date,mode,particulars,deposits,withdrawals,balance
17-09-2024,,B/F,0.0,0.0,93498.86
21-09-2024,,NEFT-SBIN224265876230-ITDTAX REFUND 2024- 25 BTWPP4121R-/ATTN//INB-00000033273316893- SBIN0000TBU,78410.0,0.0,171908.86
22-09-2024,,UPI/mait1992@icici/Payment from Ph/ICICI Bank/865106524148/IBL09db75e80c304ab99be5b17 81d7fc35e/,0.0,5000.0,166908.86
22-09-2024,MOBILE BANKING,MOBILE BANKING MMT/IMPS/426622411044/NA 533222006/Saurabh Pa/HDFC0000239/chgRs5.00GSTRs0.90,0.0,5005.9,161902.96
27-09-2024,,UPI/saurabhpdy1993@/Payment from Ph/HDFC BANK LTD/934940317132/AXLeb572c3b94ee4a74a760728 a6d7f2c69,5000.0,0.0,166902.96
28-09-2024,MOBILE BANKING,MOBILE BANKING MMT/IMPS/427213452904/HERO/YOEKI SOFT/IDFC bank,1.0,0.0,166903.96
28-09-2024,,UPI/amazon@rapl/You are paying/Amazon RBL/427207157475/RBA019237df23f47008e2c28dbf 11a05ec0/,0.0,309.13,166594.83
30-09-2024,,149201504063:Int.Pd:30-06-2024 to 29-09-2024,739.0,0.0,167333.83
30-09-2024,,NEFT-N274243293338016-HERO FINCORP LTD RETAIL PAYDI BR-68938191-00030310016225- HDFC0000240,484234.0,0.0,651567.83
30-09-2024,,UPI/kanchantiwari.9/UPI/Kotak Mahindra /464004812579/ICI00a82dc0823b435494878d1484b 786ec/,0.0,100000.0,551567.83
01-10-2024,,BIL/ONL/000906822623/RBL Bank L/P3DMXRY0CQXSMX/RBL,0.0,8582.4,542985.43
01-10-2024,,UPI/9035791251@axl/Payment from Ph/HDFC BANK LTD/464181824207/AXL3987602b6f0e498e8579421 559849f2e,1250.0,0.0,544235.43
02-10-2024,,UPI/9820594012@upi/UPI/Axis Bank Ltd/427664642826/ICI8b51f0a2686f4fdd80ce976be8 ecf6cf/,0.0,21150.0,523085.43
02-10-2024,,UPI/paytm-784860@pt/Payment from Ph/Yes Bank Ltd/713784938959/PYTM41002806352332379137/,0.0,500.0,522585.43
03-10-2024,,ACH/L&TFINANCELIMITED/ICIC7012204241002961/ C02404223133549475 C377872005,0.0,12051.0,510534.43
04-10-2024,,UPI/deepbanerjee198/UPI/State Bank Of I/464426732125/ICId10df698e39749459f97398b163 b19a3/,0.0,83123.0,427411.43
04-10-2024,,BIL/INFT/DJ42681442/Friends/ MAITREYA SHRIRA,0.0,60000.0,367411.43
05-10-2024,,UPI/piramal2@yesban/UPI Mandate/Yes Bank Ltd/427967959766/YES233BE0ED292474ACE06400 144FFB3842/,0.0,4707.0,362704.43
05-10-2024,,BIL/ONL/000909478515/FPL Techno/FPLTECHPL_ZICI5/One card bill,0.0,127242.33,235462.1
05-10-2024,,UPI/cred.club@axisb/payment on CRED/Axis Bank Ltd/427990460221/ACD2585298893LAQPrRM/,0.0,2950.0,232512.1
06-10-2024,,NEFT-KKBKH24280941173-SAURABH PRAVESH PANDEY-PAYMENT-1546675134-KKBK0000958,82805.0,0.0,315317.1
06-10-2024,,UPI/deepbanerjee198/UPI/State Bank Of I/464608443402/ICI6ee48526885a405aac4ea637e99 4dcd6/,0.0,82582.0,232735.1
09-10-2024,,UPI/usha73pandey@ok/Payment from Ph/ICICI Bank/931099039531/IBL963eda2246c74428ab8ba1b 38a273a9f/,0.0,43000.0,189735.1
09-10-2024,,UPI/saurabhpdy1993@/Payment from Ph/HDFC BANK LTD/013197934702/AXL44a859afdd32474d8aa11dc 81ef63dea,35022.0,0.0,224757.1
10-10-2024,,UPI/saurabhpdy1993@/Payment from Ph/HDFC BANK LTD/300164124779/AXLff91b897d85b499a90684c8 073befa5c,35000.0,0.0,259757.1
11-10-2024,,UPI/cred.utility@ax/payment on CRED/Axis Bank Ltd/428562879990/ACD2605679979ynEvEbk/,0.0,3050.0,256707.1
11-10-2024,,UPI/cred.club@axisb/payment on CRED/Axis Bank Ltd/428592853721/ACD2605684291VQqjvEq/,0.0,25236.67,231470.43
24-10-2024,,UPI/9773833832@ibl/Payment from Ph/State Bank Of I/089396941859/IBL3323b67d78cb4c81b0e62328fa6 88acb,4000.0,0.0,235470.43
31-10-2024,,UPI/punitintouch@ok/UPI/ICICI Bank/467151746865/ICI6b95f477b6eb4731963c7d6 e9d773cc0/,0.0,33000.0,202470.43
31-10-2024,,UPI/dip.banerjee86@/UPI/State Bank Of I/467181464681/ICIc62f85a06f96448fbd018f69715ee 02f/,0.0,36817.0,165653.43
02-11-2024,,UPI/billdeskpg.appl/APPLAMP/HDFC BANK LTD/430709162999/HDFEE3FB337DAC44590A5573 C086CA1A80A/,0.0,9900.0,155753.43
02-11-2024,,UPI/creditcards@rbl/ccpayment/RBL/430722160354 /RNB0230324307180755963B430723185793/,0.0,8580.4,147173.03
02-11-2024,,UPI/maitreya.0601@o/UPI/ICICI Bank/467326475194/ICId4927c0d71204bbdb50b64d 206ac307f/,0.0,4200.0,142973.03
03-11-2024,,ACH/L&TFINANCELIMITED/ICIC7012204241002961/ C02404223133549475 C377872006,0.0,12051.0,130922.03
04-11-2024,,UPI/khnsaad07-2@oki/UPI/TJSB Sahakari B/467564945919/ICIdcf09c83ec144d4eabb1bf95993 3334f,50000.0,0.0,180922.03
04-11-2024,,UPI/maitreya.0601@o/UPI/ICICI Bank/430971187858/ICI9ced18be24c44d6d8d2b70c d81327fe9/,0.0,50000.0,130922.03
04-11-2024,,UPI/cred.club@axisb/payment on CRED/Axis Bank Ltd/430917516018/ACD2674574425PmKRKXb/,0.0,46435.03,84487.0
05-11-2024,,UPI/piramal2@yesban/UPI Mandate/Yes Bank Ltd/431019277749/YES25D8A48A919D35DBE06400 144FFAE8A5/,0.0,4707.0,79780.0
05-11-2024,,ACH/HERO FINCORP LTD/ICIC7012709242023333/68938191,0.0,18519.0,61261.0
06-11-2024,,UPI/jairajput015@yb/Payment from Ph/Bank of India/751321201676/IBL2fff0ec3767149439b5df855e 937bc05/,0.0,30000.0,31261.0
09-11-2024,,UPI/gangsta.rhymez@/UPI/Kotak Mahindra /468057485726/AXI484d41bd219449a79b284cd73f2 d9717,18000.0,0.0,49261.0
10-11-2024,,UPI/usha73pandey@ok/Payment from Ph/ICICI Bank/294270405235/IBL5c362e50d2e8433f8e31c7cc 6ec39a23/,0.0,43000.0,6261.0
11-11-2024,,UPI/ixigo.train@ici/IXIGO Train Tri/ICICI Bank LTD /431604336690/01JCD5SWFH2VDVJYHR5TCZY72N 5DF0WSJ1C,0.0,2137.0,4124.0
11-11-2024,,UPI/ixigo.train@ici/IXIGO Train Tri/ICICI Bank LTD /431619231047/ICI14a72bfb645448119ef24057dd8a 950c,0.0,1089.0,3035.0
11-11-2024,,UPI/cred.utility@ax/payment on CRED/AXIS BANK/431683273949/ACD2696782561xePDqYK/,0.0,2800.0,235.0
12-11-2024,,NEFT-KKBKH24317862644-SAURABH PRAVESH PANDEY-PAYMENT-1546675134-KKBK0000958,30000.0,0.0,30235.0
12-11-2024,,UPI/cred.club@axisb/payment on CRED/AXIS BANK/431789909269/ACD2697281340yXAzkKk/,0.0,25014.09,5220.91
13-11-2024,MOBILE BANKING,MOBILE BANKING MMT/IMPS/431810650139/Paid via CRED/DREAMPLUG /Yes Bank Ltd,1.0,0.0,5221.91
15-11-2024,,UPI/kanchantiwari.9/UPI/Kotak Mahindra /432058228291/ICI358fa8fc38864ee09b2d74a40851 d791/,0.0,5000.0,221.91
15-11-2024,,NEFT-N320243401110919-HERO FINCORP LTD RETAIL PAYDI BR-68938191-00030310016225- HDFC0000240,548.61,0.0,770.52
18-11-2024,,NEFT-KKBKH24323722933-SAURABH PRAVESH PANDEY-PAYMENT-1546675134-KKBK0000958,121873.0,0.0,122643.52
19-11-2024,,UPI/dipbanerjee12@i/Payment from Ph/Kotak Mahindra /051202339503/IBL815e8312f7904d45b0f708dd751 81ccb,0.0,100000.0,22643.52
20-11-2024,,UPI/saurabhpdy1993@/Payment from Ph/HDFC BANK LTD/513447907235/AXLc1b8c380722640759fd6b7b 8293b1069,60000.0,0.0,82643.52
21-11-2024,,UPI/mondalsom02@ybl/Payment from Ph/AXIS BANK/789492765627/IBLa8b109d9900f4caeb00d6e 805d521a18/,0.0,21300.0,61343.52
23-11-2024,,UPI/appleservices.b/UPI Mandate/HDFC BANK LTD/432879267187/HDF278CE9AE64A62FADE063E DEEE20A0C64/,0.0,5900.0,55443.52
24-11-2024,,UPI/HOTSTARONLINE@y/Collect request/Yes Bank Ltd/432941472587/YBL445a917cae23445185607966 5d6a013e/,0.0,1499.0,53944.52
24-11-2024,,UPI/paytmqr5cylss@p/Payment from Ph/Yes Bank Ltd/456322469472/IBL454351dfb18e4d5695c52d9bf de0b5f4/,0.0,100.0,53844.52
24-11-2024,,UPI/paytmqr63cqty@p/Payment from Ph/Yes Bank Ltd/798622708558/IBLc0cb2a3079254ee28902ad4e 3a8e86d4/,0.0,100.0,53744.52
24-11-2024,,UPI/thedessertempor/Payment from Ph/HDFC BANK LTD/648580275470/IBL7ae9820747cc4087848c4c1d 8829521e/,0.0,280.0,53464.52
25-11-2024,,UPI/q594128025@ybl/UPI/Yes Bank Ltd/433096053235/ICIada53c5e61314e18869d8cdf4 eaebef8/,0.0,10.0,53454.52
25-11-2024,,UPI/Vyapar.17158899/Payment from Ph/HDFC BANK LTD/834594065888/IBLa050acc29df6437d8fca3b47e 6159699/,0.0,900.0,52554.52
25-11-2024,,UPI/paytmqrhvy282gw/Payment from Ph/Yes Bank Ltd/103606701702/IBL28ed04dec0c64d8faeeb04115 74f406e/,0.0,120.0,52434.52
26-11-2024,,UPI/khnsaad07-1@oki/UPI/Kotak Mahindra /469757638477/ICIc906d81b60e14389bdce1e34bb3 2068c/,0.0,2000.0,50434.52
26-11-2024,,UPI/Q628672636@ybl/Payment from Ph/Yes Bank Ltd/296379985545/IBLa4c780c1d3ed40c6b054e807 dda9e978/,0.0,10.0,50424.52
27-11-2024,ICICI ATM,ICICI ATM ATM/S1CNQ080/CASH WDL/27-11-24,0.0,1900.0,48524.52
27-11-2024,,UPI/usha3235@icici/Payment from Ph/ICICI Bank/679842218663/IBLaae290307421441cb56817c 6e1049240/,0.0,1000.0,47524.52
27-11-2024,,CCW/18892OAR/11035773/9862/Cardless Cash WDL/IMB,0.0,500.0,47024.52
27-11-2024,,UPI/8976067217@axl/Payment from Ph/INDIAN BANK/493573302013/IBL38f6c03a95974b9aab7964 ea14f20fae/,0.0,1000.0,46024.52
28-11-2024,,UPI/karan.rajput159/Payment from Ph/KAIJSB- Ichalka/537472650636/IBL57d3f411da934b9181fa4b a80cd0ce30,0.0,50.0,45974.52
28-11-2024,,UPI/8286331111@okbi/Payment from Ph/AXIS BANK/140658876848/IBL09530337cf4d44f2bc383fd 9070de23a/,0.0,40.0,45934.52
28-11-2024,,UPI/paytmqr1ch1wjyn/Payment from Ph/Yes Bank Ltd/888352586666/IBLf7466433b287433ba5a7c13a1 544f7c3/,0.0,86.0,45848.52
28-11-2024,,UPI/paytm.s15kt53@p/Payment from Ph/YES BANK PTY/772112785043/IBL6e55850e68964dc39b78bc5f 849ad0cf/,0.0,60.0,45788.52
28-11-2024,,UPI/kumbharshrishai/Payment from Ph/CENTRAL BANK OF/680270470121/IBL66151a4c28394c1da0d4ae878 ac952b5,0.0,34.0,45754.52
28-11-2024,,UPI/9773833832@ibl/Payment from Ph/State Bank Of I/402867915007/IBLbc80a88e1ef5460c90318ae6dc2 83056/,0.0,420.0,45334.52
28-11-2024,,UPI/nehashaikh12345/UPI/Maharashtra Gra/469906135851/ICI02c21e4014e64ab9a7ed270b a7821ea4/,0.0,28.0,45306.52
29-11-2024,,UPI/paytmqr5xr8ct@p/Payment from Ph/Yes Bank Ltd/547375654558/IBL0bd08eae8dbc4f34b65771f2a 370f165/,0.0,50.0,45256.52
30-11-2024,,UPI/prashantcornerp/Payment from Ph/HDFC BANK LTD/899144584739/IBL3d95eaec6f7c4edc833d91c7 dd49d55d/,0.0,106.0,45150.52
30-11-2024,,UPI/sprasadsanadi@o/Payment from Ph/HDFC BANK LTD/507506168211/IBL0540ad448b8b40a48af480e2 40c4bba8/,0.0,3000.0,42150.52
01-12-2024,,UPI/sonia.bahrani@o/Payment from Ph/ICICI Bank/782392618179/IBLb57fc17ef1b545ca8b82f4b5 bd8949d6/,0.0,19500.0,22650.52
01-12-2024,,UPI/paytmqr5vzv5d@p/Payment from Ph/Yes Bank Ltd/078731652564/IBL50440ad004a044a684c18bd2 5e1fb320/,0.0,50.0,22600.52
02-12-2024,,UPI/saurabhpdy1993@/Payment from Ph/HDFC BANK LTD/460467856811/YBLd280285ab9564787b2de6f7 06bf0a7a0,1150.0,0.0,23750.52
02-12-2024,,UPI/RCollectCC@rbl/A20240530000715/RBL/211800 996464/IBL25a7a7cdeb4145fc841347339739bcd2/,0.0,8581.4,15169.12
02-12-2024,,UPI/Q066118927@ybl/Payment from Ph/Yes Bank Ltd/947881007641/IBL99e1243150ae48cebab5e6b2f 57ca675/,0.0,504.0,14665.12
02-12-2024,,UPI/paytm.s15jent@p/Payment from Ph/YES BANK PTY/698811481621/IBL7250af09ab62468dbc0e560f 8a337983/,0.0,273.0,14392.12
02-12-2024,,UPI/yeshanx.6303307/Payment from Ph/HDFC BANK LTD/547145903375/IBLbf76dc9bd5d54d45850c245a e4e31eca/,0.0,3690.0,10702.12
02-12-2024,,UPI/paytmqr28100505/Payment from Ph/Yes Bank Ltd/482731457063/IBLfdf4d036bfd94064a880031e9 8ca8148/,0.0,42.0,10660.12
02-12-2024,,UPI/paytmqrydn1ws23/Payment from Ph/Yes Bank Ltd/559379816618/IBL6f0584d4ee1f417da0774bbf8 673c524/,0.0,420.0,10240.12
02-12-2024,,UPI/Q322279675@ybl/Payment from Ph/Yes Bank Ltd/288464395636/IBLf03396f3cab74cb886948cf2f0 32b455/,0.0,600.0,9640.12
02-12-2024,,UPI/paytmqr5bguye@p/Payment from Ph/Yes Bank Ltd/432477873535/IBLa3afb921f15a4f059f5c88d1b2 a26b3f/,0.0,2.0,9638.12
03-12-2024,,NEFT-KKBKH24338606518-SAURABH PRAVESH PANDEY-PAYMENT-1546675134-KKBK0000958,100000.0,0.0,109638.12
03-12-2024,,UPI/Q591493709@ybl/Payment from Ph/Yes Bank Ltd/286353791134/IBL70fa300b96f64a20ad8b46f48 38defaf/,0.0,20.0,109618.12
04-12-2024,,UPI/ltfs.payu@icici/UPIIntent/ICICI Bank LTD /433933289984/PPPL2175153028604122414181067 50174a/,0.0,12051.0,97567.12
04-12-2024,,UPI/Q152789196@ybl/Payment from Ph/Yes Bank Ltd/182313793150/IBL4c26bc6d5b0445fe9b1565da 3a58e240/,0.0,50.0,97517.12
05-12-2024,,UPI/onecardbob@yesp/Payment from Ph/YesBank_Yespay/144636734593/YJP9a4bbbe6a c5f454a9b0f7ed71fb1076d/,0.0,49841.65,47675.47
05-12-2024,,UPI/piramal2@yesban/UPI Mandate/Yes Bank Ltd/434075310021/YES28272D487BF26E79E064001 44FFAE8A5/,0.0,4707.0,42968.47
05-12-2024,,UPI/maitreya.0601@o/UPI/ICICI Bank/434086674847/ICI140d5f5a68874582b5f3c638 291c0e66/,0.0,20000.0,22968.47
05-12-2024,,ACH/HERO FINCORP LTD/ICIC7012709242023333/68938191,0.0,18519.0,4449.47
05-12-2024,,UPI/theomnikart-2@o/UPI/IDBI BANK/434092710658/ICI33cff05db0bf4999b40b148 749a56129,9900.0,0.0,14349.47
05-12-2024,,UPI/billdeskpg.appl/APPLAMP/HDFC BANK LTD/434036163958/HDFF07A33DFCCF54D849A7E3 35D7F546086/,0.0,9900.0,4449.47
06-12-2024,,UPI/amazonpaybalanc/You are paying/AXIS BANK/701957274228/APLf338038198dc42708d2dd c3df1f081a4/,0.0,162.41,4287.06
06-12-2024,,UPI/paytm-592582@pt/Oid8617982@WELL/Yes Bank Ltd/434138386073/PTM41206803585307802657202 412060102/,0.0,681.02,3606.04
06-12-2024,,UPI/Q152789196@ybl/Payment from Ph/Yes Bank Ltd/295999084252/IBLec054f11f6184054868016d9b b19bddb/,0.0,150.0,3456.04
08-12-2024,,UPI/paytm-592582@pt/collect/Yes Bank Ltd/434313128966/PTM4f32e83ead0849eaae8916f6 62acbf9d,681.02,0.0,4137.06
09-12-2024,,UPI/stk-9699499954-/Payment from Ph/AXIS BANK/906549802615/IBL1f45b12a704540c2a42f790 0a77ea5db/,0.0,95.0,4042.06
09-12-2024,,UPI/paytmqr5gr4mc@p/Payment from Ph/Yes Bank Ltd/478889153858/IBL07b53526031e4c2ba4749448 0f3b1dad/,0.0,69.0,3973.06
10-12-2024,,UPI/paytmqr5gr4mc@p/Payment from Ph/Yes Bank Ltd/189805310742/IBLc5a28857c89a41f9b43aed8f6 0b55c23/,0.0,899.0,3074.06
10-12-2024,,UPI/paytmqr5gr4mc@p/Payment from Ph/Yes Bank Ltd/429146564188/IBL22612cb99f254bd5a4de00923 a00690f/,0.0,640.0,2434.06
10-12-2024,,UPI/paytmqr5gr4mc@p/Payment from Ph/Yes Bank Ltd/911822643037/IBLb08f10faedfe48b6a8604d8c2 2b5b529/,0.0,930.0,1504.06
10-12-2024,,ECSRTN1_0312247012204241002961,0.0,590.0,914.06
10-12-2024,,UPI/paytmqr5cylt4@p/Payment from Ph/Yes Bank Ltd/761807897434/IBLd6c11cf81bb84e5ea0f9c2daa 0df83c9/,0.0,45.0,869.06
11-12-2024,,UPI/paytmqr28100505/Payment from Ph/Yes Bank Ltd/252711130358/IBL00769ef3e17f48d19dd5aa597 08444c7/,0.0,10.0,859.06
11-12-2024,,NEFT-KKBKH24346854319-SAURABH PRAVESH PANDEY-PAYMENT-1546675134-KKBK0000958,5000.0,0.0,5859.06
11-12-2024,,UPI/Q365321557@ybl/Payment from Ph/Yes Bank Ltd/161186072770/IBL497ad829367e4479aed8d48e 91bf3b6e/,0.0,43.0,5816.06
12-12-2024,,UPI/saurabhpdy1993@/Payment from Ph/HDFC BANK LTD/318298734855/AXL82c823f8b04a4545a302e52 dac0d070d,20000.0,0.0,25816.06
12-12-2024,,UPI/cred.club@axisb/payment on CRED/AXIS BANK/434774444565/ACD2783177856VKmRwGZ/,0.0,24969.97,846.09
12-12-2024,,UPI/paytm.s15jent@p/Payment from Ph/YES BANK PTY/477101431379/IBLef466037427b4857944aacfd e3645217/,0.0,150.0,696.09
13-12-2024,,UPI/amazon@yapl/You are paying/Yes Bank Ltd/434832049741/APY0193bc362bccfbc0804d1817 a7fc71f0/,0.0,449.0,247.09
13-12-2024,,UPI/saurabhpdy1993@/Payment from Ph/HDFC BANK LTD/519074626410/YBLd85b21fd6eb0471abbed2f5 c76125f8f,1322.0,0.0,1569.09
13-12-2024,,UPI/Q581762696@ybl/Payment from Ph/Yes Bank Ltd/128738188940/IBL59b50867ed4a493f838c17063 19c8f69/,0.0,76.0,1493.09
13-12-2024,,UPI/paytmqr61od8x@p/Payment from Ph/Yes Bank Ltd/631048050680/IBLfe2d190da6c44e5d827140380 e215ab8/,0.0,60.0,1433.09
13-12-2024,,UPI/paytmqr5bguye@p/Payment from Ph/Yes Bank Ltd/511662476544/IBL64e3579d3a1d4f9695ad09dd 541e9b4b/,0.0,20.0,1413.09
14-12-2024,,ACH/L&TFINANCELIMITED/ICIC7012204241002961/ C02404223133549475 BC14217001,0.0,500.0,913.09
14-12-2024,,UPI/Q581762696@ybl/Payment from Ph/Yes Bank Ltd/734546325272/IBLa592f259acc849429175dedae 2247d2f/,0.0,160.0,753.09
14-12-2024,,UPI/paytmqr6216mr@p/Payment from Ph/Yes Bank Ltd/616232413707/IBL5cd6e45791cb416f97aa2c0fe 339ea5b/,0.0,60.0,693.09
14-12-2024,,UPI/usha73pandey-1@/UPI/TJSB SAHAKARI B/471514494323/ICIcfafa61a03c94b5e9d94a72ec2d bf08e,30000.0,0.0,30693.09
14-12-2024,,UPI/kanchantiwari.9/UPI/Kotak Mahindra /434933206240/ICIaa670623850043f1ba673a32e84d 370b/,0.0,5000.0,25693.09
14-12-2024,,UPI/pandey.vinesh-1/UPI/AXIS BANK/434974555175/AXI96b8f68408fc42d9b1664fc 0c2d08ad5,200.0,0.0,25893.09
14-12-2024,,UPI/pandey.vinesh-1/UPI/AXIS BANK/471524313415/ICI0718645a59d4415ca665494 caac4d25d/,0.0,200.0,25693.09
14-12-2024,,UPI/Q373183419@ybl/Payment from Ph/Yes Bank Ltd/920824700242/IBLa10282df3e4c483d8a7921015 437b1aa/,0.0,42.0,25651.09
15-12-2024,,UPI/sruchan@ybl/CredNX Design P/HDFC BANK LTD/685830636829/IBL9c899d0701264713a89374b d6937421a/,0.0,23000.0,2651.09
15-12-2024,,UPI/paytmqr59pq7z@p/Payment from Ph/Yes Bank Ltd/060434021683/IBL932f86cb5d944dbeb73a4533 de54bd8c/,0.0,100.0,2551.09
15-12-2024,,UPI/amazonupi@apl/You are paying/AXIS BANK/534786788604/APL6d074e63bd664dd5baa57 ebdff86c1f0/,0.0,799.0,1752.09
16-12-2024,,UPI/paytm-8796946@p/Oid812160830998/Yes Bank Ltd/435135049278/PTM41216804834267050033202 412160537/,0.0,90.0,1662.09
16-12-2024,,UPI/gangsta.rhymez@/UPI/Kotak Mahindra /471773087092/AXIad9aefd017084c26b6753419f51 57065,1540.0,0.0,3202.09
17-12-2024,,UPI/maitreya.0601@o/UPI/ICICI Bank/435275352719/ICIf7cc4b2b7d734145ae63ccde be0281b8,40621.0,0.0,43823.09
17-12-2024,MOBILE BANKING,MOBILE BANKING MMT/IMPS/435219396742/Friends 5332220/TransferWi/RATN0000088/chgRs15.00GST Rs2.70,0.0,40640.23,3182.86
18-12-2024,,UPI/theomnikart-2@o/UPI/IDBI BANK/471910370691/ICIfbce6baaaccc4325a85473d 85a68d4b9,16540.0,0.0,19722.86
18-12-2024,,UPI/cred.utility@ax/payment on CRED/AXIS BANK/471903291541/ACD2795943677LBvbElb/,0.0,2520.0,17202.86
18-12-2024,,UPI/EASEBUZZONLINE@/Payment from Ph/Yes Bank Ltd/482946685572/IBLae54468b9c1c4a54a19e78df6 9c8001e/,0.0,200.0,17002.86
18-12-2024,,UPI/paytmqr28100505/Payment from Ph/Yes Bank Ltd/775846741663/IBL9e1e1e24553b445bb7faec495 f2abb8c/,0.0,50.0,16952.86
18-12-2024,,UPI/paytmqr59tn54@p/Payment from Ph/Yes Bank Ltd/713833044543/IBLd297a730d13f48f89733110a9 ba45d1a/,0.0,390.0,16562.86
19-12-2024,,UPI/paytmqr28100505/Payment from Ph/YES BANK LIMITE/757801261392/IBL833ffdeb8c0f4237b25454 5a724eef1e,0.0,60.0,16502.86
19-12-2024,,UPI/kamleshmorbiya3/Payment from Ph/BANK OF MAHARAS/245243986848/IBL98e44b3756dc4ae3bd 363bd310e94a11,0.0,60.0,16442.86
19-12-2024,,UPI/paytmqr5amksa@p/Payment from Ph/YES BANK LIMITE/368535716057/IBLd5e9ece6f53941d59d54b e8235268221,0.0,50.0,16392.86
20-12-2024,,UPI/appleservices.b/UPI Mandate/HDFC BANK LTD/435598288301/HDF294B0C60499EE946E063ED EEE20A52BA/,0.0,195.0,16197.86
20-12-2024,,UPI/9699499954-1@ok/Payment from Ph/AXIS BANK/641733945198/IBL55d928b96acc4a0cbb09fe a360df46ab/,0.0,75.0,16122.86
20-12-2024,,UPI/9702286230@ibl/Payment from Ph/BANK OF BARODA/511170625533/IBL037c44db48e04b0190a 92f01ba8316db/,0.0,23.0,16099.86
20-12-2024,,UPI/paytmqr5amksa@p/Payment from Ph/YES BANK LIMITE/536078480080/IBLb698347bb4e24271a1221 de73a2c3b15,0.0,370.0,15729.86
20-12-2024,,UPI/paytmqr5jl59t@p/Payment from Ph/YES BANK LIMITE/833472775655/IBL86ab218ecf1c40faa0b6a9 33abc692c8,0.0,270.0,15459.86
21-12-2024,,UPI/swapnilparab010/UPI/AXIS BANK/472210890724/ICIa8a34e0b6c0e46828a85c58 458a1d667/,0.0,5000.0,10459.86
21-12-2024,,UPI/ajayyadav0911-1/UPI/AU SMALL FINANC/435601084714/ICI594cd699bd8d4065b160f a529ceff8a3,1140.0,0.0,11599.86
21-12-2024,,UPI/paytmqr60um4g@p/Payment from Ph/YES BANK LIMITE/769253724025/IBLfdec980f05ba4b74b68928 3d1ff382f5,0.0,25.0,11574.86
21-12-2024,,UPI/paytmqr5cylt4@p/Payment from Ph/YES BANK LIMITE/645270614055/IBL602e70e7982e495d98209 872118ff695,0.0,250.0,11324.86
22-12-2024,,UPI/chhaganlalpatel/UPI/ICICI Bank/472335312273/ICIc2922a36ac9b4f99bf47c6f8f 93e9ffa,110.0,0.0,11434.86
22-12-2024,,UPI/paytm-8796946@p/Oid812220838414/YES BANK LIMITE/435737358717/PTM41222804693200067625 202412220504,0.0,10.0,11424.86
23-12-2024,,UPI/7039217471@axl/Payment from Ph/State Bank Of I/274504839791/IBL02550818410d4469b4b4dceeec 001e04/,0.0,40.0,11384.86
24-12-2024,,UPI/9699499954-1@ok/Payment from Ph/AXIS BANK/128152151080/IBL717089495a2043e7b5a147 4aa7436650/,0.0,80.0,11304.86
24-12-2024,,UPI/Q730395741@ybl/Payment from Ph/YES BANK LIMITE/227119930289/IBLe657008973564a21a841a 48f81cc7cbd/,0.0,500.0,10804.86
24-12-2024,,UPI/paytmqr617tlu@p/Payment from Ph/YES BANK LIMITE/986174640678/IBLebdf428a54c44141a8ff58f f70cccb3d,0.0,70.0,10734.86
24-12-2024,,UPI/002001013@tjsb/Payment from Ph/TJSB SAHAKARI B/283636667422/IBLaa91a94904f143bb92bd8e4237 37594f/,0.0,50.0,10684.86
24-12-2024,,UPI/ParviomTechnolo/UPIIntent/AIRTEL PAYMENTS/222612321069/PPPL219453593592412 24120659676a568b/,0.0,20.0,10664.86
24-12-2024,,UPI/7310229103@ibl/Payment from Ph/State Bank Of I/648724728639/IBL402f27e9e5f441a09ade8ca7cbd 706c9/,0.0,20.0,10644.86
24-12-2024,,UPI/pandey.vinesh-1/Payment from Ph/AXIS BANK/075311129623/IBLfb3f4640811c4144a861797 f95e89b6e/,0.0,9200.0,1444.86
25-12-2024,,UPI/mk7933434798@ok/UPI/CANARA BANK/472673758938/ICI388cbca2312447b99278f0d f26f7ba76/,0.0,40.0,1404.86
25-12-2024,,UPI/Q872597313@ybl/Payment from Ph/YES BANK LIMITE/508091230290/IBL39c4e51eed324866b702b 81197f6473f/,0.0,50.0,1354.86
25-12-2024,,UPI/paytmqr28100505/Payment from Ph/YES BANK LIMITE/790969548169/IBLc475600857fb44e38968b7 3380b8155d,0.0,350.0,1004.86
25-12-2024,,UPI/paytmqr63v5ej@p/Payment from Ph/YES BANK LIMITE/532365867453/IBL76766dcdc3d1441e8743a d9e6ca782ab,0.0,24.0,980.86
25-12-2024,,UPI/2422667716506-0/Payment from Ph/JIO PAYMENTS BA/304333451740/IBL6701b02c2104490ca5007ff35 2f3749d,0.0,80.0,900.86
25-12-2024,,UPI/Vyapar.17072479/Payment from Ph/HDFC BANK LTD/695468494144/IBL3bf69174f7924e99a2c7aa927 daff080/,0.0,126.0,774.86
26-12-2024,,UPI/mk7933434798@ok/UPI/CANARA BANK/472728811009/ICIa1c8a75f0eca475b86b89bd 61d5cfc2d/,0.0,50.0,724.86
26-12-2024,,UPI/q872597313@ybl/UPI/YES BANK LIMITE/436147900919/ICI290a0965b51f43a2a05d4e f69f26cdd8/,0.0,50.0,674.86
26-12-2024,,BIL/INFT/DLU0857187/Family/ PRAVESH R PANDE,200000.0,0.0,200674.86
26-12-2024,,UPI/maitreya.0601@o/UPI/ICICI Bank/472714630715/ICI9a39ca3640ef4398ae2500eb 3a78c15c/,0.0,50000.0,150674.86
26-12-2024,,BIL/NEFT/HS92436168876726/Self/Saurabh Pa/KKBK0001374,0.0,6000.0,144674.86
26-12-2024,,NEFT-RETURN-HS92436168876726-SAURABH PA- CREDIT TONRI ACCOUNT  R12,6000.0,0.0,150674.86
26-12-2024,,UPI/Q360574991@ybl/Payment from Ph/YES BANK LIMITE/495131799434/IBL65ac3797867148c8a662fd 260d8ef5c4/,0.0,36.0,150638.86
26-12-2024,,UPI/Q452111014@ybl/Payment from Ph/YES BANK LIMITE/713371757808/IBL71eab719a9dc4eff96e951 57af38d938/,0.0,40.0,150598.86
26-12-2024,,UPI/paytmqrmnnge7jk/Payment from Ph/YES BANK LIMITE/714855846036/IBL0299bbbe9d9c4c22879d2 d0864ea0beb,0.0,130.0,150468.86
26-12-2024,,UPI/paytmqr5ev4j4@p/Payment from Ph/YES BANK LIMITE/031591082727/IBLf3a8ea42d6094ab88377f7 a92985b719,0.0,15.0,150453.86
27-12-2024,,UPI/spengineering12/Payment from Ph/UNION BANK OFI/546312926344/AXL456c72527c464b168427026 d80361ae7,1.0,0.0,150454.86
27-12-2024,,UPI/paytmqr1qc1ayro/Payment from Ph/YES BANK LIMITE/038500076353/IBLa479a25f0b3647c99f97d0 49fde38b9b,0.0,20.0,150434.86
27-12-2024,,UPI/paytmqr177bvaca/Payment from Ph/YES BANK LIMITE/561445219995/IBL48662e9c6fa540e39498ea 4ebbadda77,0.0,200.0,150234.86
29-12-2024,MOBILE BANKING,MOBILE BANKING MMT/IMPS/436419151584/adv to Saurabh /S.P.ENGINE/Union Bank Of I,999.0,0.0,151233.86
29-12-2024,,UPI/paytmqr5bguye@p/Payment from Ph/YES BANK LIMITE/491854437544/IBL8bb44bdd0cc34c4980ae8 24e929cc5e3,0.0,18.0,151215.86
29-12-2024,,UPI/paytmqr5bguye@p/Payment from Ph/YES BANK LIMITE/082882378794/IBL1255898cdf0d420596b29 b0124d85af3,0.0,38.0,151177.86
30-12-2024,MOBILE BANKING,MOBILE BANKING MMT/IMPS/436514625837/PCXES2XUWEFY6YI/Am azon Sel/HSBC Bank,1592.5,0.0,152770.36
30-12-2024,,UPI/Q139125177@ybl/Payment from Ph/YES BANK LIMITE/897149082820/IBL1f098a3f491f4b7fb87e6c3 ddfe5b3b8/,0.0,20.0,152750.36
30-12-2024,,UPI/paytmqr6216mr@p/Payment from Ph/YES BANK LIMITE/461025306917/IBLdeeb9d720d44426096c90 06883f03add,0.0,52.0,152698.36
30-12-2024,,UPI/9730654746@ibl/Payment from Ph/BANK OF BARODA/538953905670/IBLc9da4194cdba48f4b60e 07642bc253e8/,0.0,32.0,152666.36
30-12-2024,,UPI/paytmqrd34ngx0i/Payment from Ph/YES BANK LIMITE/405734081886/IBL5249ba3899b149d0aba89 1f54e2d7538,0.0,933.0,151733.36
30-12-2024,,UPI/BHARATPE.900719/Pay to BharatPe/FEDERAL BANK/519040068191/IBL04fa9fd4cd4249baaeadbf0 101ab28e8/,0.0,36.0,151697.36
30-12-2024,,UPI/manojyadav01661/Payment from Ph/BANK OF INDIA/640002930594/IBL545126682ca6472f99ed7a6 f3b66761f/,0.0,25.0,151672.36
31-12-2024,,149201504063:Int.Pd:30-09-2024 to 30-12-2024,934.0,0.0,152606.36
31-12-2024,MOBILE BANKING,MOBILE BANKING MMT/IMPS/436616558759/adv /S.P.ENGINE/Union Bank Of I,99000.0,0.0,251606.36
31-12-2024,,UPI/pandeygaurav326/na/HDFC BANK LTD/436662227179/ICIWCAB911E140B348BA298A6 D6079A6908/,0.0,1593.0,250013.36
31-12-2024,,UPI/RCollectCC@rbl/A20240530000715/RBL BANK LIMITE/373300978176/IBL05d08b1cc9f74249a768a4 94d59e2b9b/,0.0,8581.4,241431.96
31-12-2024,,UPI/sanketambekar28/Payment from Ph/SARASWAT BANK/395021195734/IBLfd290df91ed6460da558c13 d7602ff72/,0.0,48.0,241383.96
01-01-2025,,UPI/002001013@tjsb/Payment from Ph/TJSB SAHAKARI B/399393260139/IBL49e0cd0dfc5b4cc4af26ba99e07 e0491/,0.0,1000.0,240383.96
01-01-2025,,UPI/gpay-1124087848/Payment from Ph/AXIS BANK/119407277454/IBLbbb524ec5b2d491eb12c96 5a181ce921/,0.0,1500.0,238883.96
01-01-2025,,UPI/Q099047281@ybl/Payment from Ph/YES BANK LIMITE/110488494876/IBL88e33d790b9f42238212b 0c66b8ad2f7/,0.0,470.0,238413.96
02-01-2025,,UPI/maitreya.0601@o/UPI/ICICI Bank/500215811991/ICI81ab5352471e4822aebed6d 901d70f13,6200.0,0.0,244613.96
02-01-2025,,UPI/ixigo.train@ici/IXIGO Train Tri/ICICI Bank LTD /385692712370/01JGKNR7VABCY1DWJ8ZHQQ9AZ VKJN7GV10R,0.0,2136.0,242477.96
02-01-2025,,UPI/ixigo.train@ici/IXIGO Train Tri/ICICI Bank LTD /907447077075/01JGKP46N8VF17GTB50036XR82G 6J4N1PK0,0.0,1106.0,241371.96
02-01-2025,,UPI/Q004766458@ybl/Payment from Ph/YES BANK LIMITE/938626801075/IBL7f96347d389648c98497ee 52c3f6d139/,0.0,40.0,241331.96
02-01-2025,,UPI/khnsaad07-1@oki/UPI/Kotak Mahindra /500272130091/ICI4c60d7af5c464f1ea37df2ad23fdc e8d/,0.0,1100.0,240231.96
02-01-2025,,UPI/sury00025979@su/UPI/Suryoday Small /536841622409/ICI0154e52343ad4249a6f0c0fedc2b df89/,0.0,10.0,240221.96
03-01-2025,,ACH/L&TFINANCELIMITED/ICIC7012204241002961/ C02404223133549475 C377872008,0.0,12051.0,228170.96
03-01-2025,,UPI/Q139125177@ybl/Payment from Ph/YES BANK LIMITE/992509311379/IBL0f1e7e55d09e4b4cade91 0bddfef618c/,0.0,10.0,228160.96
03-01-2025,,UPI/paytm.s15jent@p/Payment from Ph/YES BANK PTY/566203998630/IBLe5c1475c9dbf449786ffd5479 dafef9a/,0.0,205.0,227955.96
03-01-2025,,UPI/pandeygaurav326/na/HDFC BANK LTD/500379179748/ICIWCD5979F3648B7C4E14F21 351E07AEB1/,0.0,220.0,227735.96
04-01-2025,,UPI/pandey.vinesh-1/UPI/AXIS BANK/500468786658/ICIa7b435193e8047fe9faf7eaa e359f1d9/,0.0,800.0,226935.96
04-01-2025,,UPI/Q651635386@ybl/Payment from Ph/YES BANK LIMITE/791809054228/IBLb2ac12e63ae24babb793fa 4cf1b80956/,0.0,18.0,226917.96
04-01-2025,,UPI/paytm-91696624@/Payment from Ph/YES BANK LIMITE/466131063084/IBLd20126fdcfaa400eaaaae1 2c312a5cfe,0.0,377.23,226540.73
04-01-2025,,UPI/9821190002@okbi/Payment from Ph/AXIS BANK/768080019674/IBLf65db2429be44fb9b321ed 12f61b63ff/,0.0,1481.0,225059.73
04-01-2025,,UPI/Q278720055@ybl/Payment from Ph/YES BANK LIMITE/415505250489/IBL83e1a7de2e534ea2be133 0b8b16d178a/,0.0,38.0,225021.73
05-01-2025,,ACH/HERO FINCORP LTD/ICIC7012709242023333/68938191,0.0,18519.0,206502.73
05-01-2025,,UPI/piramal2@yesban/UPI Mandate/YES BANK LIMITE/500543116307/YES2AEBA16C239C5AD6E0 6400144FFB3842/,0.0,4707.0,201795.73
05-01-2025,,UPI/onecardbob@yesp/Payment from Ph/YesBank_Yespay/898059010198/YJPa2297aa4b8 44444093a4da95365e69eb/,0.0,73661.18,128134.55
05-01-2025,,UPI/19rohan92@okhdf/Hafta/HDFC BANK LTD/500500190708/HDFa2e0743335ae472fa2fb99b 473c08f82,24000.0,0.0,152134.55
05-01-2025,,UPI/maitreya.0601@o/UPI/ICICI Bank/500554175223/ICIdaf5a1b46731457c91d2af87 c7f40549,30000.0,0.0,182134.55
05-01-2025,,UPI/maitreya.0601@o/UPI/ICICI Bank/500579074679/ICIc0b5cd37446840bdb27d5a9 934395a5d,30000.0,0.0,212134.55
06-01-2025,,UPI/9035791251@ybl/Payment from Ph/HDFC BANK LTD/283620057929/IBL99dcd6d111db4ff1a149ebfe 933fa9b6/,0.0,78583.0,133551.55
06-01-2025,,UPI/AIRTELPREDIRECT/Payment from Ph/AXIS BANK/330667495578/IBL93227ba00fe04502a39e15 9dec59d527/,0.0,20.0,133531.55
06-01-2025,,UPI/AIRTELPREDIRECT/Payment from Ph/YES BANK LIMITE/720614209071/IBL23b6f8509e9f40f886cdd7 3fc0c68f5c,0.0,20.0,133511.55
07-01-2025,MOBILE BANKING,MOBILE BANKING MMT/IMPS/500710699645/72731053 withdr/NEBLIO TEC/Yes Bank Ltd,6516.54,0.0,140028.09
07-01-2025,,UPI/gullakmoney@yes/Payment for Gul/YesBank_Yespay/500748403836/YJP589b90eba 4c34f44963c90e201aa2009/,0.0,1500.0,138528.09
07-01-2025,,UPI/paytm.s15jent@p/Payment from Ph/YES BANK PTY/984098721490/IBL0cb1929905cc4bcd92b4214 dad361c7c/,0.0,170.0,138358.09
07-01-2025,,UPI/paytmqr5e4gsb@p/Payment from Ph/YES BANK LIMITE/800102297024/IBL7c70bb0e778042c392be0 119ff762380,0.0,85.0,138273.09
08-01-2025,,UPI/paytm.s15rlhf@p/Payment from Ph/YES BANK PTY/053135632413/IBL0e4c37cd0e634483abce4474 e81c75bc/,0.0,70.0,138203.09
08-01-2025,,UPI/paytmqr5jq0nx@p/Payment from Ph/YES BANK LIMITE/356242978743/IBL6ebb9d093e4845aa97b72 d536704c55f,0.0,500.0,137703.09
08-01-2025,,UPI/Q139125177@ybl/Payment from Ph/YES BANK LIMITE/761755266058/IBL577d99c38abf4efea122c5 2c74bbcd9c/,0.0,40.0,137663.09
08-01-2025,,UPI/Q741801669@ybl/Payment from Ph/YES BANK LIMITE/475677462363/IBL30a97cb6a0054fa187687c 8c454c0a0d/,0.0,128.0,137535.09
08-01-2025,,UPI/paytmqr5x7ie0@p/Payment from Ph/YES BANK LIMITE/310017843914/IBLd1605fe2fcc5498695e7d6 c3c3404520,0.0,10.0,137525.09
09-01-2025,,UPI/usha73pandey@ok/Payment from Ph/ICICI Bank/477645615239/IBLe0c2d70f1fde47e48b0e7cdf 369f623e/,0.0,43000.0,94525.09
09-01-2025,,UPI/cred.club@axisb/payment on CRED/AXIS BANK/537591576451/ACD2860596331LRjzbqE/,0.0,24886.29,69638.8
09-01-2025,,UPI/cred.utility@ax/payment on CRED/AXIS BANK/537591579232/ACD2860598943LBRBgxk/,0.0,5890.0,63748.8
09-01-2025,,UPI/Q322279675@ybl/Payment from Ph/YES BANK LIMITE/996772740308/IBL91a6110f31344e29b1d751 52219ef47e/,0.0,780.0,62968.8
09-01-2025,,UPI/8828324467@okbi/Payment from Ph/AXIS BANK/873033883433/IBLf96d033861aa46998b7b9c 77429f9ac6/,0.0,86.0,62882.8
09-01-2025,,UPI/Q961178675@ybl/Payment from Ph/YES BANK LIMITE/171171573802/IBLe8f57b60537f4652a6ba09 bd4c886a52/,0.0,20.0,62862.8
09-01-2025,,UPI/Q288098550@ybl/Payment from Ph/YES BANK LIMITE/084296830368/IBLe6b9a6122f8a42edaaa4cb ba0cc3e0f9/,0.0,380.0,62482.8
09-01-2025,,UPI/Q084800512@ybl/Payment from Ph/YES BANK LIMITE/421019104951/IBL4d07917712a64e12bf5ab 62fbaedcecd/,0.0,140.0,62342.8
10-01-2025,,UPI/amazonpaybalanc/You are paying/AXIS BANK/917138499201/APLd61e7bd6dc10434fbf9aca a09b0d611f/,0.0,3383.0,58959.8
10-01-2025,,UPI/Q207952539@ybl/Payment from Ph/YES BANK LIMITE/306699548044/IBL6ba853547e43411c9e834 4b31813b811/,0.0,1071.0,57888.8
10-01-2025,,UPI/usha73pandey@ok/UPI/ICICI Bank/501097972242/ICId2e91dd7542a41f1a7f07141 a395cb5e,3300.0,0.0,61188.8
10-01-2025,,UPI/paytmqrsmlabsuq/Payment from Ph/YES BANK LIMITE/943924770082/IBL857ab9ec7f0f4b7b8c991d 9bdeb9db63,0.0,60.0,61128.8
11-01-2025,,UPI/paytmqr9r81khfr/Payment from Ph/YES BANK LIMITE/769181737376/IBLbc52e3dddd8844fb83fc8b 915d376d74,0.0,330.0,60798.8
11-01-2025,,UPI/paytmqr9r81khfr/Payment from Ph/YES BANK LIMITE/224875569392/IBL1a1f9e64858344eab35881 2320e4318a,0.0,10.0,60788.8
11-01-2025,,UPI/paytmqr63bfm4@p/Payment from Ph/YES BANK LIMITE/409434205711/IBL831ba156b9114dafb67b8 bf8548043c9,0.0,18.0,60770.8
12-01-2025,,UPI/Q322279675@ybl/Payment from Ph/YES BANK LIMITE/951813332524/IBLac110e34b74c4b1885d2c 202b5ae549d/,0.0,390.0,60380.8
12-01-2025,,UPI/8828324467@okbi/Payment from Ph/AXIS BANK/696467048392/IBL442552fa2c824e08bb2946 e3f1e6c0ca/,0.0,38.0,60342.8
12-01-2025,,UPI/Q322279675@ybl/Payment from Ph/YES BANK LIMITE/674688517922/IBL73d367d322b34b718c2c1 542faa72cc2/,0.0,400.0,59942.8
12-01-2025,,UPI/paytm.s15jeom@p/Payment from Ph/YES BANK PTY/770165096999/IBL52cb4488facb44d0874d122e 497f4b40/,0.0,110.0,59832.8
12-01-2025,,UPI/paytmqr28100505/Payment from Ph/YES BANK LIMITE/120727648334/IBL6debe8124a4e4ad6b68fa 9fdefd5a5ed,0.0,45.0,59787.8
12-01-2025,,UPI/Q979493583@ybl/Payment from Ph/YES BANK LIMITE/958242434039/IBL2fae21fe04a04887ac67d5 c9e4d2352f/,0.0,42.0,59745.8
14-01-2025,,UPI/Q455502278@ybl/Payment from Ph/YES BANK LIMITE/134175377894/IBLa2829ba9476d4472a0b8d 71f5a2a35d8/,0.0,142.0,59603.8
14-01-2025,,UPI/gpay-1117687741/Payment from Ph/AXIS BANK/540721878198/IBL8ece07c32da942bf84421a e402f45cdd/,0.0,350.0,59253.8
14-01-2025,,UPI/gpay-1117687741/Payment from Ph/AXIS BANK/448257975096/IBL0021eb498e0c4bc892bbe2 10d768be67/,0.0,20.0,59233.8
14-01-2025,,UPI/paytmqr6564g3@p/Payment from Ph/YES BANK LIMITE/966451731390/IBL523ae9ee3e9041f584d71a 1bd28b2d63,0.0,15.0,59218.8
14-01-2025,,UPI/paytmqr5cylt4@p/Payment from Ph/YES BANK LIMITE/833832795421/IBL662df97396c747bc8fc74b 61eb267cb7,0.0,54.0,59164.8
15-01-2025,,UPI/paytmqr62mc2a@p/Payment from Ph/YES BANK LIMITE/435455565793/IBLba43fc99071940a3816cf7 6d023255b2,0.0,32.0,59132.8
16-01-2025,,UPI/paytmqr28100505/Payment from Ph/YES BANK LIMITE/437164741801/IBL8b462cbb6c654aad85d7b fdf9d103eff,0.0,200.0,58932.8
16-01-2025,,UPI/Q483627557@ybl/Payment from Ph/YES BANK LIMITE/567174065931/IBL9c559836cfd24394a029b2 268d43b4ec/,0.0,600.0,58332.8
16-01-2025,,UPI/paytmqr28100505/Payment from Ph/YES BANK LIMITE/932754382554/IBLadbc2c7a67a24bb59ff7ec 53b2a8b724,0.0,150.0,58182.8
17-01-2025,,UPI/9161942351@ibl/Payment from Ph/INDIAN BANK/745702954992/IBL18f3a61cfc93478591be1cf 813244601/,0.0,10.0,58172.8
18-01-2025,,UPI/kumarpatelshash/Payment from Ph/Kotak Mahindra /650798793341/IBLd2e2bbc50f46492b85ca8266e6f4 9c7c,0.0,50.0,58122.8
18-01-2025,,UPI/cf.simpl@cashfr/UPI Intent/NSDL PAYMENTS B/050892731293/IBLb7d30ad8435b4083af3d59d935 f0becc/,0.0,2452.13,55670.67
18-01-2025,,UPI/cp.lenskartjctl/payment on CRED/AXIS BANK/501817064931/ACD2879757875LzJkmNY/,0.0,49.0,55621.67
18-01-2025,,UPI/paytm.s15jent@p/Payment from Ph/YES BANK PTY/948862845003/IBL2a3ee6aedb0049bda4c78a4 117a87105/,0.0,73.0,55548.67
18-01-2025,,UPI/paytm.s19jz96@p/Payment from Ph/YES BANK PTY/787701904157/IBLc57e2b06c7c84e599b0b74f2 17649570/,0.0,70.0,55478.67
18-01-2025,,UPI/ParviomTechnolo/UPIIntent/AIRTEL PAYMENTS/929441211509/PPPL221978762881801 25173852678b99d4/,0.0,20.0,55458.67
18-01-2025,,UPI/Vyapar.17158899/Payment from Ph/HDFC BANK LTD/659985876112/IBL1eff8be3419a43a89cf00e043 887b479/,0.0,600.0,54858.67
18-01-2025,,UPI/prashantcornerp/Payment from Ph/HDFC BANK LTD/527732309481/IBLb90e9c136edc4e32882e0d1 da77c5790/,0.0,150.0,54708.67
18-01-2025,,UPI/maharashtralunc/Payment from Ph/HDFC BANK LTD/110307148655/IBLbfb549fb026244ac8448a136 8dfcdab1/,0.0,368.0,54340.67
18-01-2025,,UPI/Q714840578@ybl/Payment from Ph/YES BANK LIMITE/348683898664/IBL6150c7d9e141448ab08f18 e786df4358/,0.0,168.0,54172.67
19-01-2025,,UPI/appleservices.b/UPI Mandate/HDFC BANK LTD/501955820160/HDF2C065CCBF70762E9E063E DEEE20A5B2B/,0.0,195.0,53977.67
19-01-2025,,UPI/khnsaad07-1@oki/UPI/Kotak Mahindra /501927534727/ICI12e54acc910b4c5ea01485cfdf4fb 529/,0.0,40000.0,13977.67
19-01-2025,,UPI/khnsaad07-1@oki/UPI/Kotak Mahindra /538549233939/ICIda03ad645544449bafcaf52164d7 7bb2,40000.0,0.0,53977.67
19-01-2025,,UPI/khnsaad07-2@oki/Payment from Ph/TJSB SAHAKARIB/081993085598/IBL80a4f113c97449b2a 8e081c3fb416c4e,0.0,40000.0,13977.67
19-01-2025,,UPI/pandeygaurav326/na/HDFC BANK LTD/501957955769/ICIWC9D74EB18F3872AC9CB74 3A935E5AA9/,0.0,210.0,13767.67
19-01-2025,,UPI/Q322279675@ybl/Payment from Ph/YES BANK LIMITE/993422681405/IBL5375f271cc4a4d9a9217f4 8710f85c2d/,0.0,780.0,12987.67
19-01-2025,,UPI/paytmqr5wt8vj@p/Payment from Ph/YES BANK LIMITE/519672524169/IBL415ccf95b7b94ccebbdccc 36673423bc,0.0,50.0,12937.67
19-01-2025,,UPI/Q099047281@ybl/Payment from Ph/YES BANK LIMITE/595217488463/IBLe0ea2324672346fb9c8796 54c8092739/,0.0,280.0,12657.67
19-01-2025,,UPI/Q714840578@ybl/Payment from Ph/YES BANK LIMITE/018841004601/IBL2d6816813e9744cbb7539 2a7a391b0f8/,0.0,357.0,12300.67
20-01-2025,,UPI/prashantcornerp/Payment from Ph/HDFC BANK LTD/891283839656/IBL3b3a4793c7e54e05b75226b 32f09d932/,0.0,260.0,12040.67
21-01-2025,,UPI/241105696524890/Payment from Ph/CANARA BANK/304926965211/IBLeb4d9671a2c34d1b9fadefe 492034606/,0.0,20.0,12020.67
21-01-2025,,UPI/Q463326575@ybl/Payment from Ph/YES BANK LIMITE/227496055404/IBLf06a0b2900604245a58969 bcef99bd72/,0.0,2000.0,10020.67
21-01-2025,,UPI/gpay-1124532973/Payment from Ph/AXIS BANK/066282214496/IBL3ee2afc01b434afa93cadb9 c2bd7506c/,0.0,100.0,9920.67
21-01-2025,,UPI/cp.lenskartjctl/payment on CRED/AXIS BANK/502126564893/ACD2887229229ZJNEwYG/,0.0,1600.0,8320.67
22-01-2025,,UPI/paytm.s15jent@p/Payment from Ph/YES BANK PTY/295873421595/IBLa432cc7b4d674fc5832adde1 a86ef769/,0.0,60.0,8260.67
22-01-2025,,UPI/rahul8082157404/Payment from Ph/HDFC BANK LTD/551444553676/IBL08587da4481c4d51abe4d7b 6f74c57d3/,0.0,300.0,7960.67
22-01-2025,,UPI/paytm.s15jent@p/Payment from Ph/YES BANK PTY/369857622786/IBL91d40beac2b4447da2dd37bf 8fe2a534/,0.0,145.0,7815.67
22-01-2025,,UPI/paytmqr63vor8@p/Payment from Ph/YES BANK LIMITE/088700688949/IBL49199d51ada24d4eb0bca e2aef0125d1,0.0,30.0,7785.67
22-01-2025,,UPI/cp.zepto13a87@a/payment on CRED/AXIS BANK/502228740165/ACD2889215304lqPlNJm/,0.0,346.42,7439.25
22-01-2025,,UPI/Q322279675@ybl/Payment from Ph/YES BANK LIMITE/817449716464/IBL717a61d319ba4c5aa49e0 42d2dfd89d1/,0.0,780.0,6659.25
22-01-2025,,UPI/paytmqr5wt8vj@p/Payment from Ph/YES BANK LIMITE/961786620449/IBLec6f7a20f28348d887ade2 31d6d48d26,0.0,60.0,6599.25
22-01-2025,,UPI/Q288098550@ybl/Payment from Ph/YES BANK LIMITE/302968860578/IBL80a0fe23d9044802af555e e358a03af8/,0.0,390.0,6209.25
22-01-2025,,UPI/BHARATPE9U0O7T2/Pay to BharatPe/YesBank_Yespay/600240681113/IBL67dab d0c2f2f463a81bc3d181089d36c/,0.0,33.0,6176.25
23-01-2025,,UPI/Q483627557@ybl/Payment from Ph/YES BANK LIMITE/362706041372/IBL527426952ab44090a0933 a81da127fa0/,0.0,20.0,6156.25
23-01-2025,,UPI/Q135457944@ybl/Payment from Ph/YES BANK LIMITE/016766509763/IBL9347f47b0a5940b88fdac6 1b1bf6caae/,0.0,70.0,6086.25
23-01-2025,,UPI/paytm.s15jent@p/Payment from Ph/YES BANK PTY/485672512908/IBL681cb1fcea3b4bbdb3fea782 e88d6488/,0.0,110.0,5976.25
24-01-2025,,UPI/paytm-8796946@p/Oid801240880773/YES BANK LIMITE/502436280753/PTM50124804729714236417 202501240513,0.0,120.0,5856.25
24-01-2025,,UPI/paytm.s161ysk@p/Payment from Ph/YES BANK PTY/850366031177/IBL2512e55736e244d1aa0d63f5 755379ff/,0.0,51.0,5805.25
24-01-2025,,UPI/amazonupi@apl/You are paying/AXIS BANK/502441632550/APL01949829043ea30ff5ad21 ec038f6b90/,0.0,1254.75,4550.5
25-01-2025,,UPI/9870018114@axl/Payment from Ph/Punjab National/498966306848/IBL7b6ce271ea4040c58f8a5 17087f4835c/,0.0,58.0,4492.5
25-01-2025,,UPI/paytmqr28100505/Payment from Ph/YES BANK LIMITE/912687523519/IBL1e4b92720e0a4199bb001 c7b09632cd7,0.0,500.0,3992.5
25-01-2025,,UPI/prashantcornerp/Payment from Ph/HDFC BANK LTD/301295645051/IBL72198e57e299456fbb9a87ac 8a21bec4/,0.0,150.0,3842.5
25-01-2025,,UPI/cp.zepto13a87@a/payment on CRED/AXIS BANK/502536444907/ACD2896153345kJNYYgk/,0.0,728.27,3114.23
26-01-2025,,UPI/MCDONALDSINDIA@/Payment for PIN/AXIS BANK/905673155957/IBL8c73427e0e734835ada6e5 91946fac93/,0.0,437.02,2677.21
27-01-2025,,UPI/fitmusk387169.r/Pay via Razorpa/AXIS BANK/374848230275/AXIcd2978c3d8994cb99dfacb 6605a69f2d/,0.0,299.0,2378.21
28-01-2025,,UPI/usha73pandey-1@/UPI/TJSB SAHAKARI B/502870031054/ICIbe8ad49ae8554e98b9b2e8e8ba 33ddcc,15000.0,0.0,17378.21
01-02-2025,,UPI/gullakmoney@yes/Payment for Gul/YesBank_Yespay/539859810873/YJPf0bdba0c7 c1643a6967b6a718331f650/,0.0,1500.0,15878.21
01-02-2025,,UPI/RCollectCC@rbl/A20240530000715/RBL BANK LIMITE/022800318845/IBLf24134959e544806a43659 d19575decc/,0.0,8581.4,7296.81
01-02-2025,,NEFT-HSBCN52025020117813724-MR AKHIL SINGHAL-/ACC/NEFT           -127-008407-007- HSBC0302002,5000.0,0.0,12296.81
03-02-2025,,ACH/L&TFINANCELIMITED/ICIC7012204241002961/ C02404223133549475 C377872009,0.0,12051.0,245.81
03-02-2025,,NEFT-KKBKN62025020332494730-SAURABH PRAVESH PANDEY-PAYMENT-1546675134- KKBK0000958,150000.0,0.0,150245.81
03-02-2025,,UPI/cf.simp@icici/UPI Intent/ICICI Bank LTD /690393339118/IBLc9fcd5db23534e7abedf9fa12b82 4dfc/,0.0,6549.76,143696.05
04-02-2025,,UPI/onecardbob@yesp/In App/YesBank_Yespay/540193711702/YJP3073dcb8 c82b4befa61b2105549f1896/,0.0,52999.27,90696.78
05-02-2025,,ACH/HERO FINCORP LTD/ICIC7012709242023333/68938191,0.0,18519.0,72177.78
05-02-2025,,UPI/piramal2@yesban/UPI Mandate/YES BANK LIMITE/503618847643/YES2D5728FC151A74F4E06 400144FF9DBF7/,0.0,4707.0,67470.78
05-02-2025,,UPI/cred.club@axisb/payment on CRED/AXIS BANK/503665011493/ACD2932067334LzAaNwq/,0.0,2905.0,64565.78
05-02-2025,,UPI/cred.utility@ax/payment on CRED/AXIS BANK/503665036363/ACD2932101529VvlDmBx/,0.0,920.0,63645.78
05-02-2025,,UPI/sushant3694@oki/Payment from Ph/BANK OF MAHARAS/762080372093/IBL6766b411f0f749fd809 7fae633d2de36,0.0,12500.0,51145.78
05-02-2025,,UPI/RVSLsushant3694@oki/Payment from Ph/BANK OF MAHARAS/762080372093/IBL6766b411f0f749fd809 7fae633d2,12500.0,0.0,63645.78
05-02-2025,,UPI/sushant3694-1@o/na/HDFC BANK LTD/503640225547/ICIWCFADC66AD1FD5A30E807 847902E2DC0/,0.0,12500.0,51145.78
05-02-2025,,UPI/sushant3694@okh/na/HDFC BANK LTD/503640254178/ICIWC53B8074A60EF7607F669 B2414B56F9/,0.0,1500.0,49645.78
06-02-2025,,UPI/9967790055@ptax/Payment from Ph/ICICI Bank/731209302346/IBL3de4ff3d33564d82889f92bd ac96c72b/,0.0,5000.0,44645.78
09-02-2025,,UPI/usha73pandey@ok/Payment from Ph/ICICI Bank/761948450524/IBL684d57ec384a473cb2c048b 59c28c3b7/,0.0,43000.0,1645.78
11-02-2025,,NEFT-KKBKN62025021144324433-SAURABH PRAVESH PANDEY-PAYMENT-1546675134- KKBK0000958,24000.0,0.0,25645.78
11-02-2025,,UPI/cred.club@axisb/payment on CRED/AXIS BANK/504279309048/ACD2949788341VZBWbYb/,0.0,24906.91,738.87
11-02-2025,MOBILE BANKING,MOBILE BANKING MMT/IMPS/504214554030/RDA Vostro FIR /TRANSFERTO/HDFC Bank,3500.0,0.0,4238.87
18-02-2025,,UPI/SIMPLONLINE@axl/UPI Intent/AXIS BANK/938684432658/IBL71c74fa063a84d289718bcc 16bb8fcf9/,0.0,196.24,4042.63
24-02-2025,,UPI/sprasadsanadi@o/UPI/HDFC BANK LTD/542155259615/ICIafcb42ad32424c7999f6b6c53 d66ff1b/,0.0,1050.0,2992.63
28-02-2025,,UPI/9841052517@ybl/na/KARNATAKA BANK /505952784420/ICIWCF9F060564CEE1E5F00268F17 BDFC3B/,0.0,1152.0,1840.63
28-02-2025,,NEFT-KKBKN62025022866540155-SAURABH PRAVESH PANDEY-PAYMENT-1546675134- KKBK0000958,103000.0,0.0,104840.63
01-03-2025,,UPI/ajayyadav0911-1/Payment from Ph/AU SMALL FINANC/341727857060/IBLae8a64a2f4b1441c8926b 90aeaf10851,0.0,20000.0,84840.63
01-03-2025,,UPI/gullakmoney@yes/Payment for Gul/YesBank_Yespay/506077400291/YJPe014f54c5 81044fa91a239d6f556b950/,0.0,1500.0,83340.63
03-03-2025,,ACH/L&TFINANCELIMITED/ICIC7012204241002961/ C02404223133549475 C377872010,0.0,12051.0,71289.63
04-03-2025,,UPI/RCollectCC@rbl/C20250206000884/RBL BANK LIMITE/904005020019/IBLf7163dd0a28b4e46b50c3 54400d22ef6/,0.0,3437.19,67852.44
04-03-2025,,UPI/RCollectCC@rbl/A20240530000715/RBL BANK LIMITE/437964665994/IBLc0fb7e4967294fdabc1d42 81e2ea49cf/,0.0,8581.4,59271.04
05-03-2025,,ACH/HERO FINCORP LTD/ICIC7012709242023333/68938191,0.0,18519.0,40752.04
05-03-2025,,UPI/piramal2@yesban/UPI Mandate/YES BANK LIMITE/506493640642/YES2F8F31C31A0F0ABFE06 400144FF9DBF7/,0.0,4707.0,36045.04
05-03-2025,,UPI/cred.club@axisb/payment on CRED/AXIS BANK/543020756578/ACD3010572576VDRWEYb/,0.0,35930.04,115.0
10-03-2025,,UPI/ajayyadav0911-1/UPI/AU SMALL FINANC/506995221316/ICIa96b76fe825f42ad9512f0 1c5833a073,20000.0,0.0,20115.0
12-03-2025,,UPI/cp.zepto13a87@a/payment on CRED/AXIS BANK/507126792141/ACD3034571124VDpeKMm/,0.0,538.15,19576.85
12-03-2025,,UPI/cp.zepto13a87@a/payment on CRED/AXIS BANK/543702914180/ACD3034593444LPkmxga/,0.0,1309.79,18267.06
15-03-2025,,NEFT-KKBKN62025031589821525-SAURABH PRAVESH PANDEY-PAYMENT-1546675134- KKBK0000958,10000.0,0.0,28267.06
16-03-2025,,UPI/cred.club@axisb/payment on CRED/AXIS BANK/544128925835/ACD3043308868ykGNaXn/,0.0,24817.25,3449.81
21-03-2025,BANK CHARGES,BANK CHARGES ATD-0xx0031-RTNCHGSMar25GST,0.0,59.0,3390.81
29-03-2025,,149201504063:Int.Pd:31-12-2024 to 28-03-2025,296.0,0.0,3686.81
29-03-2025,,UPI/gangsta.rhymez@/UPI/Kotak Mahindra /508869929298/AXI7a3e90c986d041429674ad9cca9 abf56,4884.0,0.0,8570.81
30-03-2025,,UPI/maitreya.0601@o/UPI/HDFC BANK LTD/102311259391/HDFbc90c0c993034d2b9d7856 af99056d70,18000.0,0.0,26570.81
31-03-2025,,NEFT-KKBKN62025033113782668-SAURABH PRAVESH PANDEY-PAYMENT-1546675134- KKBK0000958,143438.0,0.0,170008.81
31-03-2025,,UPI/maitreya.0601@o/UPI/HDFC BANK LTD/509024293293/ICIbe7d852dac56423f816ac2c52 d0d9ec8/,0.0,35000.0,135008.81
01-04-2025,,UPI/gullakmoney@yes/Payment for Gul/YesBank_Yespay/509144162548/YJPd2e8f32ed 4c64b3ea0f4e35907345e23/,0.0,1500.0,133508.81
01-04-2025,,UPI/RCollectCC@rbl/C20250206000884/RBL BANK LIMITE/870778684573/IBLec3e2c31e41748179148e 3dbec1dca8a/,0.0,3254.07,130254.74
01-04-2025,,UPI/RCollectCC@rbl/A20240530000715/RBL BANK LIMITE/525179038318/IBL985c21e8df1840f58dad11 6eccf6a2be/,0.0,8581.4,121673.34
02-04-2025,,UPI/maitreya.0601@o/UPI/ICICI Bank/509270522355/ICIac28a9b0d1d34aa5b0d8b43 56e9bad98,35000.0,0.0,156673.34
03-04-2025,,ACH/L&TFINANCELIMITED/ICIC7012204241002961/ C02404223133549475 C377872011,0.0,12051.0,144622.34
03-04-2025,,UPI/usha73pandey@ok/Payment from Ph/ICICI Bank/091189230132/IBLb50014f5f588415098595f4c db8b7b2e/,0.0,60000.0,84622.34
03-04-2025,,UPI/19rohan92@okhdf/2025 Q1/HDFC BANK LTD/102552496712/HDF05fdfeb109b64157b672322 2c3702db2,20667.0,0.0,105289.34
04-04-2025,,UPI/cred.club@axisb/payment on CRED/AXIS BANK/509492940307/ACD3099599207nJKWWvn/,0.0,55869.58,49419.76
05-04-2025,,ACH/HERO FINCORP LTD/ICIC7012709242023333/68938191,0.0,18519.0,30900.76
05-04-2025,,UPI/firstcry.payu@h/Payment from Ph/HDFC BANK LTD/508803067045/PPPL2305778957105042513594 267f0e9f6/,0.0,1541.61,29359.15
05-04-2025,,UPI/piramal2@yesban/UPI Mandate/YES BANK LIMITE/509585931337/YES3204415306063901E064 00144FF88612/,0.0,4707.0,24652.15
06-04-2025,,UPI/khnsaad07-2@oki/UPI/TJSB SAHAKARI B/509659391829/ICI0b790f6fb8294771a39cf0e606b 781cd,50000.0,0.0,74652.15
06-04-2025,,UPI/lalnunsangihmar/Payment from Ph/MIZORAM RURALB/035508641471/IBL6f42d5ebc73a48038abe e271052b9ca0,0.0,5000.0,69652.15
06-04-2025,,UPI/mondalsom02@ybl/Payment from Ph/AXIS BANK/295193350885/IBL60eeb780651e4ab7933d22 e4020a539c/,0.0,36000.0,33652.15
06-04-2025,,UPI/lalnunsangihmar/Payment from Ph/MIZORAM RURALB/889528217927/IBL4bf29352809f44aea0f76 ca6423c2d51,0.0,5000.0,28652.15
07-04-2025,,NEFT-KKBKN62025040722391802-SAURABH PRAVESH PANDEY-PAYMENT-1546675134- KKBK0000958,114237.0,0.0,142889.15
07-04-2025,,UPI/mondalsom02@ybl/Payment from Ph/AXIS BANK/147619820043/IBLf9835c50fd3547e1baa78dd 86dad94b8/,0.0,50000.0,92889.15
08-04-2025,,UPI/9821418841@ptax/Payment from Ph/BANK OF INDIA/422184486970/IBL6669a7e4ba834694847c85f 2ae134b2c/,0.0,1000.0,91889.15
08-04-2025,,UPI/sasanka.biswas8/Payment from Ph/HDFC BANK LTD/967605557968/IBL7b72b1a4c0584cf8b1d667c2 4c818467/,0.0,57000.0,34889.15
08-04-2025,,UPI/paytmqr59tmhm@p/Payment from Ph/YES BANK LIMITE/202504209853/IBL4b98f05fcf0342ef90f737b be4383b35,0.0,20.0,34869.15
08-04-2025,,UPI/Q135457944@ybl/Payment from Ph/YES BANK LIMITE/849490403795/IBL2a59a55738e54d9da63f34 9f49b0b592/,0.0,60.0,34809.15
09-04-2025,,UPI/9967790055@ptax/Payment from Ph/ICICI Bank/490710826865/IBL1eb0a18d04824a368e43a9f a64e91f36/,0.0,17600.0,17209.15
11-04-2025,,UPI/wellnessforever/Payment from Ph/HDFC BANK LTD/342866737667/PLUTUSDQR000000000000272 55643001109/,0.0,2718.0,14491.15
11-04-2025,,UPI/paytm.s1c0kon@p/Payment from Ph/YES BANK PTY/940987900821/IBL75c6d0c74fa541d29898e752 4facd517/,0.0,40.0,14451.15
11-04-2025,MOBILE BANKING,MOBILE BANKING MMT/IMPS/510117026720/Paid via CRED/DREAMPLUG /Yes Bank,1.0,0.0,14452.15
11-04-2025,,UPI/prashantcornerp/UPI/HDFC BANK LTD/510113876741/ICI3bed3503bee94eca94171244 6fae2e0d/,0.0,618.0,13834.15
11-04-2025,,UPI/maharashtralunc/Payment from Ph/HDFC BANK LTD/171520581015/IBLa0e27fba28cc4c30a83b6d30 1695e445/,0.0,1575.0,12259.15
12-04-2025,,UPI/9680516797@ptax/Sent using Payt/ICICI Bank/510209847651/PTM26e4d90bf16441e594ca6a c9a8a7c38b,40000.0,0.0,52259.15
12-04-2025,MOBILE BANKING,MOBILE BANKING MMT/IMPS/510219018034/P2AMOB/PL PENNY D/Indusind Bank,1.0,0.0,52260.15
12-04-2025,,UPI/cred.club@axisb/payment on CRED/AXIS BANK/510233699986/ACD3123274926ZJNKKWG/,0.0,25373.87,26886.28
13-04-2025,,UPI/rajshreelottery/3734949611/AXIS BANK/122483831035/AXI493a03c65d2b40569810fd 6e4b5f50b8/,0.0,1250.0,25636.28
13-04-2025,,UPI/chauhanansh754-/UPI/BANK OF BARODA/510378057417/AXI96267b3fd6844b0ab26 4c0598372d11b,100.0,0.0,25736.28
13-04-2025,,UPI/nikittalreja56@/Payment from Ph/JANAKALYAN SAHA/014801201864/IBLd512f28a9bf446959ac5034 136a29639,0.0,455.0,25281.28
13-04-2025,,UPI/9619720122@kota/Payment from Ph/Kotak Mahindra /333868079735/IBLf944c6a1695040fa9b18ee8470eb 442a,0.0,515.0,24766.28
14-04-2025,,UPI/gpay-1124087848/Payment from Ph/AXIS BANK/255670331691/IBLdd1e1eb548664aeb9f0f3fd a01b4d10d/,0.0,4000.0,20766.28
14-04-2025,MOBILE BANKING,MOBILE BANKING MMT/IMPS/510410648291/adityaBirlaFina/PERFIOS SO/IDFC bank,1.0,0.0,20767.28
14-04-2025,,UPI/adityabirlafina/Pay via Razorpa/ICICI Bank LTD /510490934313/ICI11f562937ba2449181b842b81767 ea0a,0.0,1.0,20766.28
14-04-2025,MOBILE BANKING,MOBILE BANKING MMT/IMPS/510410475727/IMPS transactio/ADITYA BIR/HDFC Bank,173923.0,0.0,194689.28
14-04-2025,,UPI/WFMLMH1@ybl/Payment for 500/YES BANK LIMITE/071855839678/IBL9981a493c55d42f3859c7a ff051c9023/,0.0,484.93,194204.35
14-04-2025,,UPI/Getepay.svccblq/Payment from Ph/ICICI Bank LTD /412787290694/IBLe69a048a229644f185b8bca6b2fd 1b58,0.0,120.0,194084.35
14-04-2025,,UPI/paytm.s1exzjx@p/Payment from Ph/YES BANK PTY/053668025232/IBL8bb5768d8a054f2d9a005955 d8672120/,0.0,890.0,193194.35
14-04-2025,,UPI/73796356@axl/Payment from Ph/AIRTEL PAYMENTS/171508702287/IBL4ef88e87224f4356a6 ca36dc9395bc9d/,0.0,70.0,193124.35
14-04-2025,,BIL/INFT/EDI1738450/ GAURAV JAIN,0.0,122887.0,70237.35
14-04-2025,,UPI/khnsaad07-2@oki/Payment from Ph/TJSB SAHAKARIB/367726959768/IBLf0bffd50b79a4ce394 4c35ecef0543a8,0.0,60000.0,10237.35
14-04-2025,,NEFT-KKBKN62025041433127691-SAURABH PRAVESH PANDEY-PAYMENT-1546675134- KKBK0000958,10000.0,0.0,20237.35
14-04-2025,,UPI/Bank Account XX/Payment from Ph/HDFC BANK LTD/107165893635/IBL2274693b6d6f4bf681ae7525 924ba870/,0.0,18682.0,1555.35
15-04-2025,,UPI/khnsaad07-2@oki/UPI/TJSB SAHAKARI B/547113627674/ICI9b527f787a39456b8ae6b4047c d9930d,30000.0,0.0,31555.35
15-04-2025,,NEFT-KKBKN62025041534140163-SAURABH PRAVESH PANDEY-PAYMENT-1546675134- KKBK0000958,10000.0,0.0,41555.35
15-04-2025,MOBILE BANKING,MOBILE BANKING MMT/IMPS/510517278953/Maitreya A/HDFC0999999/chgRs15.00GSTRs2.70,0.0,30017.7,11537.65
15-04-2025,,UPI/paytm-8740090@p/Payment from Ph/YES BANK LIMITE/803252453954/IBLce6a5eb9f21d412b8c0274 163332bd49,0.0,500.0,11037.65
16-04-2025,MOBILE BANKING,MOBILE BANKING MMT/IMPS/510618894209/P2AMOB/PL PENNY D/Indusind Bank,1.0,0.0,11038.65
16-04-2025,,UPI/9821190002@okbi/Payment from Ph/AXIS BANK/479691824327/IBLeb4102a326e74d46b2f9ad 01b3b22a9d/,0.0,1050.0,9988.65
17-04-2025,,NEFT-KKBKN62025041737420044-SAURABH PRAVESH PANDEY-PAYMENT-1546675134- KKBK0000958,20000.0,0.0,29988.65
17-04-2025,,UPI/sanketpawaskar0/UPI/ICICI Bank/547383005561/ICI96ef0d1d49b1439b97cf981d 1ea1792e/,0.0,20000.0,9988.65
17-04-2025,,UPI/firstcry@yesban/UPI Payment./YES BANK LIMITE/510719762939/YESB32FC63A3BAF40C67E0 6400144FF8861,629.37,0.0,10618.02
17-04-2025,,UPI/nikittalreja56@/Payment from Ph/JANAKALYAN SAHA/632241648434/IBL26a223d6edde4a67800b44 09407132fe,0.0,1110.0,9508.02
17-04-2025,,UPI/rajagopalthevar/Payment from Ph/TAMILNAD MERCAN/955112511009/IBL6b59348b96d5483dbac e8afb34f071f7,0.0,190.0,9318.02
17-04-2025,,UPI/Q569146019@ybl/Payment from Ph/YES BANK LIMITE/346465386757/IBL44531ab745a14c0baddd8 caa62e2a194/,0.0,240.0,9078.02
18-04-2025,,UPI/8421486667@ybl/Payment from Ph/DHANALAXMI BANK/375807643990/IBLdabfcf8c2dc14143b13a4d1 2b46f1a6b/,0.0,46.0,9032.02
18-04-2025,,UPI/9819772797@ybl/UPI/UNION BANK OF I/547446127252/ICIc6bc3628f6e74f75b0aadc5d6d8f 8c4a/,0.0,60.0,8972.02
18-04-2025,,NEFT-KKBKN62025041838470180-SAURABH PRAVESH PANDEY-PAYMENT-1546675134- KKBK0000958,10000.0,0.0,18972.02
18-04-2025,,UPI/paytmqr28100505/Payment from Ph/YES BANK LIMITE/957650749318/IBL8488f3f6be9e4b238c387d adebab921a,0.0,85.0,18887.02
18-04-2025,,UPI/paytmqr5dd94g@p/Payment from Ph/YES BANK LIMITE/860598591046/IBL1931897385d04ec2911bb 81140e8bfe7,0.0,20.0,18867.02
18-04-2025,,UPI/paytmqr5dd94g@p/Payment from Ph/YES BANK LIMITE/184669776126/IBLccad29ccf2b14c8b8ae00f 1971a6a5e2,0.0,44.0,18823.02
18-04-2025,,UPI/sureshyadasures/Payment from Ph/AIRTEL PAYMENTS/522182512021/IBL28b4789f4f0645039a 164605217b4f6e,0.0,48.0,18775.02
19-04-2025,,UPI/kanojiyaramchan/Payment from Ph/State Bank OfI/616634722196/IBL053bde8c2e9b45999a44a812 c3c79e1c,0.0,208.0,18567.02
19-04-2025,MOBILE BANKING,MOBILE BANKING MMT/IMPS/510920027727/Aadrila Technol/Cashfree P/Kotak Mahindra,1.0,0.0,18568.02
19-04-2025,,UPI/8689856516@pthd/Payment from Ph/Kotak Mahindra /074319297150/IBL61b517dce0e64027a7a78734876 f69e0,0.0,100.0,18468.02
19-04-2025,,UPI/paytmqr28100505/Payment from Ph/YES BANK LIMITE/196509152690/IBL874c8a3d2a474230b8285 438d7bf7973,0.0,42.0,18426.02
19-04-2025,,UPI/WFMLMH1@ybl/Payment for 500/YES BANK LIMITE/653583157420/IBLc4a30da4450048c5820ba 0b888e6668b/,0.0,199.98,18226.04
20-04-2025,MOBILE BANKING,MOBILE BANKING MMT/IMPS/511010164585/Saurabh Pa/KKBK0001374/chgRs5.00GSTRs0.90,0.0,10005.9,8220.14
20-04-2025,MOBILE BANKING,MOBILE BANKING MMT/IMPS/511010164585/Saurabh Pa/KKBK0001374,10005.9,0.0,18226.04
20-04-2025,MOBILE BANKING,MOBILE BANKING MMT/IMPS/511010165934/Saurabh Pa/KKBK0001374/chgRs5.00GSTRs0.90,0.0,10005.9,8220.14
20-04-2025,MOBILE BANKING,MOBILE BANKING MMT/IMPS/511010165934/Saurabh Pa/KKBK0001374,10005.9,0.0,18226.04
20-04-2025,,UPI/paytmqr69lddd@p/Payment from Ph/YES BANK LIMITE/010753964626/IBL58f4c5f560064139809a3a dcef5be07b,0.0,990.0,17236.04
20-04-2025,,UPI/BHARATPE.900707/Pay to BharatPe/FEDERAL BANK/042828461329/IBL0db2fd9cf151421d84fc0e0 296771f13/,0.0,40.0,17196.04
20-04-2025,,UPI/paytm.s1exzjx@p/Payment from Ph/YES BANK PTY/289496530065/IBLa66dd789152e4e3bbc875d9 414576d6c/,0.0,490.0,16706.04
20-04-2025,,UPI/airtel-billpaym/Airtel Broadban/YES BANK LIMITE/547640406742/PYTM5042080459730174670 5XXXXXXXXXXX,0.0,2356.46,14349.58
20-04-2025,,UPI/zeptomarketplac/ZEPTOMARKETPLAC/AIRTEL PAYMENTS/199809123488/IBL55a20588902947d2b fb142efdec1d77e,0.0,133.0,14216.58
21-04-2025,,UPI/9867544006@axis/Payment from Ph/AXIS BANK/008869763314/IBL794420f4323b450585bde0 981f2f231a/,0.0,521.0,13695.58
21-04-2025,,UPI/paytmqrzlqa46zx/Payment from Ph/YES BANK LIMITE/663008253887/IBL53c3d3cb00cf4a3f9b5a4d bdf5d685ab,0.0,2.0,13693.58
21-04-2025,,UPI/nikittalreja56@/Payment from Ph/JANAKALYAN SAHA/205292030821/IBLf664cfcb70644b7bb4d313 34c5805530,0.0,900.0,12793.58
21-04-2025,,UPI/paytmqr6778qy@p/Payment from Ph/YES BANK LIMITE/394702927094/IBL902701f6a9324240a0708c cebcda297d,0.0,400.0,12393.58
21-04-2025,,UPI/Q330630816@ybl/Payment from Ph/YES BANK LIMITE/558481164574/IBLa5707b9c8fb54e28a36a21 ea840bbd6a/,0.0,2.0,12391.58
22-04-2025,MOBILE BANKING,MOBILE BANKING MMT/IMPS/511212004771/FTTransferP2A/Ram singh  toSAURABH PA,1.0,0.0,12392.58
22-04-2025,,UPI/maitreya.0601@o/UPI/HDFC BANK LTD/103589694920/HDFc656e1a55fb64089b1e52ed 07f8ead6b,35000.0,0.0,47392.58
22-04-2025,,UPI/Q330630816@ybl/Payment from Ph/YES BANK LIMITE/521666501313/IBL0b2fae63b9c349a6891ab0 fb61e9c2b6/,0.0,30.0,47362.58
22-04-2025,,UPI/Q330630816@ybl/Payment from Ph/YES BANK LIMITE/073217529112/IBLef584614730c44fa820e5ff cfdce15e0/,0.0,20.0,47342.58
22-04-2025,,UPI/nikittalreja56@/Payment from Ph/JANAKALYAN SAHA/900675503307/IBL51a9ce29e6564d88a96ab4 e7a7849a6d,0.0,720.0,46622.58
22-04-2025,,UPI/paytmqr6778qy@p/Payment from Ph/YES BANK LIMITE/557859102628/IBL85928aeccde04660aae75 2fa69e5034d,0.0,200.0,46422.58
22-04-2025,,UPI/paytmqr28100505/Payment from Ph/YES BANK LIMITE/158960441405/IBL5f73d63446864091965692 d3021936d1,0.0,499.0,45923.58
24-04-2025,,UPI/zeptomarketplac/ZEPTOMARKETPLAC/AIRTEL PAYMENTS/329444190709/IBL8204a8aba53b49029 09f7c731ba0de5e,0.0,313.0,45610.58
24-04-2025,,UPI/zeptomarketplac/home/AXIS BANK/111870620681/IBL2b6eee21931c45f7999100 c68b7d04d1/,0.0,178.0,45432.58
24-04-2025,,UPI/pg.razorpay@axi/ZEPTOMARefundQM/AXIS BANK/406695771145/AXIac699b5a2da94a72ae2825 81ed54406a,48.79,0.0,45481.37
24-04-2025,,UPI/Q373183419@ybl/Payment from Ph/YES BANK LIMITE/250333588709/IBL2c83b9ddbbba498b8c9c9 dc8ef246dc0/,0.0,30.0,45451.37
24-04-2025,,UPI/paytmqr28100505/Payment from Ph/YES BANK LIMITE/241185754087/IBLb4ec8baef5f847dfac203d 2e108ed6ea,0.0,800.0,44651.37
25-04-2025,,UPI/Q330630816@ybl/Payment from Ph/YES BANK LIMITE/081456344549/IBLcf7d134077d743f7acdd21 b716e72c79/,0.0,36.0,44615.37
25-04-2025,,UPI/nikittalreja56@/Payment from Ph/JANAKALYAN SAHA/229581200686/IBL95e5a51f89fd4f51bdc4ace b17a45500,0.0,855.0,43760.37
25-04-2025,,UPI/paytmqr6a7wdp@p/Payment from Ph/YES BANK LIMITE/099186638845/IBL1e216254b81c4d42a19db 67736c5a351,0.0,72.0,43688.37
26-04-2025,,UPI/Q077186394@ybl/Payment from Ph/YES BANK LIMITE/141021806233/IBLf0d61d8e03fd40e8a596cc 2ba6c8799e/,0.0,250.0,43438.37
26-04-2025,,UPI/paytmqr28100505/Payment from Ph/YES BANK LIMITE/687778455264/IBL20b5fd3a589543859b111 97182cd4342,0.0,365.0,43073.37
26-04-2025,,UPI/gaurisathal022@/Payment from Ph/UJJIVAN SMALLF/448211690570/IBLacfaa0fc488f4172bf72fc 98350f6ca7,0.0,100.0,42973.37
27-04-2025,,UPI/kanojiyaramchan/Payment from Ph/State Bank OfI/064255530181/IBL7e3c69dedb2f4c309e31a6699 03a55ef,0.0,96.0,42877.37
27-04-2025,,UPI/ibkPOS.EP109661/Payment from Ph/ICICI Bank/827179666224/IBL85bd82ffd8db404fbd2f5eab a432ea5a/,0.0,330.0,42547.37
27-04-2025,,UPI/ibkPOS.EP109661/Payment from Ph/ICICI Bank/145217998754/IBLdc7b3c2951c94e21a79d5dc 3b479a01e/,0.0,139.0,42408.37
27-04-2025,,UPI/WELLNESSFOREVER/Payment for 500/YES BANK LIMITE/554076144516/IBLc511b6e4886542efa22794 248018d0d9,0.0,1199.0,41209.37
27-04-2025,,UPI/paytm.s1exzjx@p/Payment from Ph/YES BANK PTY/957060182726/IBLf7e7287a5cd7467ca81d56aaf 98cf2d8/,0.0,73.0,41136.37
27-04-2025,,UPI/Q330630816@ybl/Payment from Ph/YES BANK LIMITE/039700622721/IBL99837914c4094ba29a0f06 cb2842ff8e/,0.0,36.0,41100.37
27-04-2025,,UPI/9619720122@kota/Payment from Ph/Kotak Mahindra /365247921710/IBLe1e3632dd54647a2958fddfb4cf0 379f,0.0,200.0,40900.37
27-04-2025,,UPI/Q077186394@ybl/Payment from Ph/YES BANK LIMITE/278565737642/IBL49627aeaf44a4e6582b9f6 9fb447e203/,0.0,300.0,40600.37
27-04-2025,,UPI/paytmqr6a7wdp@p/Payment from Ph/YES BANK LIMITE/742615716919/IBL1d297aa9bdc6405886c44 054be7c0810,0.0,38.0,40562.37
28-04-2025,,UPI/lalnunsangihmar/Payment from Ph/MIZORAM RURALB/834816433678/IBLbe573cfbe91a43918f93c 7f3908d5486,0.0,10000.0,30562.37
28-04-2025,MOBILE BANKING,MOBILE BANKING MMT/IMPS/511811197336/transferSaurabh/HIMAN K JAI/Equitas Small F,5000.0,0.0,35562.37
28-04-2025,MOBILE BANKING,MOBILE BANKING MMT/IMPS/511817284284/pay for lossSau/HIMANK JAI/Equitas Small F,20000.0,0.0,55562.37
28-04-2025,,UPI/firstcry.payu@h/UPIIntent/HDFC BANK LTD/098570173240/PPPL2332827364128042519110 6680f8572/,0.0,625.05,54937.32
28-04-2025,,BIL/INFT/EDW3657908/ GAURAV JAIN,0.0,40535.0,14402.32
29-04-2025,,UPI/paytmqr68uc01@p/Payment from Ph/YES BANK LIMITE/143153717990/IBL55e936b43a3f498bbae7ae 15e4a5468f,0.0,30.0,14372.32
29-04-2025,,UPI/jayanta.konar25/UPI/BANK OF INDIA/548527853907/AXI1e245880eb26498fb4afff9 1ad5bf128,10000.0,0.0,24372.32
29-04-2025,,UPI/nikittalreja56@/Payment from Ph/JANAKALYAN SAHA/607894540432/IBL7b61bf0f9f734d5f96faa0ca 503f36b7,0.0,1050.0,23322.32
29-04-2025,,UPI/paytmqr28100505/Payment from Ph/YES BANK LIMITE/554530425361/IBLaa35ce6b0805403aa35d4 9b7a7192fdb,0.0,117.0,23205.32
30-04-2025,MOBILE BANKING,MOBILE BANKING MMT/IMPS/512006686615/transfer for lo/HIMANK JAI/Equitas Small F,15000.0,0.0,38205.32
30-04-2025,,UPI/zeptomarketplac/ZEPTOMARKETPLAC/AIRTEL PAYMENTS/759639526243/IBLebb267c8986349a4a 2c22b5c390a65d0,0.0,2348.0,35857.32
30-04-2025,,UPI/ashoklagoon-1@o/Payment from Ph/HDFC BANK LTD/290021241829/IBL5f1ea5228f3f4622aea10bbca 1621f17/,0.0,6999.0,28858.32
30-04-2025,,UPI/paytmqr63v5ej@p/Payment from Ph/YES BANK LIMITE/972303766957/IBLb4cc1608e2ec431f970d8e 3eac82f36f,0.0,20.0,28838.32
30-04-2025,,UPI/Q468223197@ybl/Payment from Ph/YES BANK LIMITE/009170867213/IBL3b668494e1b446ed8580c ec0eb2698a2/,0.0,18.0,28820.32
30-04-2025,,UPI/9930633155@ptye/Payment from Ph/UNION BANK OFI/092338246965/IBL3f8531e4f09d4db8b8ace5f26 276b396,0.0,45.0,28775.32
01-05-2025,,UPI/8961658656@ybl/Payment from Ph/BANDHAN BANK LT/177383075416/YBL0e81671ea1d44cb39c7c2dca 162a8825,15000.0,0.0,43775.32
01-05-2025,,UPI/9163959198@ikwi/Payment from Ph/State Bank OfI/121500434373/IBLb68d21fa6b4e4df385860a32e 7d89196,0.0,15000.0,28775.32
01-05-2025,,UPI/shankarsaw9326@/Payment from Ph/UNION BANK OFI/894465017211/IBLa3c4a783679a422683d6be71 493bcaab,0.0,62.0,28713.32
01-05-2025,,UPI/gpay-1118385312/Payment from Ph/AXIS BANK/074227463962/IBL6f430a73ec9243558fdb8d4 f4e78e235/,0.0,400.0,28313.32
01-05-2025,,UPI/saw104380@okici/Payment from Ph/BANK OF BARODA/529979194128/IBLd73f57c3c8bb4c719be2 2cc94c073daf/,0.0,30.0,28283.32
01-05-2025,,UPI/onecardbob@yesp/In App/YesBank_Yespay/512133247882/YJP7ede56f1 db354231b2737de665330d1f/,0.0,5889.92,22393.4
01-05-2025,,NEFT-KKBKN62025050155155605-SAURABH PRAVESH PANDEY-PAYMENT-1546675134- KKBK0000958,100000.0,0.0,122393.4
01-05-2025,,UPI/RCollectCC@rbl/A20240530000715/RBL BANK LIMITE/381872021759/IBLdaddbb69a2574529bcba5 3a66bafb1ca/,0.0,8582.0,113811.4
01-05-2025,,UPI/RCollectCC@rbl/C20250206000884/RBL BANK LIMITE/690018356972/IBL3828623acc4543f89192be 9c99087159/,0.0,3247.0,110564.4
01-05-2025,,UPI/gullakmoney@yes/Payment for Gul/YesBank_Yespay/512134301734/YJP386343756 69844b099d190be94dfc15e/,0.0,1500.0,109064.4
02-05-2025,,UPI/WFMLMH1@ybl/Payment for 500/YES BANK LIMITE/945045004458/YBL46d0281f3bbb4d759605 ba0943c6ce4d/,0.0,539.85,108524.55
02-05-2025,,UPI/Q330630816@ybl/Payment from Ph/YES BANK LIMITE/516268322047/IBL3714431b103048b3890a7 f0d9d5d614b/,0.0,74.0,108450.55
02-05-2025,,UPI/Vyapar.17087166/Payment from Ph/HDFC BANK LTD/925403931644/IBL76aa6a2fbb9a496fa2cc806d8 da557c4/,0.0,1191.0,107259.55
03-05-2025,,ACH/L&TFINANCELIMITED/ICIC7012204241002961/ C02404223133549475 C377872012,0.0,12051.0,95208.55
03-05-2025,,UPI/amazonpaybalanc/You are paying/AXIS BANK/644028785933/APLe92cc8ad79954d6bbd60c 87dad9a3d33/,0.0,350.0,94858.55
03-05-2025,,UPI/amazonpaybalanc/You are paying/AXIS BANK/102597917385/APL4d0d1fc11bf94422b3fac7 0e61d317c0/,0.0,4328.0,90530.55
03-05-2025,,UPI/gpay-1124995380/Payment from Ph/AXIS BANK/669871738959/IBLd23cd6ad95354c8e9616f0 db0454a4f9/,0.0,30.0,90500.55
03-05-2025,,UPI/9199monu123@oki/Payment from Ph/INDIA POST PAYM/535221020605/IBLaf67a37b9e7943e1858d75 cba61c60a1,0.0,50.0,90450.55
03-05-2025,,UPI/gpay-1125778633/Payment from Ph/AXIS BANK/692020815229/IBL36b758112efc435d95d54d ce6082db23/,0.0,35.0,90415.55
03-05-2025,,UPI/amazonpay@apl/You are paying/AXIS BANK/464375308315/APL9dbd3a4a81d54aa094d30 4e59d0c07ab/,0.0,376.55,90039.0
03-05-2025,,UPI/gpay-1125362070/Payment from Ph/AXIS BANK/259280969362/IBLeefd7d794cd9449c8d7a7f7 365f51e7d/,0.0,200.0,89839.0
03-05-2025,,UPI/gpay-1125670032/Payment from Ph/AXIS BANK/189040445613/IBLa7c476e286ab47acbe4834 0ede788f36/,0.0,2.0,89837.0
03-05-2025,,UPI/paytmqr1qc1ayro/Payment from Ph/YES BANK LIMITE/314009911468/IBLbfc64e5f7b244722848c91 ef8161a1a8,0.0,170.0,89667.0
04-05-2025,,UPI/simpl@axb/UPI Intent/AXIS BANK/512410651848/moztfM9TFCJE8MTjXGJ/,0.0,3158.8,86508.2
04-05-2025,,UPI/paytm.s1exzjx@p/Payment from Ph/YES BANK PTY/828147477339/IBL4d5fa33b35104c95b15c540d f3aa89c1/,0.0,137.0,86371.2
04-05-2025,,UPI/gpay-1124995380/Payment from Ph/AXIS BANK/114071973542/IBL599c2d730867467487c5e5 6a832f61ec/,0.0,25.0,86346.2
05-05-2025,,ACH/HERO FINCORP LTD/ICIC7012709242023333/68938191,0.0,18519.0,67827.2
05-05-2025,,UPI/piramal2@yesban/UPI Mandate/YES BANK LIMITE/512567622249/YES345C259886CD2635E064 00144FFA73D1/,0.0,4707.0,63120.2
05-05-2025,,UPI/adityabirlafina/Pay via Razorpa/ICICI Bank LTD /549093315985/ICIa4758cbd0c5449b7a95b6bbfe8b 9fe0b,0.0,10855.0,52265.2
05-05-2025,,UPI/Vyapar.17158899/Payment from Ph/HDFC BANK LTD/162708373030/IBL6e68ec459e9b47799c775714 6a3dd8ba/,0.0,400.0,51865.2
05-05-2025,,UPI/Q594128025@ybl/Payment from Ph/YES BANK LIMITE/868250767062/IBLbf16e3967c3b45c29b53c7 87fc50140c/,0.0,440.0,51425.2
05-05-2025,,UPI/WFMLMH2@ybl/Payment for 500/YES BANK LIMITE/139036824981/IBL808307756cb34aedaa39f4 ba3b00c07a/,0.0,453.77,50971.43
05-05-2025,,UPI/tejalpadave1997/Payment from Ph/BANK OF BARODA/777722926559/IBL007600ff9d554466bef14 acd69af7ba2/,0.0,1100.0,49871.43
06-05-2025,,UPI/paytmqr1ppe1yww/Payment from Ph/YES BANK LIMITE/423969068835/IBLb9a8db28acb5460d813f9 9edd9bb4300,0.0,390.0,49481.43
07-05-2025,,UPI/0123sahafaizan-/Payment from Ph/UNION BANK OFI/343987991751/IBL5aa50aebdefa4bd293d60870 b99fb305,0.0,929.0,48552.43
08-05-2025,,UPI/tejalpadave1997/Payment from Ph/BANK OF BARODA/381864897371/IBL79c18becbed246ac86d 1992838481f8f/,0.0,400.0,48152.43
08-05-2025,,UPI/paytmqr67wr1v@p/Payment from Ph/YES BANK LIMITE/500890080869/IBLcbbc7171bc5f4374a0db4 73b2e725933,0.0,38.0,48114.43
09-05-2025,,UPI/anisansari90000/Payment from Ph/HDFC BANK LTD/791536348669/IBL30c50f6e41da44ff990da5feb cec230a/,0.0,89.0,48025.43
09-05-2025,,UPI/gpay-1118385312/Payment from Ph/AXIS BANK/792149184529/IBLe207bb3d9eba4ce582e24c 7437d52b4d/,0.0,400.0,47625.43
09-05-2025,,UPI/yespay.mabs.106/Payment from Ph/YesBank_Yespay/854969801571/IBL3216dd9f2d 834929ae8c11fe69fd5574/,0.0,1000.0,46625.43
09-05-2025,,UPI/kalpy82740092@b/5FLU/BANK OF BARODA/854423771691/IBL2d22ff33767144229f574 3bfff23819e/,0.0,1000.0,45625.43
09-05-2025,,UPI/917391807419@in/e5Rk/INDIAN BANK/512936038120/ICIc0c70fb71b5e4aeebe03f9d 71135bc89/,0.0,500.0,45125.43
10-05-2025,,UPI/9745383366@ikwi/UPI/State Bank Of I/513028137556/ICI7c236841425d42579dc56f7ad6a 0532e/,0.0,5000.0,40125.43
10-05-2025,,UPI/paytmqr74b8ewjk/Payment from Ph/YES BANK LIMITE/301102635730/IBL1089ded52cc84110a29d9 c8611fe3082,0.0,1936.0,38189.43
10-05-2025,,UPI/7039535320@okbi/Payment from Ph/AXIS BANK/501870272109/YBLebbe7023d78641bb9bb75 dffa6c84011/,0.0,35.0,38154.43
10-05-2025,,UPI/kanchantiwari.9/UPI/ICICI Bank/513029433899/ICI60e4f5a3070647048d9aaaae b9e9ea82,30000.0,0.0,68154.43
10-05-2025,,UPI/usha73pandey@ok/UPI/ICICI Bank/513075545483/ICI8668ef23d1424598aec12757 c7da9deb/,0.0,43000.0,25154.43
10-05-2025,,UPI/6383909681-m46a/Payment from Ph/INDIAN OVERSEAS/527251405830/IBLa27fce19f68b4841b4f ea1446dded651,0.0,1000.0,24154.43
10-05-2025,,UPI/9578960076@ikwi/UPI/ICICI Bank/513096447964/ICIe764c0b319e049a09ec6ceaa d20cbf7b/,0.0,1000.0,23154.43
10-05-2025,,UPI/8179073862@ikwi/UPI/KARNATAKA BANK /513095065551/ICIc07401cdb427440e81130047824 d51bd/,0.0,2000.0,21154.43
10-05-2025,MOBILE BANKING,MOBILE BANKING MMT/IMPS/513028137379/FXP10023316617/Beeinb ox  /Ratnakar Bank,1170.0,0.0,22324.43
10-05-2025,,UPI/9035791251@axl/Payment from Ph/HDFC BANK LTD/194650614181/AXL7376ba1d7f0b4388acf5306 b067a85c0,25810.0,0.0,48134.43
10-05-2025,,UPI/paytmqr28100505/Payment from Ph/YES BANK LIMITE/158175527342/IBL18d848634b53437d9a330 eb70a0fb9cc,0.0,92.0,48042.43
10-05-2025,,UPI/paytmqr28100505/Payment from Ph/YES BANK LIMITE/934383903939/IBLf83a679ab7f7406f983617f bf5cdecf2,0.0,20.0,48022.43
10-05-2025,,UPI/paytm.s15jf0g@p/Payment from Ph/YES BANK PTY/975628374636/IBL24e199b889ac48c08d2c4aa3 12097e56/,0.0,113.0,47909.43
11-05-2025,,UPI/mfinservices@su/Payout/Suryoday Small /513100233231/SUR2F42AC9D17F34173895E4C70C C608E08,2104.0,0.0,50013.43
11-05-2025,,UPI/cf.zeptonowltd@/Payment from Ph/ICICI Bank LTD /709200682602/IBLf0199e5a1b6448529c941b01896 aabe5,0.0,429.0,49584.43
11-05-2025,,UPI/tejalpadave1997/Payment from Ph/BANK OF BARODA/789080758065/IBL0fe528124d4845818c26 7080bfa3aa29/,0.0,965.0,48619.43
11-05-2025,,UPI/Q077186394@ybl/Payment from Ph/YES BANK LIMITE/374556390597/IBL70f7b258ce2b4300a839a8 369efb0061/,0.0,640.0,47979.43
11-05-2025,,UPI/WFMLMH1@ybl/Payment for 500/YES BANK LIMITE/977926358508/IBL746ff05eeced49fb9684d4 82048ccc0b/,0.0,344.96,47634.47
12-05-2025,,UPI/saritajahdav987/Payment from Ph/State Bank OfI/668869243995/IBL990d6a976f4b4792a8fb6f3c66 ecae76,0.0,16000.0,31634.47
12-05-2025,,NEFT-KKBKN62025051270678247-SAURABH PRAVESH PANDEY-PAYMENT-1546675134- KKBK0000958,10000.0,0.0,41634.47
12-05-2025,,UPI/cred.club@axisb/payment on CRED/AXIS BANK/549807688054/ACD3206645657lqPKMPG/,0.0,36475.43,5159.04
12-05-2025,,UPI/paytmqr69z2f3@p/Payment from Ph/YES BANK LIMITE/750777418733/IBL578395428b254ff5ae45a2 016372a653,0.0,28.0,5131.04
12-05-2025,,UPI/paytmqr6dll5r@p/Payment from Ph/YES BANK LIMITE/417513336890/IBLf82ff1088ec1465e9656c08 770593868,0.0,28.0,5103.04
13-05-2025,,UPI/BHARATPE.900707/Pay to BharatPe/FEDERAL BANK/909500882743/IBL2d8a91185d7e4ad6971e0a 116d8aea25/,0.0,490.0,4613.04
13-05-2025,,UPI/paytm.s1exzjx@p/Payment from Ph/YES BANK PTY/382958322511/IBL1d50095f8a014fddabb83a8e a5390cfe/,0.0,100.0,4513.04
13-05-2025,,UPI/BHARATPE9U0O7T2/Pay to BharatPe/YesBank_Yespay/018228925305/IBL7d747 76f10d34a959741a34b0cef8949/,0.0,2.0,4511.04
13-05-2025,,UPI/chauhanlalbhadu/Payment from Ph/AIRTEL PAYMENTS/565188866931/IBL5372a71a47354061a 11db4ced8c4549f,0.0,26.0,4485.04
15-05-2025,,UPI/kanchantiwari.9/UPI/ICICI Bank/513573806242/ICIbe5c488362584c9ca2ee91f6 f708d6d2,50000.0,0.0,54485.04
15-05-2025,MOBILE BANKING,MOBILE BANKING MMT/IMPS/513517590447/w2b/MOBIKWIK  /Axis Bank,1.65,0.0,54486.69
15-05-2025,MOBILE BANKING,MOBILE BANKING MMT/IMPS/513517158560/Poonawalla Finc/Cashfree P/Kotak Mahindra,1.0,0.0,54487.69
15-05-2025,,UPI/maitreya.0601@o/UPI/HDFC BANK LTD/513518801721/ICI8cd8580cc4504b2abb0e7304 fe230dac/,0.0,50000.0,4487.69
15-05-2025,,UPI/zeptonowcashfre/Payment from Ph/HDFC BANK LTD/584991841434/IBL1cf0219726ff40069be65c6c0 d64c63f/,0.0,122.0,4365.69
15-05-2025,,UPI/paytm-91696624@/Payment from Ph/YES BANK LIMITE/155630078773/IBLe9641a08c1864a33abf71e 9cf9b0b167,0.0,490.0,3875.69
15-05-2025,,UPI/Q508851279@ybl/Payment from Ph/YES BANK LIMITE/814361031225/IBL4d98a3d921144697a1786 56c6d0b2b13/,0.0,240.0,3635.69
15-05-2025,,UPI/paytmqr63bh92@p/Payment from Ph/YES BANK LIMITE/689137913748/IBL5177c1f9aed840d48cac09 08afa19fe4,0.0,36.0,3599.69
16-05-2025,,UPI/Vyapar.17158899/Payment from Ph/HDFC BANK LTD/288645050446/IBLdd87ebefcf0c4f84a55a30e32 e38643a/,0.0,400.0,3199.69
16-05-2025,,UPI/WFMLMH2@ybl/Payment for 500/YES BANK LIMITE/119037331988/IBL81dd091e0f114763ac4daa 0e85b280d8/,0.0,213.27,2986.42
16-05-2025,,UPI/namrata.avising/UPI/AXIS BANK/513623815529/AXIcc263c7a39524a60860f39 1bd5f04757,50000.0,0.0,52986.42
16-05-2025,,UPI/Bank Account XX/Payment from Ph/HDFC BANK LTD/109421994652/IBLf33ff2ce13814127bc9485cfa3 ce80e8/,0.0,50000.0,2986.42
16-05-2025,,UPI/paytm.s1c9mnv@p/Payment from Ph/YES BANK PTY/552098359479/IBL780a24ca20374acf9030436c 4e7a3694/,0.0,340.0,2646.42
16-05-2025,,UPI/maitreya.0601@o/UPI/ICICI Bank/513646972683/ICI8c81c82c201a4f6083c2025c 86c76781,5000.0,0.0,7646.42
16-05-2025,,UPI/Q922265868@ybl/Payment from Ph/YES BANK LIMITE/103748786733/IBL7af3f1eaf2ed4fd68d8eb95 b82dbbdc1/,0.0,340.0,7306.42
16-05-2025,,UPI/paytmqr28100505/Payment from Ph/YES BANK LIMITE/555262165456/IBL671bdd60eb7a4e33a85de 913598362d1,0.0,70.0,7236.42
17-05-2025,,UPI/9035791251@axl/Payment from Ph/HDFC BANK LTD/700637754875/AXL3389f5dabb1e4a89b258574 dbabac04e,2600.0,0.0,9836.42
17-05-2025,,UPI/zeptomarketplac/home/AXIS BANK/993174693265/IBLe2474ffd82c344bb80177a4 2c99baecc/,0.0,560.0,9276.42
17-05-2025,,UPI/getsimpl.payu@i/UPIIntent/ICICI Bank LTD /545788271645/PPPL2355788070217052515470268 28621e/,0.0,563.6,8712.82
17-05-2025,,UPI/Q960232423@ybl/Payment from Ph/YES BANK LIMITE/618691954141/IBLbf35850ee1104389a2aaa2 f21e830ed8/,0.0,100.0,8612.82
17-05-2025,,UPI/Q720761735@ybl/Payment from Ph/YES BANK LIMITE/918145243266/IBLe548cc63b59446959c6ef3 9d2712a361/,0.0,90.0,8522.82
18-05-2025,,UPI/airtel-billpaym/Airtel Broadban/YES BANK LIMITE/167767095425/PYTM5051880374663480628 5XXXXXXXXXXX,0.0,2361.18,6161.64
18-05-2025,,UPI/paytmqr5za3s6@p/Payment from Ph/YES BANK LIMITE/207764470370/IBL82b4825846534ccb8bf83c 8013cac485,0.0,30.0,6131.64
18-05-2025,,UPI/paytmqr66ddpt@p/Payment from Ph/YES BANK LIMITE/038306231621/IBL17a9aebdc8e547debec56 93335007fe6,0.0,36.0,6095.64
19-05-2025,,UPI/namrata.avising/UPI/AXIS BANK/513913620999/AXI9f6e0c2e57ee494a8ff5fcee 5ff81916,25000.0,0.0,31095.64
19-05-2025,,BIL/NEFT/ICICN12025051979589807/WISE/JPMORG AN CHASE,0.0,25000.0,6095.64
19-05-2025,,UPI/paytmqr66ddpt@p/Payment from Ph/YES BANK LIMITE/945858159562/IBLb3fecddd0a8c426aa8d30c 6f8b5c4094,0.0,38.0,6057.64
20-05-2025,,UPI/kanchantiwari.9/UPI/ICICI Bank/514003877005/ICI7e5079ac8c2d41ca9f841cd0 6c8f3614,50000.0,0.0,56057.64
20-05-2025,,UPI/maitreya.0601@o/UPI/HDFC BANK LTD/514058470023/ICI3d5c8cef562f45259dca33e7b 965313b/,0.0,50000.0,6057.64
20-05-2025,,UPI/BHARATPE.9D0E0E/Pay to BharatPe/UNITY SMALL FIN/403425164867/IBL62613a5e678b470e92cd3484 e2c72574,0.0,19.0,6038.64
20-05-2025,,UPI/ansarifaijan431/Payment from Ph/Kotak Mahindra /058597382916/IBLfcbb174939f5438f89d270978894 3746,0.0,26.0,6012.64
21-05-2025,,UPI/paytmqr28100505/Payment from Ph/YES BANK LIMITE/872594294418/IBLc8c86dd36bf14362bf162f 08bd2b7616,0.0,1193.0,4819.64
21-05-2025,,UPI/ashok.guptaa.19/Payment from Ph/UNION BANK OFI/812387061515/IBL7d638c8582b649109fdbb0e8 4fd734b7,0.0,32.0,4787.64
21-05-2025,,UPI/paytmqr5l223r@p/Payment from Ph/YES BANK LIMITE/809357985659/IBL08b6da98e0d24401bbd17 2fd71feb028,0.0,19.0,4768.64
21-05-2025,,UPI/paytm.s1ct3cb@p/Payment from Ph/YES BANK PTY/585307193745/IBLbe58186709db4e249c9578f3 dc5d90b5/,0.0,250.0,4518.64
21-05-2025,,UPI/Q330630816@ybl/Payment from Ph/YES BANK LIMITE/251455711000/IBLa40ed7f2facc4322b42d90 795101acf7/,0.0,55.0,4463.64
21-05-2025,,UPI/9619720122@kota/Payment from Ph/Kotak Mahindra /023700459587/IBL992f73ab683a4100b90f1c469dcc f00a,0.0,400.0,4063.64
22-05-2025,,UPI/cf.zepto12@cash/Payment from Ph/NSDL PAYMENTSB/317021163708/IBL93b8c7216e1a4f35 8179f9bfe6ad5d89,0.0,454.0,3609.64
22-05-2025,,UPI/namrata.avising/UPI/AXIS BANK/514294032900/AXI6735b75899c04f2d9c9d8ff cb80039ec,25000.0,0.0,28609.64
22-05-2025,MOBILE BANKING,MOBILE BANKING MMT/IMPS/514217122708/Saurabh Pa/ESFB0005002/chgRs5.00GSTRs0.90,0.0,25005.9,3603.74
22-05-2025,MOBILE BANKING,MOBILE BANKING MMT/IMPS/514217122708/Saurabh Pa/ESFB0005002,25005.9,0.0,28609.64
22-05-2025,MOBILE BANKING,MOBILE BANKING MMT/IMPS/514218190735/Saurabh Pa/ESFB0005002/chgRs5.00GSTRs0.90,0.0,25005.9,3603.74
22-05-2025,MOBILE BANKING,MOBILE BANKING MMT/IMPS/514218190735/Saurabh Pa/ESFB0005002,25005.9,0.0,28609.64
22-05-2025,MOBILE BANKING,MOBILE BANKING MMT/IMPS/514218232285/SAURABH PA/ESFB0000CMS/chgRs5.00GSTRs0.90,0.0,25005.9,3603.74
22-05-2025,MOBILE BANKING,MOBILE BANKING MMT/IMPS/514218106034/92715678 withdr/Equitas /Equitas Small F,24452.99,0.0,28056.73
22-05-2025,,BIL/NEFT/ICICN12025052279727479/WISE/JPMORG AN CHASE,0.0,25000.0,3056.73
23-05-2025,,UPI/paytmqr5l223r@p/Payment from Ph/YES BANK LIMITE/487014742735/IBLac44d8536eb0427982bca 7ff8e37f5a5,0.0,4.0,3052.73
23-05-2025,,BY CASH  - THANE  MAJIWADE,147000.0,0.0,150052.73
23-05-2025,,UPI/cred.club@axisb/payment on CRED/AXIS BANK/550903137837/ACD3230412764LBWExWP/,0.0,147000.0,3052.73
23-05-2025,,UPI/WFMLMH1@ybl/Payment for 500/YES BANK LIMITE/409873833602/IBL9798414ddf174fceb776d1 77880476d0/,0.0,217.0,2835.73
23-05-2025,,UPI/paytm-74049403@/Payment from Ph/YES BANK LIMITE/974660807066/IBLdfbe4fc8f407486e8ba7c2 01913e632f,0.0,115.0,2720.73
23-05-2025,,UPI/7738872929@okbi/Payment from Ph/AXIS BANK/174931320962/IBL9756a4209a574111b3c6cc 335d73785c/,0.0,30.0,2690.73
24-05-2025,,UPI/namrata.avising/UPI/AXIS BANK/551017279288/AXIf74eb753a78e4f2a9bd273 2517b5ba1e,52000.0,0.0,54690.73
24-05-2025,,UPI/Bank Account XX/Payment from Ph/ICICI Bank/531781354005/IBL263e5d4892754862a0b2ff52 b1497928/,0.0,52461.0,2229.73
24-05-2025,,UPI/8108337296@kota/Payment from Ph/Kotak Mahindra /453118145360/IBL2061f183493049ffb2ea204821eb 8552,0.0,200.0,2029.73
24-05-2025,,UPI/paytmqr5f3vf5@p/Payment from Ph/YES BANK LIMITE/900788730537/IBL865f05fc08cc4cf1be4a215 2dc70a43c,0.0,38.0,1991.73
24-05-2025,,UPI/paytmqr5bhqgh@p/Payment from Ph/YES BANK LIMITE/561292496646/IBLba70b62c11ec45aca36b6 c3f5b884f62,0.0,37.0,1954.73
25-05-2025,,UPI/namrata.avising/UPI/AXIS BANK/514578544245/AXI85a45efede72415788d85f b564126d46,28000.0,0.0,29954.73
25-05-2025,,UPI/paytmqr5e86l1@p/Payment from Ph/YES BANK LIMITE/219394307614/IBL91d0fbd301a44d5ea626ef 7c088291e1,0.0,255.0,29699.73
25-05-2025,,BIL/NEFT/ICICN12025052579834849/WISE/JPMORG AN CHASE,0.0,28000.0,1699.73
26-05-2025,,UPI/Q367385000@ybl/Payment from Ph/YES BANK LIMITE/722187219763/IBL5d267b39751c47c091517 8ef5bc5be82/,0.0,150.0,1549.73
26-05-2025,,UPI/Q898197640@ybl/Payment from Ph/YES BANK LIMITE/818323552087/IBL8ae1a43510574ed6b957d b101fc23e33/,0.0,50.0,1499.73
26-05-2025,,UPI/Q898197640@ybl/Payment from Ph/YES BANK LIMITE/926254194846/IBL00d32aaf313741ba9615ae fa48fcfbf9/,0.0,8.0,1491.73
27-05-2025,,UPI/Q330630816@ybl/Payment from Ph/YES BANK LIMITE/595850113690/IBLc75344e68b15498a805be 3228f90c6e7/,0.0,23.0,1468.73
27-05-2025,,UPI/9619720122@kota/Payment from Ph/Kotak Mahindra /489196443728/IBLd32c7a76f4604ef895b56bfc5023 20fb,0.0,420.0,1048.73
27-05-2025,,UPI/Q330630816@ybl/Payment from Ph/YES BANK LIMITE/652286464515/IBL9825c2cb8bb848e89332b e3ebd948ef9/,0.0,46.0,1002.73
27-05-2025,,UPI/Q330630816@ybl/Payment from Ph/YES BANK LIMITE/233754125889/IBL95dd7c200a7441fe99d96a 2228164f0c/,0.0,5.0,997.73
27-05-2025,,UPI/paytmqr28100505/Payment from Ph/YES BANK LIMITE/187734733118/IBL9f772839dd7b4af491e80c 1a5743413b,0.0,54.0,943.73
27-05-2025,,UPI/Q447099211@ybl/Payment from Ph/YES BANK LIMITE/653697634094/IBLea19c2728d0d48b7b7782 1d33c039ade/,0.0,140.0,803.73
28-05-2025,,UPI/paytm-91696624@/Payment from Ph/YES BANK LIMITE/283305529768/IBLeb8c161fa79e4603b6b3d 94222ffa52a,0.0,490.0,313.73
28-05-2025,,UPI/saurabhpdy1993@/Payment from Ph/HDFC BANK LTD/694545524034/YBLafc1ac4cec1649389aa13b3f d952f671,100.0,0.0,413.73
29-05-2025,,UPI/9967757447@yesc/Paid via CRED/ICICI Bank/551508978261/YCD01JWDR762QJSYAACNW EY4YY65209k6z6,5000.0,0.0,5413.73
29-05-2025,,UPI/paytm.s1exzjx@p/Payment from Ph/YES BANK PTY/800232308544/IBLfc8bfe16cafd40aaa6c4ba172 737c9fb/,0.0,150.0,5263.73
29-05-2025,,UPI/Q741801669@ybl/Payment from Ph/YES BANK LIMITE/780460384604/IBL994588a3751c436683eb2 9b919287486/,0.0,336.0,4927.73
29-05-2025,,UPI/miniklubretailp/Payment from Ph/HDFC BANK LTD/713438878106/IBLe5b982ad32ac45ac9020a32e d86dcb22/,0.0,1799.1,3128.63
29-05-2025,,UPI/paytmqr5vn4sq@p/Payment from Ph/YES BANK LIMITE/818713886934/IBL8a4c498a8e334efea9fc9fa 88f3b0ac7,0.0,1050.0,2078.63
29-05-2025,,UPI/paytmqr6abm2i@p/Payment from Ph/YES BANK LIMITE/843796560405/IBL9d1f894c2bad46f3b7c47e 393aec7cd5,0.0,636.0,1442.63
30-05-2025,,UPI/vijayshukla5431/Payment from Ph/Kotak Mahindra /093829517730/IBLfe1418c1ca7d4c6792d8fee7e5c4 2a0a,0.0,1000.0,442.63
30-05-2025,,UPI/amazon@rapl/You are paying/Amazon RBL/515043574716/RBA01971ea3e9396db0b4ce9b b4e50084e2/,0.0,188.33,254.3
30-05-2025,,UPI/namrata.avising/UPI/AXIS BANK/515028624383/AXIbbbd1781674c4a56afcf40 27fa91dc5c,80000.0,0.0,80254.3
30-05-2025,,UPI/maitreya.0601@o/UPI/ICICI Bank/551642718316/ICI4774e8530a9246158f2e57cd aa1e57c3,32500.0,0.0,112754.3
30-05-2025,,UPI/maitreya.0601@o/UPI/ICICI Bank/551603620350/ICI9090cf9570514b5c958e2c48 5ebdc994,32500.0,0.0,145254.3
30-05-2025,,UPI/Bank Account XX/Payment from Ph/HDFC BANK LTD/734305960353/IBL12835afefd9344ff84449f2a7c 280172/,0.0,30000.0,115254.3
31-05-2025,,UPI/namrata.avising/UPI/AXIS BANK/551709709730/AXIfa0fbb22df7e45e0a7291bd b6220a777,100000.0,0.0,215254.3
31-05-2025,,UPI/usha73pandey-1@/UPI/TJSB SAHAKARI B/515150303101/ICI6b858572dc2a4d43a3467b6ec2 bc99bd,66000.0,0.0,281254.3
31-05-2025,,BIL/INFT/EEZ9357897/ GAURAV JAIN,0.0,96210.0,185044.3
31-05-2025,,UPI/onecardbob@yesp/In App/YesBank_Yespay/551743247447/YJP676c45c7 db4f4f048678e288bd3bbe3e/,0.0,10956.58,174087.72
01-06-2025,,UPI/gullakmoney@yes/Payment for Gul/YesBank_Yespay/551850054494/YJPdc90ed807 e944a25b1456c7f13065da3/,0.0,1500.0,172587.72
01-06-2025,,UPI/RCollectCC@rbl/A20240530000715/RBL BANK LIMITE/449292118232/IBL3bb0414cf6764b288d410f 06e89e83c5/,0.0,8581.0,164006.72
02-06-2025,,UPI/vishal.hira55@o/Payment from Ph/INDIAN BANK/773998432314/IBL0a94979fb49e4ece8a20a5e a9a24b7d3/,0.0,62869.0,101137.72
02-06-2025,,UPI/namrata.avising/UPI/AXIS BANK/515394665662/AXI1ccb0d4ada824c689f89dd 4f287e5dca,20000.0,0.0,121137.72
03-06-2025,MOBILE BANKING,MOBILE BANKING MMT/IMPS/515410975403/LOAN PAYMENT /PRAVEEN PR/Kotak Mahindra,43000.0,0.0,164137.72
03-06-2025,,UPI/maitreya.0601@o/UPI/ICICI Bank/552087668580/ICIc48a1dca783a4eaabd72380 89aae3e7c,51470.0,0.0,215607.72
03-06-2025,,UPI/pinelabs.103444/UPI Intent/HDFC BANK LTD/766076612807/IBL7385d8f64910454dae6e31a5 43143651/,0.0,876.2,214731.52
03-06-2025,,BIL/INFT/EF30161448/ KANCHAN PANDEY,0.0,105000.0,109731.52
03-06-2025,CMS TRANSACTION,CMS TRANSACTION CMS/001716184597/AD_LANDTAD__C0240422313 3549475,0.0,12051.0,97680.52
04-06-2025,,UPI/olamoney1.rzp@a/Pay via Razorpa/AXIS BANK/218109561555/AXI0b58efe22d0f45469a97b7 1e7ed97c5a/,0.0,733.0,96947.52
05-06-2025,,ACH/HERO FINCORP LTD/ICIC7012709242023333/68938191,0.0,18519.0,78428.52
05-06-2025,,UPI/piramal2@yesban/UPI Mandate/YES BANK LIMITE/515659392414/YES36CBC22324C265B9E06 400144FF88612/,0.0,4707.0,73721.52
05-06-2025,,UPI/adityabirlafina/Pay via Razorpa/ICICI Bank LTD /515649410570/ICI692b14e28fc545ddbc728f554d5e 0374,0.0,10855.0,62866.52
06-06-2025,,UPI/amznlpa-nuqcori/You are paying/AXIS BANK/773754834352/APL8433ed2db454479ba6c97 7d8ee9e91ed/,0.0,9188.05,53678.47
06-06-2025,,UPI/axio.rzp@icici/Pay via Razorpa/ICICI Bank LTD/515754597480/ICI6ec3cff6f463468f8ad8930840 0273fc/,0.0,5.0,53673.47
09-06-2025,,UPI/usha73pandey@ok/Payment from Ph/ICICI Bank/851054279667/IBLc5ec8bc9db3e45898ad6cd3 40eb117cd/,0.0,43000.0,10673.47
09-06-2025,,UPI/cred.utility@ax/payment on CRED/AXIS BANK/552624803935/ACD3284759079VaJRJZE/,0.0,8140.0,2533.47
09-06-2025,MOBILE BANKING,MOBILE BANKING MMT/IMPS/516016536846/ESRefund1448335/INES /Axis Bank,116.0,0.0,2649.47
10-06-2025,,UPI/axio.rzp@icici/Pay via Razorpa/ICICI Bank LTD/515754597480/ICI6ec3cff6f463468f8ad8930840 0273fc/,5.0,0.0,2654.47
12-06-2025,,UPI/kanchantiwari.9/UPI/ICICI Bank/552992959156/ICI6ede11e4c5cd4d70952833b 288e59a78,20850.0,0.0,23504.47
13-06-2025,,UPI/kanchantiwari.9/UPI/ICICI Bank/516445034664/ICI13bcaa85d0d747a98949917 35fdb5c39,40000.0,0.0,63504.47
13-06-2025,,UPI/cred.club@axisb/payment on CRED/AXIS BANK/553008381574/ACD3294855915kJxkDrb/,0.0,36167.95,27336.52
13-06-2025,MOBILE BANKING,MOBILE BANKING MMT/IMPS/516419745747/Saurabh Pa/KKBK0001374/chgRs5.00GSTRs0.90,0.0,11005.9,16330.62
13-06-2025,MOBILE BANKING,MOBILE BANKING MMT/IMPS/516419745747/Saurabh Pa/KKBK0001374,11005.9,0.0,27336.52
13-06-2025,,UPI/kanchantiwari.9/UPI/ICICI Bank/516475044041/ICI29b917d7f8574e8c984525ed 48d7cf43/,0.0,10000.0,17336.52
14-06-2025,,UPI/9833994835@ybl/Payment from Ph/State Bank Of I/999431012581/YBLcb4275fbdc844c1ab43bf35170 df85c9,1.0,0.0,17337.52
14-06-2025,,UPI/9833994835@ybl/Payment from Ph/State Bank Of I/275218487648/YBLdd2753b5557d492699b1ff598a bd2ab7,45178.0,0.0,62515.52
15-06-2025,,UPI/namrata.avising/UPI/AXIS BANK/516628788364/AXI3d18116758094046bf2c3c 7c6daf5309,50000.0,0.0,112515.52
15-06-2025,,UPI/khnsaad07-2@oki/na/TJSB SAHAKARI B/516600296679/ICIWC0E57EBF9D6A5B371D03C18 4E831290/,0.0,30000.0,82515.52
18-06-2025,,UPI/namrata.avising/UPI/AXIS BANK/553536968820/AXI39e379dcdc0348199e1d0 410f80eb997,50000.0,0.0,132515.52
18-06-2025,,UPI/Bank Account XX/Payment from Ph/HDFC BANK LTD/818644266392/IBLc321d33be0fc4d199871bb1c 24461a96/,0.0,20000.0,112515.52
18-06-2025,,UPI/vishal.hira55@o/Payment from Ph/INDIAN BANK/050218161594/IBL4ef534c3d4fc4ac499c7778 9b440995e/,0.0,30000.0,82515.52
18-06-2025,,UPI/namrata.avising/UPI/AXIS BANK/553580694597/AXI2ad2fbc43164483ea4bf7a 976855fd4c,50000.0,0.0,132515.52
18-06-2025,,BIL/NEFT/ICICN12025061881524581/WISE/JPMORG AN CHASE,0.0,50000.0,82515.52
20-06-2025,,UPI/airtel2.payu@hd/Airtel Broadban/HDFC BANK LTD/861202718916/PPPL2397148545120062514244 5685521d5/,0.0,2365.9,80149.62
20-06-2025,,UPI/namrata.avising/UPI/AXIS BANK/517194395890/AXI005bbb5962614ccd91dad e8fe48ab09c,50000.0,0.0,130149.62
20-06-2025,,UPI/aurosen27@icici/Payment from Ph/ICICI Bank/134551464206/IBLfae1ea258455439b9063fe72 599d1d4b/,0.0,45000.0,85149.62
20-06-2025,,UPI/maitreya.0601@o/UPI/HDFC BANK LTD/553792804589/ICIf1b1d8507ae347e38603776a a8a57821/,0.0,50000.0,35149.62
23-06-2025,,UPI/Bank Account XX/Payment from Ph/ICICI Bank/977728374570/IBL62664f80424d4027af1f1b05 4cf1f9b7/,0.0,20000.0,15149.62
26-06-2025,BANK CHARGES,BANK CHARGES ATD-0xx0031-RTNCHGSJun25GST,0.0,59.0,15090.62
26-06-2025,,UPI/sreejith.nair26/UPI/Kotak Mahindra /517733192865/ICI1a623f5ccf3d4a04805c2ebbb9b7 20b6,2934.0,0.0,18024.62
27-06-2025,,BIL/INFT/EFV3710918/Friend/ MAITREYA SHRIRA,60000.0,0.0,78024.62
28-06-2025,,UPI/SAURABH PR/saurabhpdy1993/Payment fr/HDFC BANK/168906338607/YBL6c6db5a15d934246b185c 16f2bcd7fb5,5000.0,0.0,83024.62
29-06-2025,,UPI/vijay.chenani@y/Payment from Ph/State Bank OfI/151482343119/YBL518cea1669f94123810ee42e d4b6cef2,4670.0,0.0,87694.62
30-06-2025,,149201504063:Int.Pd:29-03-2025 to 29-06-2025,309.0,0.0,88003.62
30-06-2025,,UPI/amazon@rapl/You are paying/Amazon RBL/518159714760/RBA0197bf28dcaf7a349107fbd2 41d0d7ac/,0.0,168.89,87834.73
01-07-2025,,UPI/gullakmoney@yes/Payment for Gul/YesBank_Yespay/554800022733/YJP9fdca106c 3c54548a18f042806af0c77/,0.0,1500.0,86334.73
02-07-2025,,UPI/RCollectCC@rbl/A20240530000715/RBL BANK LIMITE/661316312824/RBLCOLLP020720251159246 997467672428/,0.0,8582.0,77752.73
03-07-2025,CMS TRANSACTION,CMS TRANSACTION CMS/001737613466/AD_LANDTAD__C0240422313 3549475,0.0,12051.0,65701.73
03-07-2025,,UPI/APPLE MEDI/appleservices./UPI Mandat/HDFC BANK/100896394368/HDF38BE5135A58D11D6E063 4ECEE10ADF99/,0.0,699.0,65002.73
04-07-2025,,NEFT-KKBKN62025070443187311-SAURABH PRAVESH PANDEY-PAYMENT-1546675134- KKBK0000958,255335.0,0.0,320337.73
04-07-2025,,UPI/CRED Club/cred.club@axis/payment on/AXIS BANK/555120386820/ACDede5f702dcc54bfb8f2dea d42ca295d4/,0.0,200000.0,120337.73
04-07-2025,MOBILE BANKING,MOBILE BANKING MMT/IMPS/518521937464/LOAN PAYMENT /PRAVEEN PR/Kotak Mahindra,43000.0,0.0,163337.73
05-07-2025,,ACH/HERO FINCORP LTD/ICIC7012709242023333/689381918191,0.0,18519.0,144818.73
05-07-2025,,UPI/PIRAMAL CA/piramal2@yesba/UPI Mandat/YES BANKL/518650712732/YES39266A2A0B533D94E06 400144FFA73D1,0.0,4707.0,140111.73
05-07-2025,,UPI/Aditya Bir/adityabirlafin/Pay via Ra/ICICI Bank/518607254401/ICI1be422940add410285aabf6e e84926dd,0.0,10855.0,129256.73
06-07-2025,,UPI/CRED Club/cred.club@axis/payment on/AXIS BANK/555325639678/ACDee431fc7514f42239ab980 16a665fc93/,0.0,55505.28,73751.45
07-07-2025,,UPI/SASANKA BI/sasanka.biswas/Payment fr/HDFC BANK/827711040931/IBL38c5f557f74a48c7b4284da 656e166d1/,0.0,46735.0,27016.45
08-07-2025,,UPI/WISTERIA F/paytm.s10sxjx@/Payment fr/YES BANKP/105379514073/IBL45c184cab77c4f2fbdf6d2 e3fe6c084d,0.0,977.0,26039.45
09-07-2025,,NEFT-KKBKN62025070950650478-SAURABH PRAVESH PANDEY-PAYMENT-1546675134- KKBK0000958,53000.0,0.0,79039.45
09-07-2025,,UPI/USHA PRAVE/usha73pandey@o/Send Money/ICICI Bank/496764481237/IBL87b320ac4acf4b93a3da467 1c3f90f52,0.0,43000.0,36039.45
09-07-2025,,UPI/ZEPTO MARK/zeptomarketpla/Payment fr/ICICI Bank/404869011367/IBL46eef4dcdbfd4578991530b 46bdf4ef3,0.0,295.41,35744.04
09-07-2025,,UPI/AJEET YADA/7379652737-2@a/Payment fr/CANARA BAN/135481701279/IBL9e605effa90242d4a89c6617 674dbdbc,0.0,51.0,35693.04
09-07-2025,,UPI/ANITA SANJ/paytmqr63l53u@/Payment fr/YES BANKL/123844585244/IBL5fc445a50f9c4518ae7d26 ee13aefa5e,0.0,31.0,35662.04
09-07-2025,,UPI/BIGTREE EN/bookmyshow@axb/Debit Mone/AXIS BANK/555601376986/AXB8add22960a42482db2257 9735bf54447/,0.0,424.84,35237.2
10-07-2025,,UPI/Bank Accou/623505392951@I/Payment fr/ICICI Bank/525679402310/IBLb3027974a8ed4cd795632c7 ff389b8eb,0.0,12480.0,22757.2
10-07-2025,,UPI/NAMRATA SU/namrata.avisin/UPI/AXIS BANK/519109493101/AXI9e989c70a61b4100b0f141 c432e5eb8f,90000.0,0.0,112757.2
10-07-2025,MOBILE BANKING,MOBILE BANKING MMT/IMPS/519115523137/FINNY JOSE/HDFC0000410/chgRs5.00GSTRs0.90,0.0,90005.9,22751.3
10-07-2025,,UPI/MOHD IBRAH/9920744887@ibl/Payment fr/HDFC BANK/371413677202/IBL09c7dd2c59174369a0a4f5 5b64862a48/,0.0,12000.0,10751.3
11-07-2025,,UPI/APPLE MEDI/appleservices./UPI Mandat/HDFC BANK/100953382199/HDF3977A6C3721A7956E063 4FCEE10A7138/,0.0,629.0,10122.3
11-07-2025,,UPI/SATENDRA K/nilaya7819@oki/Payment fr/State Bank/350775292644/IBLdd376e0e011f41ba86dad7f c0bfc8ecf,0.0,4000.0,6122.3
11-07-2025,,UPI/SACHIN BHA/BHARATPE.01054/Payment fr/INDUSINDB/013366503581/IBLf04b81b1c5fe499a af4be9165a1c7a1c,0.0,999.0,5123.3
11-07-2025,,NEFT-UBINN52025071141036051-NAMRATA SUGREEW SINGH-/NRE/-558502020991081- UBIN0555851,200000.0,0.0,205123.3
11-07-2025,,BIL/INFT/EGF6683015/ SAURABH BISWAL,0.0,158396.0,46727.3
11-07-2025,,UPI/ASMA CHICK/pos.11350563@i/Payment fr/INDUSINDB/138873617872/IBLc95be5d42d414bc 288d22f4a34025b88,0.0,950.0,45777.3
12-07-2025,,UPI/CRED Club/cred.club@axis/payment on/AXIS BANK/555920529047/ACDe008bf6cf7cc42dba44a96 19302af141/,0.0,36947.91,8829.39
12-07-2025,,UPI/Vishwanath/paytm-91696624/Payment fr/YES BANKL/289761811091/IBLd1d5d4c1c83f4e579fe075 72a6edce67,0.0,491.61,8337.78
12-07-2025,,UPI/Lalbhihari/paytmqr62mc2a@/Payment fr/YES BANKL/329703184922/IBL8ab3c0ad6ae24369ba7fd 844600ac77b,0.0,96.0,8241.78
13-07-2025,,UPI/VIJAY KUMA/vijayshukla543/Payment fr/Kotak Mahi/179724123936/IBLbf12cb06509b441ca886b2b d01fd6bdf,0.0,1000.0,7241.78
13-07-2025,,UPI/WWW ADANIO/adanione1.payu/Payment fr/HDFC BANK/790356183005/PPPL24264198409130725061 9156873028b/,0.0,450.0,6791.78
13-07-2025,,UPI/LAKHBIR SI/9467833833@ybl/Payment fr/State Bank/315930235009/IBL5be07a2e8e3e4c179e1cd72 ff6ae1829,0.0,700.0,6091.78
13-07-2025,,BIL/INFT/EGH6888899/ PRAVESH R PANDE,30000.0,0.0,36091.78
13-07-2025,,UPI/SATENDRA K/nilaya7819@oki/Payment fr/State Bank/872140430391/IBLc2b3aff093144039b0d4e2d4 fe37c8b0,0.0,22500.0,13591.78
13-07-2025,,UPI/SUNIL KUMA/9990637922@axl/Payment fr/AXIS BANK/031153155383/IBL36a173c1348c416697df591 b32f0de58/,0.0,130.0,13461.78
13-07-2025,,UPI/ALOK PAUL/alokpaul2730@o/UPI/HDFC BANK/108044795678/HDFb0befd6db37a48259422f4 9183f96619,3500.0,0.0,16961.78
13-07-2025,,UPI/PRAKASH AD/paytmqr5z2kdj@/Payment fr/YES BANKL/079942865846/IBLe2ff85cde74b46678bb8a5 d4224e3641,0.0,420.0,16541.78
13-07-2025,,UPI/ZEPTONOW/zeptonow.esbz@/Payment fr/HDFC BANK/354972014904/IBLe976821d357d49139f8beb 6d842c5aed/,0.0,346.92,16194.86
14-07-2025,,UPI/ZOMATO/payzomato@hdfc/Payment fr/HDFC BANK/862413898504/IBL664ba587eecc428d8affb1f cc4b3e696/,0.0,239.15,15955.71
14-07-2025,,UPI/UBER INDIA/uberindiasyste/UberRide/AIRTEL PAY/684413456810/RO2q32jj7E4yzhK5Ge1Vf2K2a0/,0.0,1.0,15954.71
14-07-2025,,UPI/DINESH KUM/pal811616@ybl/Payment fr/Kotak Mahi/101293841514/IBLfba80b054caa47c9adbf6a1e a5500b0f/,0.0,81.0,15873.71
14-07-2025,,UPI/Gopal Sing/8826579074@axl/Payment fr/EQUITAS SM/828456486184/IBL16cd92a35b6344dc9a162835 d46f3273,0.0,99.0,15774.71
14-07-2025,,UPI/ROPPEN TRA/roppentranspor/ROPPENTRAN/AIRTEL PAY/290100670138/IBL8da3bc6633a44663bde4b20 10aaa42f6,0.0,40.0,15734.71
14-07-2025,,UPI/ASHOK KUMA/BHARATPE.90070/Pay to Bha/FEDERAL BA/628846506821/IBL3d65bb21303541bca1ade007 df30db1d,0.0,120.0,15614.71
15-07-2025,,NEFT-KKBKN62025071559302843-SAURABH PRAVESH PANDEY-PAYMENT-1546675134- KKBK0000958,30000.0,0.0,45614.71
15-07-2025,,UPI/AARTI DEVI/ravendrapal550/Payment fr/UNION BANK/270627407341/IBLf13c8299b9484175b4e8c0 9c8be039c3,0.0,142.0,45472.71
15-07-2025,,UPI/UBER INDIA/uberindiasyste/UberRide/AIRTEL PAY/684413456810/RO2q32jj7E4yzhK5Ge1Vf2K2a0/,1.0,0.0,45473.71
15-07-2025,,UPI/RAVENDRA S/paytmqr631uo8@/Payment fr/YES BANKL/853447526993/IBLc1a46ce9d7754a5ab25e3 6d287e652aa,0.0,76.0,45397.71
15-07-2025,,UPI/ZOMATO/payzomato@hdfc/Payment fr/HDFC BANK/638733087997/IBLcb2ec46df1874c98a56e35 b640f6200c/,0.0,363.55,45034.16
16-07-2025,,UPI/CRED/cred.utility@a/payment on/AXIS BANK/556315095820/ACD466df45cdc604f58848bc1 4c515cbef3/,0.0,3350.0,41684.16
16-07-2025,,UPI/Amir Khan/8800746508@kot/Payment fr/Kotak Mahi/434414148418/IBLad7b2dc903c14652a4310ee 0198ae3bc/,0.0,112.0,41572.16
16-07-2025,,UPI/Satish Sat/8395052032@pty/Payment fr/State Bank/715061501759/IBL8a1afa381fcf43138abe17c3 6c26532f,0.0,105.0,41467.16
16-07-2025,,UPI/SHIVANI/shivanimathur2/Payment fr/HDFC BANK/690379915332/IBL6a41ef90d61343e684c1fd4 5c985c8c8/,0.0,50.0,41417.16
16-07-2025,,UPI/ZEPTO MARK/cf.zeptomarket/Payment fr/NSDL PAYME/025064434654/IBLbfc54d7cf4314ba38bf04d ee38b403e1,0.0,658.39,40758.77
17-07-2025,,UPI/Amit Kumar/paytmqr14pp95r/Payment fr/YES BANKL/077381972920/IBLb52f639dc9c848fcb2f2ab 42d74919c2,0.0,100.0,40658.77
17-07-2025,,UPI/Shripal si/ombk.aafj41817/Payment fr/PPIW/991916097060/IBL11b0fce3e2e54e4abd313 22f7d115044/,0.0,80.0,40578.77
17-07-2025,,UPI/Airtel Dir/airteldirectup/Airtel Pos/AIRTEL PAY/665665439017/IBLb7ed6f2d984643b49c429387 ac9a25b9,0.0,3158.86,37419.91
17-07-2025,,UPI/ZOMATO LIM/zomato-order@p/Zomato Pay/YES BANKL/434478562743/PYTM5071780594994906830 5XXXXXXXXXXX,0.0,167.2,37252.71
17-07-2025,,UPI/ZOMATO LIM/zomato-order@p/express/YES BANK L/556403983102/PTMde083f44d24f4d1289eee87c2 dfb5498,167.2,0.0,37419.91
17-07-2025,,UPI/ZOMATO/payzomato@hdfc/Payment fr/HDFC BANK/260445420971/IBLc0c29054ddc741cd912e57 1ab0aea915/,0.0,180.05,37239.86
18-07-2025,,UPI/RAMAUTAR/bharatpe.8e0y0/PayToRAMAU//51 9979990261/ICIff887f3886f74f48b0e662ecaa10eff1/,0.0,121.0,37118.86
19-07-2025,,UPI/Satendra K/6387213238@pts/NA//520082484791/ICI367044e0 144f4f90aaf130675dfb715d/,0.0,54.0,37064.86
19-07-2025,,UPI/DINESH KUM/q396843726@ybl/NA//520082948551/ICI92b02 66f3fce45a1aa88295a14078caa/,0.0,40.0,37024.86
19-07-2025,,UPI/GAURAV KUM/kumarg0147@oki/NA//520083827459/ICI2aefe eec6fa4450292670e2940cb1531/,0.0,54.0,36970.86
20-07-2025,MOBILE BANKING,MOBILE BANKING MMT/IMPS/520117381891/Saurabh Pa/HDFC0000239/chgRs5.00GSTRs0.90,0.0,30005.9,6964.96
21-07-2025,MOBILE BANKING,MOBILE BANKING MMT/IMPS/520221797633/Saurabh Pa/HDFC0000239/chgRs5.00GSTRs0.90,0.0,6960.86,4.1
24-07-2025,,UPI/MAITREYA S/maitreya.0601@/UPI/ICICI Bank/520599341364/ICIdb8f6433243e4dbdb8da3ba 8641e4f6f,20000.0,0.0,20004.1
24-07-2025,,UPI/MAITREYA S/maitreya.0601@/UPI/ICICI Bank/520556333597/ICI4e230a4514b649fb9f9d31bd c66909c8,20000.0,0.0,40004.1
24-07-2025,MOBILE BANKING,MOBILE BANKING MMT/IMPS/520519769411/Saurabh Pa/HDFC0000239/chgRs5.00GSTRs0.90,0.0,39999.9,4.2
29-07-2025,,DCARDFEE2791JUL25-JUN26+GST,0.0,4.2,0.0
02-08-2025,MOBILE BANKING,MOBILE BANKING MMT/IMPS/521423494532/P2AMOB/SAURABH PR/Indusind Bank,12100.0,0.0,12100.0
03-08-2025,CMS TRANSACTION,CMS TRANSACTION CMS/001760086487/AD_LANDTAD__C0240422313 3549475,0.0,12051.0,49.0
04-08-2025,MOBILE BANKING,MOBILE BANKING MMT/IMPS/521623865506/P2AMOB/SAURABH PR/Indusind Bank,162600.0,0.0,162649.0
05-08-2025,MOBILE BANKING,MOBILE BANKING MMT/IMPS/521700774897/Saurabh Pa/HDFC0000239/chgRs15.00GSTRs2.70,0.0,162617.7,31.3
05-08-2025,MOBILE BANKING,MOBILE BANKING MMT/IMPS/521710900214/P2AMOB/SAURABH PR/Indusind Bank,18519.0,0.0,18550.3
05-08-2025,,ACH/HERO FINCORP LTD/ICIC7012709242023333/689381918191,0.0,18519.0,31.3
06-08-2025,MOBILE BANKING,MOBILE BANKING MMT/IMPS/521806813388/LOAN PAYMENT /PRAVEEN PR/Kotak Mahindra,43000.0,0.0,43031.3
06-08-2025,,UPI/SAURABH PR/9773777601-2@y/Payment fr/INDUSINDB/184781955401/YBL45eeddf0a5ff4d85 83669a65c2ea27a2,88000.0,0.0,131031.3
06-08-2025,,UPI/SAURABH PR/saurabhpdy1993/UPI/HDFC BANK/109345383140/HDF96fe1134bf014615aeadd6 ef286fb8f2,5567.0,0.0,136598.3
07-08-2025,BANK CHARGES,BANK CHARGES DCARDFEE2791JUL25-JUN26+GST,0.0,349.8,136248.5
08-08-2025,,UPI/SHIV KUMAR/rm2528403@okhd/na/INDIA POST/522094423411/ICIWCFFBE4604C9800D12046 CCE57147C3C/,0.0,500.0,135748.5
09-08-2025,,UPI/KRUTIKA SA/krutikamishra0/na/HDFC BANK/522100275852/ICIWCEC265213F176F28CAE4 2D595122976/,0.0,501.0,135247.5
09-08-2025,,UPI/KRUTIKA SA/krutikamishra0/na/HDFC BANK/522100326705/ICIWC5F0580A2EFFB2C20AD 89F8761E65A3/,0.0,501.0,134746.5
10-08-2025,,UPI/SACHIN SHA/sachinsharmapo/na/Kotak Mahi/522205717974/ICIWC0E4AFB14638C5748A81 D3B38CCD5FC/,0.0,300.0,134446.5
11-08-2025,,UPI/SARIKA SAN/pandey.sarika./Rakhi 2025/Kotak Mahi/522309353842/ICIWC81F9CC8DD7877282D59 7C14F570067,0.0,1100.0,133346.5
11-08-2025,,UPI/PRIYANKA R/priyanka.3048-/na/State Bank/522309359466/ICIWCD534CD9897531094BD9 A44EE639B1E/,0.0,1100.0,132246.5
12-08-2025,CREDIT CARD,CREDIT CARD ATD/Auto Debit CC0xx0031,0.0,34780.0,97466.5
12-08-2025,,UPI/CRED/cred.utility@a/payment on/AXIS BANK/559026476566/ACDf59184f722e746db994a26 95eaa63268/,0.0,2306.0,95160.5
12-08-2025,,UPI/MAITREYA S/maitreya.0601@/UPI/ICICI Bank/559042843117/ICId8ba8999500d4a6dbb35f0e 238fb74cd,1291.0,0.0,96451.5
12-08-2025,,UPI/MAITREYA S/8879776518@pth/UPI/ICICI Bank/559048145192/ICI6068b9c22831457799ee669 94e4f36ae/,0.0,1291.0,95160.5
13-08-2025,CMS TRANSACTION,CMS TRANSACTION CMS/001767200944/AD_LANDTAD__C0240422313 3549475,0.0,38.0,95122.5
13-08-2025,,UPI/ATISH KARU/919773833832@s/Saving/Standard C/522520686372/SCB57cc2d0e009340c7a73997,15000.0,0.0,110122.5
13-08-2025,,UPI/ETERNAL LI/zomatoonlineor/ZomatoOnli/AIRTEL PAY/522586341838/ICIf0680c921bb246c09fb18349c 7507574,0.0,3130.5,106992.0
15-08-2025,,UPI/PLUSH MILE/plushmiles2857/PaymenttoJ/ICICI Bank/000023683016/IBL0e7569a4d88443fa8c879c2 8bfc654a2,0.0,1499.0,105493.0
15-08-2025,,UPI/Swiggy Lim/swiggy.stores@/Pay20for20/AXIS BANK/724993171501/AXBd27de07122294b3993410 cadd5d39c4f/,0.0,311.0,105182.0
15-08-2025,,UPI/Urban Comp/paytm-urbancom/Payment fo/YES BANKL/652657486153/PYTM5081580626066960384 5XXXXXXXXXXX,0.0,208.0,104974.0
16-08-2025,,UPI/SAURABH PR/9773777601-2@i/Payment fr/INDUSINDB/722758109969/IBL5374f751ed434ebd a6cb17341f9424a4,0.0,25000.0,79974.0
16-08-2025,,UPI/K M ENGINE/kmengineer.mer/Payment fr/Punjab Nat/505998592342/IBL2d2645f421214a91ae9c4e1c4 b30134d,0.0,26600.0,53374.0
16-08-2025,,UPI/PREM PAL S/prempalsing43@/Payment fr/INDUSINDB/010168629332/IBLe2fc8d121ab440d2 9af8498dceb72dfd,0.0,300.0,53074.0
16-08-2025,,UPI/A One Hand/gpay-111929800/na/AXIS BANK/522838087285/ICIWC7378854941C15CAB884 294E832A1CB/,0.0,1300.0,51774.0
17-08-2025,,UPI/Simpl/cf.simpl@cashf/4254273021/NSDL PAYME/522914364245/NPL3F49A13434E8436FB22 BCD1AFAB1BCF0/,0.0,1954.17,49819.83
17-08-2025,,UPI/Zepto Mark/zeptonow-2.bdp/UPI/HDFC BANK/522931077365/YJP0513083AA1E14BFFB635 175C9562BCA0/,0.0,1684.09,48135.74
17-08-2025,,UPI/Gullak/gullak.hypg@ye/Pay for me/YesBank_Ye/957673638926/YJP0d9c77ad4ad44 eaaa420f8fde86a9074/,0.0,2052.83,46082.91
17-08-2025,,UPI/Zepto/zeptoonline@yb/UPI/YES BANK L/522934936036/YJP28AED0A1A28E4DA78C2A69D AF2AC712D/,0.0,1566.89,44516.02
19-08-2025,,UPI/KAPTAN SIN/9871363120@pta/Payment fr/State Bank/544257768860/IBL73a86ef99b534f36ac5b3e59 9e0ae7c0,0.0,2730.0,41786.02
21-08-2025,,UPI/Zepto Mark/zeptonow-2.bdp/Payment fr/HDFC BANK/002778689426/AXL264aa656260f4c72b8e7c2 84ee603c0d/,0.0,292.97,41493.05
21-08-2025,,UPI/kanchantiw/kanchantiwari./UPI/ICICI Bank/559936173374/ICI5867c7e78c2f4893b1784e95 2987f797/,0.0,5000.0,36493.05
21-08-2025,,UPI/ATISH POOJ/9773833832@hdf/Payment fr/HDFC BANK/557284404613/IBLe892ec4c1b124bf785ad27f 1c17f851a/,0.0,15000.0,21493.05
23-08-2025,,UPI/Aditya Bir/adityabirlafin/Pay via Ra/ICICI Bank/523570572327/ICI6fdec9e4a5c846d5a57343c5 10f03760,0.0,500.0,20993.05
23-08-2025,,UPI/Zepto Mark/zeptonow-2.bdp/UPI/HDFC BANK/560118901413/YJPCAD0FE4F2E474EF98BC1 50E62C2F7383/,0.0,1061.83,19931.22
29-08-2025,MOBILE BANKING,MOBILE BANKING MMT/IMPS/524117917032/P2AMOB/SAURABH PR/Indusind Bank,235316.0,0.0,255247.22
01-09-2025,,UPI/RBL Bank C/creditcards@rb/MYC8230175/RBL BANKL/617198716250/IBL739f2545859b4184bc9a4 6c84bd1d48c,0.0,8581.0,246666.22
01-09-2025,,UPI/Amazon Pay/amazonbillpaym/You are pa/Amazon RBL/524494147578/RBA019905d839f3aae88162ce4 2d7f0c3de,0.0,21.0,246645.22
03-09-2025,,UPI/SANKET RAJ/9967757447@yes/na/ICICI Bank/524633719622/ICIWCACAECFA7B755519CAE F47F405A5B2C/,0.0,505.0,246140.22
03-09-2025,CMS TRANSACTION,CMS TRANSACTION CMS/001781477096/AD_LANDTAD__C0240422313 3549475,0.0,12051.0,234089.22
03-09-2025,,UPI/CAPITALFLO/amznlpa-nuqcor/You are pa/AXIS BANK/450489590628/APL01990e4216151b0952a4c 6e6f0906086/,0.0,12290.28,221798.94
03-09-2025,,UPI/CRED Club/cred.club@axis/payment on/AXIS BANK/561201065282/ACD2bde6dc1b04e4f3cb8559 166e4c31eb8/,0.0,41415.0,180383.94
03-09-2025,,UPI/APPLE MEDI/appleservices./UPI Mandat/HDFC BANK/101376537718/HDF3DCB6E9F7A39BBDFE06 34FCEE10AAE74/,0.0,5.0,180378.94
03-09-2025,,UPI/APPLE MEDI/appleservices./Mandate Re/HDFC BANK/101376556101/HDF30CF45638AB24AA7BF7 C7A42DED5B8E1,5.0,0.0,180383.94
04-09-2025,,UPI/CRED Club/cred.club@axis/payment on/AXIS BANK/561303374992/ACDa7686c1ac8fb477687dd6 ba23b8abeb2/,0.0,177319.0,3064.94
04-09-2025,,UPI/SAURABH PR/9773777601@kot/PaidViaKot/Kotak Mahi/524723725747/MBTdf6bf80554f94fd1b28e791 b5ea3c165,5000.0,0.0,8064.94
04-09-2025,,UPI/SAURABH PR/9773777601-2@i/Payment fr/INDUSINDB/323190361764/IBL74e8662337194fc2 a5b9012c0a77521c,26016.0,0.0,34080.94
04-09-2025,,UPI/SAURABH PR/9773777601-2@y/Payment fr/INDUSINDB/421422152277/YBLd35867cc648647d cb2980e7576624bc7,100.0,0.0,34180.94
05-09-2025,,ACH/HERO FINCORP LTD/ICIC7012709242023333/689381918191,0.0,18519.0,15661.94
05-09-2025,,UPI/PIRAMAL CA/piramal2@yesba/UPI Mandat/YES BANKL/524840614844/YES3E066665FB902B1DE06 400144FF88612,0.0,4707.0,10954.94
05-09-2025,,UPI/Aditya Bir/adityabirlafin/Pay via Ra/ICICI Bank/524850709369/ICI20a6c825c9e340908a204e34 83328542,0.0,10855.0,99.94
05-09-2025,MOBILE BANKING,MOBILE BANKING MMT/IMPS/524822748798/LOAN PAYMENT /PRAVEEN PR/Kotak Mahindra,43000.0,0.0,43099.94
06-09-2025,,BIL/INFT/EIA5694082/ KANCHAN PANDEY,100000.0,0.0,143099.94
06-09-2025,,UPI/Urban Comp/paytm-urbancom/Payment fo/YES BANKL/524926917786/PYTM5090680278650600857 7XXXXXXXXXXX,0.0,306.0,142793.94
06-09-2025,,UPI/SAURABH PR/9773777601@kot/PaidViaKot/Kotak Mahi/524913354083/MBTbe6446d783ad40d3b7c79 a086cbd1333,5000.84,0.0,147794.78
07-09-2025,,UPI/Bank Accou/09910004000044/Payment fr/Punjab Nat/666121778376/IBL17f4928b29b94705aa4ca644f 9c1b5e3,0.0,71000.0,76794.78
07-09-2025,,UPI/Amazon Pay/amznlpa-vok95f/You are pa/AXIS BANK/876398200371/APL01992304e0fc6dc0ab758c b12de32ec4/,0.0,889.0,75905.78
07-09-2025,,UPI/Mr SOMAY V/somayverma4591/Payment fr/CENTRAL BA/186391234111/IBL9e10bb7436dc4f6ea3df08fc5e e6d358,0.0,1050.0,74855.78
07-09-2025,,UPI/Blinkit/blinkit.payu@h/UPIIntent/HDFC BANK/905873057408/PPPL25057318457070925194 00768bd923f/,0.0,291.0,74564.78
08-09-2025,,UPI/USHA PRAVE/usha73pandey@o/Payment fr/ICICI Bank/537254254852/IBLdca62b4fc8bd45118fd1050 314d564a0,0.0,43000.0,31564.78
08-09-2025,,UPI/Sopal Chau/BHARATPE099018/Payment fr/YesBank_Ye/844021398903/IBL1f5d59f4962f4f8e8 e36f7c3489922ba,0.0,152.0,31412.78
08-09-2025,,UPI/Blinkit/blinkit.rzp@hd/Pay via Ra/HDFC BANK/101414130820/HDF255418611530459DAAA7 27CB158F245C/,0.0,2958.0,28454.78
08-09-2025,,UPI/SATYENDRA/BHARATPE907271/Pay to Bha/YesBank_Ye/408782052881/IBL6ddf9239ed694 18fa64394da7f1afc18/,0.0,72.0,28382.78
08-09-2025,,UPI/Zomato pri/zomato.payu@ax/UPIIntent/AXIS BANK/586474785623/PPPL25074047952080925214 63968bf0167/,0.0,374.9,28007.88
09-09-2025,,UPI/MAYANK MAY/9971452364@pts/Payment fr/State Bank/996119594716/IBL95246dfbbee4409390f974fc 61015001,0.0,168.0,27839.88
09-09-2025,,UPI/BIRENDRA K/paytmqr6cozv4@/Payment fr/YES BANKL/748656762028/IBL84855f7047724b499c41d eb2957e489b,0.0,125.0,27714.88
09-09-2025,,UPI/HRITIK VER/Q732367686@ybl/Payment fr/YES BANKL/929638928337/IBLacbfe65a5cac413a95246e a2ee353f86,0.0,69.0,27645.88
09-09-2025,,UPI/DAL CHAND/paytmqr6gmhgp@/Payment fr/YES BANK L/854183647206/IBL4a7ed3314b234a128c51ee2fcac 2c910/,0.0,50.0,27595.88
09-09-2025,,UPI/BHEEMSAIN/9582897791@pth/Payment fr/HDFC BANK/007300959642/IBL55a354decec640daa84317 aa966d28b3/,0.0,72.0,27523.88
10-09-2025,,UPI/NAND KISHO/BHARATPE.9U0Z0/Pay to Bha/FEDERAL BA/622737477916/IBL1d4104c890124a56bd630e2b daf84d30,0.0,114.0,27409.88
10-09-2025,,UPI/Rahul/Q109903534@ybl/Payment fr/YES BANK L/728628204225/IBL46d48b683bab421584884b59ea e48411/,0.0,60.0,27349.88
11-09-2025,,UPI/Ayush Khan/9899336331@pty/Payment fr/Kotak Mahi/629236679967/IBLc8b3bba36791424b9f7bec2 b430ee45f,0.0,156.0,27193.88
11-09-2025,,UPI/AKHILESH/70300234100742/Payment fr/Punjab Nat/374272087274/IBLa32886ca56ca4487b5db9b06 bcf981c2/,0.0,120.0,27073.88
11-09-2025,,UPI/ZOMATO/payzomato@hdfc/Payment fr/HDFC BANK/919283820127/IBLc0864575b39040c5a61c99 8a1f21f396/,0.0,393.28,26680.6
12-09-2025,,UPI/DEEP CHAND/BHARATPE.9W0C0/Pay to Bha/FEDERAL BA/413896585870/IBL8973adbb497a428586e134def aae63fc,0.0,96.0,26584.6
12-09-2025,,UPI/OM JI/paytmqr6oisgw@/Payment fr/YES BANK L/341247888022/IBL800737f2e823406b9fcd0042032 d1fef/,0.0,28.0,26556.6
12-09-2025,,UPI/Neeraj/8433729041@ibl/Payment fr/INDIAN OVE/873773206750/IBL00342168e1154b4680253f7a df337eca/,0.0,245.0,26311.6
12-09-2025,,UPI/SURENDRA/Q308731419@ybl/Payment fr/Kotak Mahi/388665779617/IBL2bcd6614b18a4159ad78b20 f431160d8/,0.0,104.0,26207.6
13-09-2025,,UPI/SAURABH PR/9773777601-2@a/Payment fr/INDUSINDB/243353282434/AXLb7566533201c43 87a9f075ebe17c0ff9,20000.0,0.0,46207.6
13-09-2025,,UPI/CRED Club/cred.club@axis/payment on/AXIS BANK/562215814759/ACD4ffaf0156eae448d96b611 932ee28a69/,0.0,34808.21,11399.39
13-09-2025,,UPI/Sushil Sah/paytm.s16c644@/Payment fr/YES BANKP/107236253529/IBL49957b9ada2e4c42899b5 246db1f17de,0.0,19.0,11380.39
13-09-2025,,UPI/Blinkit/blinkit.payu@h/UPIIntent/HDFC BANK/425712703773/PPPL25144455681130925223 35168c5a3f7/,0.0,567.0,10813.39
14-09-2025,,UPI/Blinkit/blinkit.payu@h/UPIIntent/HDFC BANK/727904083667/PPPL25148751047140925110 91568c65503/,0.0,408.0,10405.39
14-09-2025,,UPI/UBER INDIA/uberindiasyste/UberRide/AIRTEL PAY/704220454160/RI7KubebGpzswFyoZzer77AVa 0/,0.0,82.17,10323.22
14-09-2025,,UPI/UBER INDIA/uberindiasyste/UberRide/AIRTEL PAY/173089966152/RI1oZuaTYREERPQqZOlzEp71a 0/,0.0,131.63,10191.59
14-09-2025,,UPI/Airtel/AirtelBillPaym/Airtel Bro/AIRTEL PAY/581538507672/PPPL2515722369014092520271 268c6d7c8/,0.0,49.93,10141.66
15-09-2025,,UPI/Blinkit/blinkit.payu@h/UPIIntent/HDFC BANK/940282428006/PPPL25161610201150925082 15968c77f4f/,0.0,778.0,9363.66
15-09-2025,,UPI/SHYAM JI S/shyamji7012@ok/Payment fr/Kotak Mahi/740206894166/IBL8690159ec95447a484841ad 9815a3623,0.0,114.0,9249.66
15-09-2025,,UPI/PROFESSION/paytm.s15anfy@/Payment fr/YES BANKP/348120422045/IBL00744ae540094277bff48b f687f15c9c,0.0,99.0,9150.66
15-09-2025,,UPI/SUDEEP KUM/9675717970-1@o/Payment fr/AXIS BANK/343724400512/IBL6464cacb04ba45bc9244c6 159a1cb978/,0.0,75.0,9075.66
16-09-2025,,UPI/Chandrabha/9761800978@axl/Payment fr/State Bank/362688745433/IBL1c53b9c9569948e880d5b8ff 4837fcc7,0.0,150.0,8925.66
16-09-2025,,UPI/Airtel Mon/airtelmoney114/AirtelMone/AIRTEL PAY/216060790246/IBLff1f40d4ba474124a750e33c8 1029b6e,0.0,200.0,8725.66
16-09-2025,,UPI/MR NIRMAL/7228904019@axl/Payment fr/BANDHAN BA/717786123000/IBL250d2e8a3043454998f6350a5 572364a/,0.0,72.0,8653.66
16-09-2025,,UPI/Amazon Pay/amznlpa-vok95f/You are pa/AXIS BANK/836209984021/APL0199537e1075be3574b0f9 d1fac05700/,0.0,1658.02,6995.64
17-09-2025,,UPI/CHANDRA PA/BHARATPE.9D0Z0/Pay to Bha/UNITY SMAL/750778654083/IBLb81ab5150db04f078e2afd b6a36f2bb4,0.0,137.0,6858.64
17-09-2025,,UPI/Apple Serv/billdeskpg.app/APPLAMP/HDFC BANK/101480901128/HDF982A864E8C8844B692B8 A5F02913150A/,0.0,1199.0,5659.64
