date,mode,particulars,chq./Ref.No.,deposits,withdrawals,balance
01/09/24,UPI,UPI-D NARSING RAO-NARSINGRAO.D@AXL-UBIN0 803219-319457877158-PAYMENT FROM PHONE,0000319457877158,600.0,0.0,695.17
01/09/24,UPI,UPI-SREE BALAJI WINES-PAYTMQR5CWION@PTYS -YESB0PTMUPI-424536972195-PAYMENT FROM P HONE,0000424536972195,0.0,180.0,515.17
01/09/24,UPI,UPI-BHAGWAN DAS MARDA-7816018341@AXL-KVB L0001443-424546162797-PAYMENT FROM PHONE,0000424546162797,1530.0,0.0,2045.17
01/09/24,UPI,UPI-APPALA GURUPRASAD-GURUATNIC.IN@YBL- SBIN0004159-594824946566-PAYMENT FROM PH ONE,0000594824946566,2500.0,0.0,4545.17
01/09/24,UPI,UPI-MUKKERLA GEETA SUDHA-6302856696@YBL- KKBK0007463-461174364576-PAYMENT FROM PH ONE,0000461174364576,0.0,3000.0,1545.17
02/09/24,UPI,UPI-BHARGAVI BUDUMURU-6303219486@YBL-SB IN0020784-955819260982-PAYMENT FROM PHON E,0000955819260982,2170.0,0.0,3715.17
02/09/24,POS,CASH DEPOSIT-416021XXXXXX2657-KACHIGUDA,0000000000002822,55500.0,0.0,59215.17
02/09/24,UPI,UPI-ANGEL ONE LIMITED-ANGELONENSE@ICICI- ICIC0DC0099-424605508006-PAYINGANGELONE,0000424605508006,0.0,10000.0,49215.17
02/09/24,IMPS,IMPS-424610805834-RKATEL TECHNOLOGIES PR IVATE LIMITED-YESB-XXXXXXXXXXX1163-TESTI ALI-AQUA.AHMED98@YBL-UTIB 0001808-876874645495-PAYMENT FROM PHONE,0000424610805834,49180.0,0.0,98395.17
02/09/24,UPI,UPI-PHONEPE-BBPSBP@AXL-UTIB0AXLUPI-70262 0867213-PAYMENT FROM PHONE,0000702620867213,0.0,4387.52,94007.65
02/09/24,UPI,UPI-RAJINDER PAL-PALRAJINDER7891@YBL-SB IN0006645-754412109723-PAYMENT FROM PHON E,0000754412109723,0.0,1000.0,93007.65
02/09/24,UPI,UPI-VENKATESH DAVATH-9963008595@AXL-HDFC 0000317-207069926560-PAYMENT FROM PHONE,0000207069926560,0.0,49180.0,43827.65
02/09/24,UPI,UPI-TAPSTART CAPITAL PRI-MWYNTECHPRIVATE 77.RZP@ICICI-ICIC0DC0099-424616783617-PA YVIARAZORPAY,0000424616783617,0.0,1873.02,41954.63
02/09/24,,BAJAJFIN_BF-1286306_89927080,000000000000000,0.0,9503.0,32451.63
02/09/24,,BAJAJFIN_BF-1286306_89760069,000000000000000,0.0,9101.0,23350.63
02/09/24,,BAJAJFIN_BF-1286306_90002980,000000000000000,0.0,3223.0,20127.63
02/09/24,UPI,UPI-MOHD AHMED ALI-AQUA.AHMED98@YBL-UTIB 0001808-456642324644-PAYMENT FROM PHONE,0000456642324644,180.0,0.0,20307.63
03/09/24,UPI,UPI-MUKKERLA GEETA SUDHA-6302856696@YBL- KKBK0007463-461398289891-PAYMENT FROM PH ONE,0000461398289891,0.0,200.0,20107.63
03/09/24,UPI,UPI-PURUSHOTTAM ADHIKAR-9005457070@AXL- SBIN0012223-505457435694-PAYMENT FROM PH ONE,0000505457435694,3745.0,0.0,23852.63
03/09/24,UPI,UPI-RAPARTI SRIHARI-9493207195@YBL-BKID0 008627-674768207816-PAYMENT FROM PHONE,0000674768207816,0.0,10000.0,13852.63
03/09/24,POS,CASH DEPOSIT-416021XXXXXX2657-BARKATPURA,0000000000002848,43000.0,0.0,56852.63
03/09/24,UPI,CASH APPALA-LAKSHME1202@OKSBI-SB IN0005895-506120957734-UPI,0000000000002850,34000.0,0.0,90852.63
03/09/24,UPI,UPI-KREDITBEE-KREDITBEE.PAYMENTS22@ICICI -ICIC0DC0099-424756963456-PAYMENT FROM P HONE,0000424756963456,0.0,5951.0,84901.63
03/09/24,UPI,UPI-VIVRITI CAPITAL-VIVRITICAPITAL.ESBZ@ ICICI-ICIC0DC0099-424703969461-PAYMENT F ROM PHONE,0000424703969461,0.0,7539.0,77362.63
03/09/24,UPI,UPI-UPMOVE CAPITAL PRIVA-UPMOVECAPITALPR 695125.RZP@RXAIRTEL-AIRP0000011-42471656 0838-UPMOVECAPITALPRIVA,0000424716560838,0.0,8154.54,69208.09
03/09/24,UPI,UPI-LIQUI LOANS-LIQUILOANS.CF@AXISBANK-U TIB0000100-424706240270-PAYMENT FROM PHO NE,0000424706240270,0.0,21485.29,47722.8
04/09/24,NEFT,NEFT CR-UTIB0000846-ONE MOBIKWIK SYSTEMS LIMITED-M MADHU YADAV-AXISCN0733431867,AXISCN0733431867,3910.0,0.0,51632.8
04/09/24,UPI,UPI-HARI BALAJI SAKTHIV-HARI626@YBL-SBI N0003332-093683746414-PAYMENT FROM PHONE,0000093683746414,450.0,0.0,52082.8
04/09/24,POS,POS 416021XXXXXX2657 DMART KACHIGUDA,0000424805236068,0.0,5634.5,46448.3
04/09/24,,ACH D- PROTIUM FINANCE LIMI-772SOZ4MECXP,0000008100316611,0.0,28475.0,17973.3
04/09/24,UPI,UPI-RAPARTI SRIHARI-9493207195@YBL-BKID0 008627-969074112025-PAYMENT FROM PHONE,0000969074112025,0.0,10000.0,7973.3
04/09/24,UPI,UPI-MOHD AHMED ALI-AQUA.AHMED98@YBL-UTIB 0001808-160901939635-PAYMENT FROM PHONE,0000160901939635,180.0,0.0,8153.3
04/09/24,UPI,UPI-KOPPARTHI RAJESH-KOPPARTHIRAJESH991@ IBL-ICIC0001313-283916403964-PAYMENT FRO M PHONE YADAV-Q758292524@YBL-YE SB0YBLUPI-542855087088-UPI,0000283916403964,1240.0,0.0,9393.3
05/09/24,UPI,UPI-SANJUKUMAR-7559479979@YBL-FINO000000 1-424932163321-PAYMENT FROM PHONE,0000424932163321,3720.0,0.0,13113.3
05/09/24,POS,CASH DEPOSIT-XXXXXXXXXX1847-BARKATPURA,0000000000003570,7200.0,0.0,20313.3
05/09/24,UPI,UPI-RAMAKANTH BAJAJ-9032678298-2@AXL-IC IC00ADRSH-424903966795-PAYMENT FROM PHON E,0000424903966795,1000.0,0.0,21313.3
05/09/24,UPI,UPI-JIOIN APP DIRECT-JIOINAPPDIRECT1@AXL -UTIB0AXLUPI-308341486218-PAYMENT FROM P HONE,0000308341486218,0.0,19.0,21294.3
06/09/24,UPI,UPI-BILLA S-9700452204-2@YBL-HSBC0500002 -425013170251-PAYMENT FROM PHONE,0000425013170251,2115.0,0.0,23409.3
06/09/24,,IB BILLPAY DR-HDFC92-434155XXXXXX1025,MB06074712571ET9,0.0,11737.0,11672.3
06/09/24,UPI,UPI-MOHD AHMED ALI-AQUA.AHMED98@YBL-UTIB 0001808-902653727458-PAYMENT FROM PHONE,0000902653727458,180.0,0.0,11852.3
06/09/24,UPI,UPI-K MADHUSUDHAN REDDY-MADHU816@AXL-KKB K0007463-461678039855-PAYMENT FROM PHONE,0000461678039855,1240.0,0.0,13092.3
07/09/24,UPI,UPI-B SHIRISHA-SIRISHA0413@AXL-UBIN08007 67-861273476963-PAYMENT FROM PHONE,0000861273476963,2240.0,0.0,15332.3
07/09/24,UPI,UPI-MOHD AHMED ALI-AQUA.AHMED98@AXL-UTIB 0001808-980226276312-PAYMENT FROM PHONE,0000980226276312,0.0,10000.0,5332.3
08/09/24,UPI,UPI-MUKKERLA GEETA SUDHA-6302856696@YBL- KKBK0007463-461863844021-PAYMENT FROM PH ONE,0000461863844021,10000.0,0.0,15332.3
08/09/24,NEFT,NEFT CR-UTIB0000846-ONE MOBIKWIK SYSTEMS LIMITED-M MADHU YADAV-AXISCN0737654321,AXISCN0737654321,1240.0,0.0,16572.3
08/09/24,POS,CASH DEPOSIT-XXXXXXXXXX1847-BARKATPURA,0000000000004195,9000.0,0.0,25572.3
08/09/24,UPI,UPI-VARTHYAVATH THIRUPAT-THIRUPATHI1981N AIK@YBL-ANDB0001424-425278351608-PAYMENT FROM PHONE,0000425278351608,2100.0,0.0,27672.3
08/09/24,,ACH D- HERO FINCORP LTD-62405711,0000008339653338,0.0,10855.0,16817.3
08/09/24,UPI,UPI-MUKKERLA GEETA SUDHA-6302856696@YBL- KKBK0007463-461801485988-PAYMENT FROM PH ONE,0000461801485988,0.0,1300.0,15517.3
08/09/24,UPI,UPI-MADIGELA MUKESH-Q165870300@YBL-YESB 0YBLUPI-461880740449-PAYMENT FROM PHONE,0000461880740449,0.0,189.0,15328.3
08/09/24,UPI,UPI-JIOIN APP DIRECT-JIOINAPPDIRECT@AXL- UTIB0AXLUPI-933723432290-PAYMENT FROM PH ONE,0000933723432290,0.0,19.0,15309.3
08/09/24,UPI,UPI-JIOIN APP DIRECT-JIOINAPPDIRECT@AXL- UTIB0AXLUPI-241527173249-PAYMENT FROM PH ONE,0000241527173249,0.0,302.0,15007.3
09/09/24,UPI,UPI-MUKKERLA GEETA SUDHA-6302856696@YBL- KKBK0007463-461939094760-PAYMENT FROM PH ONE,0000461939094760,0.0,7000.0,8007.3
09/09/24,POS,CASH DEPOSIT-416021XXXXXX2657-BARKATPURA,0000000000004455,22000.0,0.0,30007.3
09/09/24,UPI,UPI-RAPARTI SRIHARI-9493207195@YBL-BKID0 008627-348580923082-PAYMENT FROM PHONE,0000348580923082,0.0,13000.0,17007.3
09/09/24,UPI,UPI-RAMESH GUPTA-PAYTMQRAPCMUETPN2@PAYTM -YESB0PTMUPI-425334518329-PAYMENT FROM P HONE,0000425334518329,0.0,120.0,16887.3
09/09/24,UPI,UPI-MOHD AHMED ALI-AQUA.AHMED98@YBL-UTIB 0001808-461970915368-PAYMENT FROM PHONE,0000461970915368,270.0,0.0,17157.3
10/09/24,IMPS,IMPS-425408323058-MUKKERLA MADHU-SBIN-XX XXXXX5940-CASH,0000425408323058,0.0,2000.0,15157.3
10/09/24,UPI,UPI-LENDBOX-LENDBOX.RZP@ICICI-ICIC0DC009 9-425469901779-PAYVIARAZORPAY,0000425469901779,0.0,7357.0,7800.3
10/09/24,UPI,UPI-MADIGELA MUKESH-Q165870300@YBL-YESB 0YBLUPI-462086977458-PAYMENT FROM PHONE,0000462086977458,0.0,339.0,7461.3
10/09/24,UPI,UPI-MUKKERLA GEETA SUDHA-6302856696@YBL- KKBK0007463-462060795087-PAYMENT FROM PH ONE,0000462060795087,0.0,5800.0,1661.3
11/09/24,UPI,UPI-BHARTI AIRTEL LIMITE-AIRTELPREDIRECT 2@AXL-UTIB0AXLUPI-462164085652-PAYMENT F ROM PHONE,0000462164085652,0.0,582.0,1079.3
11/09/24,UPI,UPI-SIMMA RAMALAKSHMI-8179933440@AXL-UBI N0800236-462101572657-PAYMENT FROM PHONE,0000462101572657,1155.0,0.0,2234.3
11/09/24,UPI,UPI-ALLI ASHWINIKUMAR-ASHWINYADAV85@YBL- INDB0000839-425536580121-PAYMENT FROM PH ONE,0000425536580121,7000.0,0.0,9234.3
11/09/24,UPI,UPI-MANTHANI RAHUL-9618750503@YBL-CNRB00 00000-462144487050-PAYMENT FROM PHONE,0000462144487050,0.0,9200.0,34.3
11/09/24,UPI,UPI-KONDRAPALLY RAJU-KONDRAPALLYRAJU@YB L-SBIN0021610-462127244498-PAYMENT FROM PHONE 008627-082270876227-PAYMENT FROM PHONE,0000462127244498,1000.0,0.0,1034.3
12/09/24,NEFT,NEFT CR-YESB0000001-ZERODHA BROKING LTD- DSCNB A/C-MUKKERLA MADHU YADAV-YESF34256,YESF342560128236,187.18,0.0,1221.48
12/09/24,UPI,UPI-RAMAKANTH BAJAJ-9032678298-6@IBL-SB IN0007641-462227508954-PAYMENT FROM PHON E,0000462227508954,100.0,0.0,1321.48
12/09/24,UPI,UPI-RAMAKANTH BAJAJ-9032678298-6@IBL-SB IN0007641-462263444021-PAYMENT FROM PHON E,0000462263444021,100.0,0.0,1421.48
12/09/24,UPI,UPI-RAMAKANTH BAJAJ-9032678298-6@IBL-SB IN0007641-462239550756-PAYMENT FROM PHON E,0000462239550756,100.0,0.0,1521.48
12/09/24,UPI,UPI-RAMAKANTH BAJAJ-9032678298-6@IBL-SB IN0007641-462214334048-PAYMENT FROM PHON E,0000462214334048,175.0,0.0,1696.48
12/09/24,UPI,UPI-RAMAKANTH BAJAJ-9032678298-6@IBL-SB IN0007641-462205128877-PAYMENT FROM PHON E,0000462205128877,100.0,0.0,1796.48
12/09/24,UPI,UPI-RAMAKANTH BAJAJ-9032678298-6@IBL-SB IN0007641-462297691398-PAYMENT FROM PHON E,0000462297691398,150.0,0.0,1946.48
12/09/24,UPI,UPI-RAMAKANTH BAJAJ-9032678298-6@IBL-SB IN0007641-462200208533-PAYMENT FROM PHON E,0000462200208533,100.0,0.0,2046.48
12/09/24,UPI,UPI-RAMAKANTH BAJAJ-9032678298-6@IBL-SB IN0007641-462260639326-PAYMENT FROM PHON E,0000462260639326,50.0,0.0,2096.48
12/09/24,,ATW-416021XXXXXX2657-P3ENTS55-HYDERABAD,0000000000005347,0.0,2000.0,96.48
12/09/24,NEFT,NEFT CR-YESB0000001-FINKURVE FINANCIAL S ERVICES LIMITED-M MADHU 2336175-PAYMENT FROM PHONE,0YESB42564826780,8584.0,0.0,8680.48
13/09/24,UPI,UPI-JURRU RAHUL YADAV-9963019626@YBL-SB IN0007641-462389389722-PAYMENT FROM PHON E,0000462389389722,0.0,5000.0,3680.48
13/09/24,,NET PAYIN TO NSE MF A/C -00990610005906- UCC -4114733-130924806687-0099061000590,0000000562157830,0.0,1000.0,2680.48
13/09/24,,NET PAYIN TO NSE MF A/C -00990610005906- UCC -4114733-130924806855-0099061000590,0000000562158041,0.0,1000.0,1680.48
13/09/24,,NET PAYIN TO NSE MF A/C -00990610005906- UCC -4114733-130924807355-0099061000590,0000000562158138,0.0,1000.0,680.48
14/09/24,UPI,UPI-MUKKERLA GEETA SUDHA-6302856696@YBL- KKBK0007463-462449774312-PAYMENT FROM PH ONE,0000462449774312,2500.0,0.0,3180.48
15/09/24,UPI,UPI-HARI BALAJI SAKTHIV-HARI626@YBL-SBI N0003332-462573651054-PAYMENT FROM PHONE,0000462573651054,450.0,0.0,3630.48
15/09/24,,ACH D- LIC OF INDIA-6577926590924,0000008017972259,0.0,2488.0,1142.48
15/09/24,UPI,UPI-MUDDE GAYATHRI-9550147698@AXL-SBIN0 020650-462597907768-PAYMENT FROM PHONE,0000462597907768,11880.0,0.0,13022.48
15/09/24,UPI,UPI-SHAIK HABEEBUDDIN-7989814974@AXISB-I CIC0000558-425962095263-CHITTI,0000425962095263,11880.0,0.0,24902.48
15/09/24,UPI,UPI-PUNJAB WINES-Q239582492@YBL-YESB0YBL UPI-462593825944-PAYMENT FROM PHONE,0000462593825944,0.0,210.0,24692.48
15/09/24,IMPS,IMPS-425913321913-M MADHU YADAV-KKBK-XXX XXX7813-CASH,0000425913321913,0.0,20000.0,4692.48
15/09/24,UPI,UPI-SHAMA AKBAR UBIN0803219-543026032115-UPI,0000462593498141,0.0,450.0,4242.48
15/09/24,UPI,UPI-JONNA KANTI SRIKANTH-Q302880581@YBL- YESB0YBLUPI-462504343669-PAYMENT FROM PH ONE,0000462504343669,0.0,180.0,4062.48
15/09/24,UPI,UPI-MAHESHWARI KUKUTLA-MAHIKUKUTLA11@YBL -IBKL0000594-462563144401-PAYMENT FROM P HONE,0000462563144401,33084.0,0.0,37146.48
15/09/24,UPI,UPI-ANGEL LTD NSE-ANGELONENSE@HDFCBANK-H DFC0000001-425947880810-PAYINGANGELONE,0000425947880810,0.0,10000.0,27146.48
16/09/24,UPI,UPI-MUKKERLA GEETA SUDHA-6302856696@YBL- KKBK0007463-462654299850-PAYMENT FROM PH ONE,0000462654299850,29500.0,0.0,56646.48
16/09/24,UPI,UPI-JIOIN APP DIRECT-JIOINAPPDIRECT@AXL- UTIB0AXLUPI-462606742050-PAYMENT FROM PH ONE,0000462606742050,0.0,302.0,56344.48
16/09/24,UPI,UPI-ANGEL LTD NSE-ANGELONENSE@HDFCBANK-H DFC0000001-426039412239-PAYINGANGELONE,0000426039412239,0.0,18000.0,38344.48
16/09/24,,Transaction,3981222341707430/ZERODHA,0.0,20000.0,18344.48
16/09/24,UPI,UPI-PRASANTH KUMAR T-PRASHANTH8639@AXL-B ARB0VJPUBL-462662677705-PAYMENT FROM PHO NE,0000462662677705,23760.0,0.0,42104.48
16/09/24,IMPS,IMPS-426009388293-SRIDEVI JT1-ICIC-XXXXX XXX3198-CASH,0000426009388293,0.0,14000.0,28104.48
16/09/24,UPI,UPI-MUKUND MANIKRAO ALI-AQUA.AHMED98@AXL-UTIB 0001808-547827734485-PAYMENT FROM PHONE,0000462663086074,1365.0,0.0,29469.48
16/09/24,UPI,UPI-RAPARTHI SRI HARI-9493207195-2@YBL-K KBK0000563-462694684335-PAYMENT FROM PHO NE,0000462694684335,50000.0,0.0,79469.48
16/09/24,UPI,UPI-MUDUMBAI SRINIVAS-9246588510@AXL-UTI B0000370-462602831770-PAYMENT FROM PHONE,0000462602831770,1240.0,0.0,80709.48
16/09/24,UPI,UPI-MUKKERLA GEETA SUDHA-6302856696@YBL- KKBK0007463-462602413089-PAYMENT FROM PH ONE,0000462602413089,0.0,25000.0,55709.48
16/09/24,,ANGEL ONE LIMI-206827297,0000409167199995,6000.0,0.0,61709.48
16/09/24,IMPS,IMPS-426021300712-M MADHU YADAV-KKBK-XXX XXX7813-CASH,0000426021300712,0.0,21000.0,40709.48
17/09/24,UPI,UPI-ANDALA MAHESH YADAV-8019560564@YBL-K KBK0007462-273519361120-PAYMENT FROM PHO NE,0000273519361120,9325.0,0.0,50034.48
17/09/24,,ANGEL ONE LIMI-207388887,0000409178715620,5000.0,0.0,55034.48
18/09/24,NEFT,NEFT CR-YESB0000001-ZERODHA BROKING LTD- DSCNB A/C-MUKKERLA MADHU YADAV-YESF34262,YESF342620647654,10000.0,0.0,65034.48
18/09/24,UPI,UPI-BAJAJ FINANCE LTD LO-BAJAJFINANCEIEP LQR@ICICI-ICIC0DC0099-426219818582-UPI T RANSACTION FO,0000426219818582,0.0,9503.0,55531.48
18/09/24,UPI,UPI-BAJAJ FINANCE LTD LO-BAJAJFINANCEIEP LQR@ICICI-ICIC0DC0099-426259316337-UPI T E,0000426259316337,0.0,9101.0,46430.48
18/09/24,UPI,UPI-BAJAJ FINANCE LTD LO-BAJAJFINANCEIEP LQR@ICICI-ICIC0DC0099-426225842771-UPI T RANSACTION FO,0000426225842771,0.0,3223.0,43207.48
18/09/24,UPI,UPI-PHONEPE-BBPSBP@AXL-UTIB0AXLUPI-46285 2767604-PAYMENT FROM PHONE,0000462852767604,0.0,855.0,42352.48
18/09/24,UPI,UPI-APOLLO FINVEST LIMIT-APOLLOFINVEST.R ZP@HDFCBANK-HDFC0000053-426244193007-PAY VIARAZORPAY,0000426244193007,0.0,1693.0,40659.48
19/09/24,NEFT,NEFT CR-YESB0000001-RESILIENT INNOVATION S PRIVATE LIMIT-M MADHU YADAV-YESB426381,0YESB42638147382,5000.0,0.0,45659.48
19/09/24,NEFT,NEFT CR-YESB0000001-ZERODHA BROKING LTD- DSCNB A/C-MUKKERLA MADHU YADAV-YESF34263,YESF342630102322,3500.0,0.0,49159.48
19/09/24,NEFT,NEFT CR-UTIB0000846-ONE MOBIKWIK SYSTEMS LIMITED-M MADHU YADAV-AXISCN0748956677,AXISCN0748956677,2700.0,0.0,51859.48
19/09/24,,ANGEL ONE LIMI-207610190,0000409190207494,7000.0,0.0,58859.48
19/09/24,UPI,UPI-ANGEL LTD NSE-ANGELONENSE@HDFCBANK-H DFC0000001-426307395559-PAYINGANGELONE,0000426307395559,0.0,10000.0,48859.48
19/09/24,UPI,UPI-RAPARTI SRIHARI-9493207195@YBL-BKID0 008627-462916939172-PAYMENT FROM PHONE,0000462916939172,0.0,13000.0,35859.48
19/09/24,UPI,UPI-PHONEPE-BBPSBP@AXL-UTIB0AXLUPI-46291 7986101-PAYMENT FROM PHONE,0000462917986101,0.0,9065.11,26794.37
19/09/24,UPI,UPI-M ARVIND-9550183344@YBL-KKBK000745 5-462936954878-PAYMENT FROM PHONE,0000462936954878,0.0,1000.0,25794.37
19/09/24,UPI,UPI-MADIGELA,0000462987970802,0.0,216.0,25578.37
20/09/24,UPI,UPI-MUKKERLA GEETA SUDHA-6302856696@YBL- KKBK0007463-463076969636-PAYMENT FROM PH ONE,0000463076969636,0.0,3000.0,22578.37
20/09/24,UPI,UPI-VODAFONE IDEA ANDHR-VIINAPPAP@AXL-U TIB0AXLUPI-463035704447-PAYMENT FROM PHO NE,0000463035704447,0.0,100.0,22478.37
20/09/24,UPI,UPI-MOHD AHMED ALI-AQUA.AHMED98@YBL-UTIB 0001808-463070370461-PAYMENT FROM PHONE,0000463070370461,900.0,0.0,23378.37
20/09/24,UPI,UPI-NAYI KOTI SEKHAR-SHEKAR.NAIKOTI1@YBL -CNRB0000033-463020048275-PAYMENT FROM P HONE,0000463020048275,0.0,1200.0,22178.37
20/09/24,UPI,UPI-JANARDHAN FILL POINT-BPCLJANARDHANFI LLKACHIGUDA0008@YBL-YESB0YBLUPI-46305791 2054-PAYMENT FOR GTZ347,0000463057912054,0.0,450.0,21728.37
20/09/24,UPI,UPI-RAMAKANTH BAJAJ-9032678298-8@YBL-SB IN0007641-463060676367-PAYMENT FROM PHON E,0000463060676367,895.0,0.0,22623.37
21/09/24,UPI,UPI-PUNY PALS HIGH SCHOO-PUNYPALSHIGHSCH OOLDORMA@ICICI-ICIC0DC0099-426503545555- PAYMENT FROM PHONE,0000426503545555,0.0,1706.0,20917.37
21/09/24,IMPS,IMPS-426519303938-M MADHU YADAV-KKBK-XXX XXX7813-CASH,0000426519303938,0.0,1000.0,19917.37
22/09/24,UPI,UPI-MOHD SHAFEEQ SB0YBLUPI-543436827939-UPI,0000426681540644,0.0,107.0,19810.37
22/09/24,UPI,UPI-MURALIKRISHNA VEGETA-GPAY-1124438713 1@OKBIZAXIS-UTIB0000553-426637776598-PAY MENT FROM PHONE,0000426637776598,0.0,410.0,19400.37
22/09/24,UPI,UPI-PHONEPE-BBPSBP@AXL-UTIB0AXLUPI-46329 0089492-PAYMENT FROM PHONE,0000463290089492,0.0,3000.0,16400.37
22/09/24,IMPS,IMPS-426614872982-RKATEL TECHNOLOGIES PR IVATE LIMITED-YESB-XXXXXXXXXXX1163-TESTI NSTA,0000426614872982,10000.0,0.0,26400.37
22/09/24,IMPS,IMPS-426614366963-M MADHU YADAV-KKBK-XXX XXX7813-CASH,0000426614366963,0.0,23000.0,3400.37
22/09/24,IMPS,IMPS-426614885986-RKATEL TECHNOLOGIES PR IVATE LIMITED-YESB-XXXXXXXXXXX1163-TESTI NSTA,0000426614885986,20000.0,0.0,23400.37
22/09/24,UPI,UPI-ARJUNA RAO SARA-9394889503@AXL-SBIN 0011661-463209711181-PAYMENT FROM PHONE,0000463209711181,15000.0,0.0,38400.37
22/09/24,UPI,UPI-MARGAM VANI-9392657723@AXL-SBIN0021 100-463283816251-PAYMENT FROM PHONE,0000463283816251,0.0,26000.0,12400.37
22/09/24,UPI,UPI-KSK VENTURES-BHARATPE907720046052@YE SBANKLTD-YESB0YESUPI-426632700543-PAY TO KSK VENTURE,0000426632700543,0.0,180.0,12220.37
23/09/24,UPI,UPI-RAPARTI SRIHARI-9493207195@YBL-BKID0 008627-463339751088-PAYMENT FROM PHONE,0000463339751088,0.0,10000.0,2220.37
24/09/24,UPI,NEFT CR-YESB0000001-ZERODHA BROKING LTD- RAJ-ARVINDRAJ57964-1@OKHDFC BANK-HDFC0000512-101191091901-UPI,YESF342680232294,2500.0,0.0,4720.37
24/09/24,,ANGEL ONE LIMI-209028445,0000409235849473,25000.0,0.0,29720.37
24/09/24,UPI,UPI-ANGEL LTD NSE-ANGELONENSE@HDFCBANK-H DFC0000001-426847908665-PAYINGANGELONE,0000426847908665,0.0,6000.0,23720.37
24/09/24,,ZHDF2X901MEEFT/BILLDKRATNAKARBANKLI,0002426862619003,0.0,22000.0,1720.37
24/09/24,IMPS,IMPS-426811843144-RKATEL TECHNOLOGIES PR IVATE LIMITED-YESB-XXXXXXXXXXX1163-TESTI NSTA,0000426811843144,19600.0,0.0,21320.37
24/09/24,NEFT,NEFT CR-ICIC0099999-ANGEL ONE LIMITED CL IENT AC-MUKKERLA MADHU YADAV-CMS45213362,000CMS4521336255,16000.0,0.0,37320.37
25/09/24,NEFT,NEFT CR-YESB0000001-ZERODHA BROKING LTD- DSCNB A/C-MUKKERLA MADHU YADAV-YESF34269,YESF342690338161,3500.0,0.0,40820.37
25/09/24,NEFT,NEFT CR-UTIB0000846-ONE MOBIKWIK SYSTEMS LIMITED-M MADHU YADAV-AXISCN0754803112,AXISCN0754803112,1500.0,0.0,42320.37
25/09/24,UPI,UPI-MARGAM VANI-9392657723@AXL-SBIN0021 100-463514210051-PAYMENT FROM PHONE,0000463514210051,0.0,26000.0,16320.37
25/09/24,UPI,UPI-ANGEL LTD NSE-ANGELONENSE@HDFCBANK-H DFC0000001-426945608635-PAYINGANGELONE,0000426945608635,0.0,4500.0,11820.37
25/09/24,UPI,UPI-AIRTEL RECHARGE-AIRTELPREDIRECT2@AXL -UTIB0AXLUPI-463581425939-PAYMENT FROM P,0000463581425939,0.0,252.0,11568.37
25/09/24,UPI,UPI-MEHFIL-PAYTM-75000139@PTYS-YESB0PTMU PI-426993537295-PAYMENT FROM PHONE,0000426993537295,0.0,260.0,11308.37
25/09/24,NEFT,NEFT CR-YESB0000001-FINKURVE FINANCIAL S ERVICES LIMITED-M MADHU YADAV-YESB426914,0YESB42691459646,8584.0,0.0,19892.37
25/09/24,NEFT,NEFT CR-ICIC0099999-ANGEL ONE LIMITED CL IENT AC-MUKKERLA MADHU YADAV-CMS45241576,000CMS4524157638,7000.0,0.0,26892.37
26/09/24,NEFT,NEFT CR-YESB0000001-ZERODHA BROKING LTD- DSCNB A/C-MUKKERLA MADHU YADAV-YESF34270,YESF342700265005,3500.0,0.0,30392.37
26/09/24,NEFT,NEFT CR-UTIB0000206-RESILIENT INNOVATION S PRIVATE LIMITED- NODAL ACCOU-M MADHU Y ADAV-AXNFCN0755763598,AXNFCN0755763598,3000.0,0.0,33392.37
26/09/24,NEFT,NEFT CR-UTIB0000846-ONE MOBIKWIK SYSTEMS LIMITED-M MADHU YADAV-AXISCN0755987218,AXISCN0755987218,4000.0,0.0,37392.37
26/09/24,UPI,UPI-HEERAKAR MANMOHAN-PAYTMQR1Q2WDHJ8T5@ PAYTM-YESB0PTMUPI-427058145948-PAYMENT F ROM PHONE,0000427058145948,0.0,620.0,36772.37
26/09/24,UPI,UPI-N LAXAMAIAH AND BROT-PAYTMQRWH0TRT4W ED@PAYTM-YESB0PTMUPI-427005076776-PAYMEN T FROM PHONE,0000427005076776,0.0,450.0,36322.37
26/09/24,UPI,UPI-MUKKERLA GEETA SUDHA-6302856696@YBL- KKBK0007463-463690468176-PAYMENT FROM PH ONE,0000463690468176,0.0,16000.0,20322.37
26/09/24,UPI,UPI-MADIGELA MUKESH-Q165870300@YBL-YESB 0YBLUPI-463612049408-PAYMENT FROM PHONE,0000463612049408,0.0,216.0,20106.37
26/09/24,UPI,UPI-AGRAWALA SWEETS HOUS-7207029090@OKBI ZAXIS-UTIB0000553-427046704758-PAYMENT F ROM PHONE,0000427046704758,0.0,100.0,20006.37
26/09/24,UPI,UPI-MOHAMMED MASIUDDIN-Q988017422@YBL-YE SB0YBLUPI-463631066802-PAYMENT FROM PHON E,0000463631066802,0.0,414.0,19592.37
26/09/24,UPI,UPI-JAYADEEPA M S-BHARATPE.90069770319@F BPE-FDRL0001382-427076474297-PAY TO BHAR ATPE ME,0000427076474297,0.0,80.0,19512.37
26/09/24,NEFT,NEFT CR-ICIC0099999-ANGEL ONE LIMITED CL IENT AC-MUKKERLA MADHU YADAV-CMS45266518,000CMS4526651853,5000.0,0.0,24512.37
27/09/24,NEFT,NEFT CR-YESB0000001-ZERODHA BROKING LTD- DSCNB A/C-MUKKERLA MADHU YADAV-YESF34271,YESF342710350951,5500.0,0.0,30012.37
27/09/24,UPI,UPI-MANE NAVNEETHA-PAYTMQR5C8BFC@PTYS-YE SB0PTMUPI-427146888264-PAYMENT FROM PHON,0000427146888264,0.0,30.0,29982.37
27/09/24,UPI,UPI-FATAKPAY DIGITAL PRI-FATAKPAYDIGITAL 929958.RZP@RXAIRTEL-AIRP0000011-42717965 4186-FATAKPAYDIGITALPRI,0000427179654186,0.0,6001.18,23981.19
27/09/24,IMPS,IMPS-427108462272-FDPL FINANCE PRIVATE-I CIC-XXXXXXXX3844-ICITXN20710046,0000427108462272,5225.0,0.0,29206.19
27/09/24,UPI,UPI-ANGEL LTD NSE-ANGELONENSE@HDFCBANK-H DFC0000001-427129658450-PAYINGANGELONE,0000427129658450,0.0,3000.0,26206.19
27/09/24,UPI,UPI-PUNJAB WINES-PAYTM.S14IOSB@PTY-YESB0 MCHUPI-427120037912-PAYMENT FROM PHONE,0000427120037912,0.0,660.0,25546.19
27/09/24,UPI,UPI-ANGEL LTD NSE-ANGELONENSE@HDFCBANK-H DFC0000001-427171786448-PAYINGANGELONE,0000427171786448,0.0,800.0,24746.19
27/09/24,UPI,UPI-SRI LAKSHMI NARASIMH-Q484293518@YBL- YESB0YBLUPI-463763721435-PAYMENT FROM PH ONE,0000463763721435,0.0,550.0,24196.19
29/09/24,UPI,UPI-15524 APOLLO PHARMAC-PAYTM-83520469@ PTYS-YESB0PTMUPI-427343419321-PAYMENT FR OM PHONE,0000427343419321,0.0,152.97,24043.22
29/09/24,UPI,UPI-RAPARTI SRIHARI-9493207195@YBL-BKID0 008627-463923486191-PAYMENT FROM PHONE,0000463923486191,0.0,13000.0,11043.22
29/09/24,UPI,UPI-MUKKERLA GEETA SUDHA-6302856696@YBL- KKBK0007463-463965430498-PAYMENT FROM PH ONE,0000463965430498,0.0,10000.0,1043.22
30/09/24,UPI,UPI-HARI BALAJI SAKTHIV-HARI626@YBL-SBI N0003332-464037231038-PAYMENT FROM PHONE,0000464037231038,810.0,0.0,1853.22
30/09/24,UPI,UPI-AKSHAY UBIN0803219-507252006135-UPI,0000427439091731,1350.0,0.0,3203.22
30/09/24,UPI,UPI-MUKKERLA GEETA SUDHA-6302856696@YBL- KKBK0007463-464017636616-PAYMENT FROM PH ONE,0000464017636616,0.0,1000.0,2203.22
01/10/24,,INTEREST PAID TILL 30-SEP-2024,000000000000000,453.0,0.0,2656.22
01/10/24,UPI,UPI-ANGEL LTD NSE-ANGELONENSE@HDFCBANK-H DFC0000001-427573968087-PAYINGANGELONE,0000427573968087,0.0,950.0,1706.22
01/10/24,UPI,UPI-MUNTHA RAMESH YADAV-RAMEESHM6666@YBL -BKID0008604-464176119467-PAYMENT FROM P HONE,0000464176119467,10000.0,0.0,11706.22
01/10/24,POS,CASH DEPOSIT-416021XXXXXX2657-EAST MARRE DPALLY,0000000000006274,49200.0,0.0,60906.22
01/10/24,POS,CASH DEPOSIT-416021XXXXXX2657-EAST MARRE DPALLY,0000000000006276,10300.0,0.0,71206.22
01/10/24,,ZHDFQ1Y025DCS8/BILLDKRATNAKARBANKLI,0002427563288743,0.0,6857.0,64349.22
01/10/24,UPI,UPI-UPMOVE CAPITAL PRIVA-UPMOVECAPITALPR 321112.RZP@AXISBANK-UTIB0000100-26509580 2754-POWERED BY SMARTCO,0000265095802754,0.0,40758.54,23590.68
01/10/24,IMPS,IMPS-427526213953-TAPSTART CAPITAL PVT L TD-RATN-XXXXXXXX6589-WITHDRAWAL,0000427526213953,4391.3,0.0,27981.98
02/10/24,UPI,UPI-PURUSHOTTAM ADHIKARI-ADHIKARIPURUSHO TTAM@YBL-BARB0BARKAT-464209844444-PAYMEN T FROM PHONE,0000464209844444,3185.0,0.0,31166.98
02/10/24,UPI,UPI-ALLI B0PTMUPI-507323146303-UPI,0000427632537680,0.0,1000.0,30166.98
02/10/24,NEFT,NEFT CR-FDRL0009993-NORTHERN ARC CAPITAL LIMITED-M MADHU YADAV-FBBT242766284041,FBBT242766284041,41814.0,0.0,71980.98
02/10/24,UPI,UPI-ANGEL LTD NSE-ANGELONENSE@HDFCBANK-H DFC0000001-427614812846-PAYINGANGELONE,0000427614812846,0.0,19900.0,52080.98
02/10/24,UPI,UPI-KREDITBEE-KREDITBEE.PAYMENTS22@ICICI -ICIC0DC0099-427689142356-PAYMENT FROM P HONE,0000427689142356,0.0,5951.0,46129.98
02/10/24,UPI,UPI-VIVRITI CAPITAL-VIVRITICAPITAL.ESBZ@ ICICI-ICIC0DC0099-427652709570-PAYMENT F ROM PHONE,0000427652709570,0.0,7539.0,38590.98
02/10/24,UPI,UPI-ZERODHA-ZERODHABROKING@YESBANK-YESB0 000022-427691705724-5591460071501113 Z,0000427691705724,0.0,10000.0,28590.98
03/10/24,UPI,UPI-BHARGAVI BUDUMURU-6303219486@YBL-SB IN0020784-464308621794-PAYMENT FROM PHON E,0000464308621794,1890.0,0.0,30480.98
03/10/24,POS,CASH DEPOSIT-416021XXXXXX2657-BARKATPURA,0000000000009907,17500.0,0.0,47980.98
03/10/24,POS,CASH DEPOSIT-416021XXXXXX2657-BARKATPURA,0000000000009909,2000.0,0.0,49980.98
03/10/24,POS,CASH DEPOSIT BY - M MADHU YADAV - BARKAT PURA,000000000000000,8400.0,0.0,58380.98
03/10/24,UPI,UPI-RAPARTI SRIHARI-9493207195@YBL-BKID0 008627-464351148103-PAYMENT FROM PHONE,0000464351148103,0.0,10000.0,48380.98
03/10/24,UPI,UPI-PODUNOORU RAKESH-RAKESHNAIDU2610@AX MOHIUDDIN-Q654287932@YBL-YESB0Y BLUPI-544122751612-UPI,0000464355374244,1240.0,0.0,49620.98
03/10/24,UPI,UPI-BILLA S-9700452204-2@YBL-HSBC0500002 -427780675739-PAYMENT FROM PHONE,0000427780675739,1305.0,0.0,50925.98
03/10/24,UPI,UPI-B SHIRISHA-SIRISHA0413@YBL-UBIN08007 67-464390069878-PAYMENT FROM PHONE,0000464390069878,2175.0,0.0,53100.98
03/10/24,NEFT,NEFT CR-ICIC0099999-ANGEL ONE LIMITED CL IENT AC-MUKKERLA MADHU YADAV-CMS45459846,000CMS4545984621,6000.0,0.0,59100.98
04/10/24,NEFT,NEFT CR-YESB0000001-ZERODHA BROKING LTD- DSCNB A/C-MUKKERLA MADHU YADAV-YESF34278,YESF342780005529,2500.0,0.0,61600.98
04/10/24,POS,CASH DEPOSIT-416021XXXXXX2657-BARKATPURA,0000000000000239,9600.0,0.0,71200.98
04/10/24,UPI,UPI-SASHIKALA BHANDARI-9032117972@IBL-S BIN0005895-464445334876-PAYMENT FROM PHO NE,0000464445334876,3150.0,0.0,74350.98
04/10/24,UPI,UPI-LIQUILOANS-CF.LIQUILOANS@ICICI-ICIC0 DC0099-427882972781-PAYMENT FROM PHONE,0000427882972781,0.0,21485.29,52865.69
04/10/24,UPI,UPI-ZERODHA BROKING LTD-ZERODHABROKING@H DFCBANK-HDFC0000523-427889349376-0037812 530050769 Z,0000427889349376,0.0,300.0,52565.69
04/10/24,,ACH D- PROTIUM FINANCE LIMI-R2UB3HWMKHV7,0000009427650725,0.0,28475.0,24090.69
04/10/24,UPI,UPI-RAPARTI SRIHARI-9493207195@YBL-BKID0 008627-464404110846-PAYMENT FROM PHONE,0000464404110846,0.0,10000.0,14090.69
04/10/24,UPI,UPI-KANDADI MADHUSUDHAN -MADHUSUDHANSMIL S-YESB0PTMUPI-507794857432-UPI,0000464427332870,1200.0,0.0,15290.69
04/10/24,UPI,UPI-MUKKERLA GEETA SUDHA-6302856696@YBL- KKBK0007463-464461726530-PAYMENT FROM PH ONE,0000464461726530,0.0,10000.0,5290.69
04/10/24,UPI,UPI-MUKKERLA GEETA SUDHA-6302856696@YBL- KKBK0007463-464412360128-PAYMENT FROM PH ONE,0000464412360128,0.0,3000.0,2290.69
04/10/24,UPI,UPI-MUKKERLA GEETA SUDHA-6302856696@YBL- KKBK0007463-464496297768-PAYMENT FROM PH ONE,0000464496297768,10000.0,0.0,12290.69
04/10/24,UPI,UPI-KOPPARTHI RAJESH-KOPPARTHIRAJESH991@ IBL-ICIC0001313-464412910162-PAYMENT FRO M PHONE,0000464412910162,1000.0,0.0,13290.69
04/10/24,UPI,UPI-MOHD SALEEM-9059047869SALEEM@YBL-SB IN0001765-464430603664-PAYMENT FROM PHON E,0000464430603664,2280.0,0.0,15570.69
04/10/24,UPI,UPI-MR RAVI TEJA POTHAR-7842597617@AXL- CBIN0280808-427880546242-PAYMENT FROM PH ONE,0000427880546242,0.0,1350.0,14220.69
04/10/24,UPI,UPI-P ARUNA KUMARI-PSHYAM2030@YBL-UBIN08 03782-024515023270-PAYMENT FROM PHONE,0000024515023270,5000.0,0.0,19220.69
04/10/24,UPI,UPI-MUKKERLA GEETA SUDHA-6302856696@YBL- KKBK0007463-464489778195-PAYMENT FROM PH ONE XXX7813-CASH,0000464489778195,0.0,2000.0,17220.69
05/10/24,,ANGEL ONE LIMI-1036990137,0000410054603134,17027.15,0.0,34247.84
05/10/24,NEFT,NEFT CR-YESB0000001-ZERODHA BROKING LTD- DSCNB A/C-MUKKERLA MADHU YADAV-YESF34279,YESF342791711304,10404.67,0.0,44652.51
05/10/24,UPI,UPI-MUKKERLA GEETA SUDHA-6302856696@YBL- KKBK0007463-464525986436-PAYMENT FROM PH ONE,0000464525986436,0.0,44000.0,652.51
05/10/24,POS,CASH DEPOSIT-416021XXXXXX2657-BARKATPURA,0000000000000580,12600.0,0.0,13252.51
05/10/24,UPI,UPI-RADHARAPU NAGALAXMI-6281800943@AXL-A PGV0000001-982910876250-PAYMENT FROM PHO NE,0000982910876250,1350.0,0.0,14602.51
06/10/24,,IB BILLPAY DR-HDFC92-434155XXXXXX1025,MB06084716070T16,0.0,11927.0,2675.51
06/10/24,UPI,UPI-BHAGWAN DAS MARDA-7816018341@AXL-KVB L0001443-428068404004-PAYMENT FROM PHONE,0000428068404004,1305.0,0.0,3980.51
06/10/24,POS,CASH DEPOSIT-XXXXXXXXXX1847-BARKATPURA,0000000000000799,8500.0,0.0,12480.51
07/10/24,,ANGEL ONE LIMI-212190358,0000410077619697,5473.06,0.0,17953.57
07/10/24,UPI,UPI-ANGEL LTD NSE-ANGELONENSE@HDFCBANK-H DFC0000001-428168842145-PAYINGANGELONE,0000428168842145,0.0,6000.0,11953.57
07/10/24,UPI,UPI-ZERODHA BROKING LTD-ZERODHABROKING@H DFCBANK-HDFC0000523-428191949643-3776994 694357369 Z,0000428191949643,0.0,650.0,11303.57
07/10/24,UPI,UPI-RAPARTI SRIHARI-9493207195@YBL-BKID0 008627-564835568375-PAYMENT FROM PHONE,0000564835568375,38000.0,0.0,49303.57
07/10/24,UPI,UPI-ANGEL LTD NSE-ANGELONENSE@HDFCBANK-H DFC0000001-670000727905-PAYINGANGELONE,0000670000727905,0.0,10000.0,39303.57
08/10/24,UPI,UPI-ZERODHA-ZERODHABROKING@YESBANK-YESB0 000022-071957741000-6291649871676943 Z,0000071957741000,0.0,10000.0,29303.57
08/10/24,,ACH D- HERO FINCORP LTD-62405711,0000009824930060,0.0,10855.0,18448.57
08/10/24,UPI,UPI-TRANSACTREE TECHNOLO-LENDBOX819058.R ZP@AXISBANK-UTIB0000100-506239701832-PAY VIARAZORPAY,0000506239701832,0.0,7357.0,11091.57
08/10/24,UPI,UPI-RADHARAPU NAGALAXMI-6281800943@YBL-A PGV0000001-894035371152-PAYMENT FROM PHO NE,0000894035371152,270.0,0.0,11361.57
08/10/24,NEFT,NEFT CR-ICIC0099999-ANGEL ONE LIMITED CL IENT AC-MUKKERLA MADHU YADAV-CMS45660989,000CMS4566098900,5000.0,0.0,16361.57
08/10/24,UPI,UPI-LENDBOX-LENDBOX.RAZORPAY@AXISBANK-UT IB0001506-184788468254-PAYVIARAZORPAY,0000184788468254,0.0,14618.0,1743.57
08/10/24,IMPS,IMPS-428220857881-TRUECREDITSPVTLT-UTIB- XXXXXXXXXXX0537-TRUECREDITS,0000428220857881,23000.0,0.0,24743.57
09/10/24,NEFT,NEFT CR-YESB0000001-ZERODHA BROKING LTD- DSCNB A/C-MUKKERLA MADHU YADAV-YESF34283,YESF342830008108,1000.0,0.0,25743.57
09/10/24,UPI,UPI-ANGEL LTD NSE-ANGELONENSE@HDFCBANK-H DFC0000001-178308161102-PAYINGANGELONE,0000178308161102,0.0,5800.0,19943.57
09/10/24,UPI,UPI-ZERODHA-ZERODHABROKING@YESBANK-YESB0 000022-444860969787-4996304538636272 Z 015-424247418146-PAYMENT FROM PHONE,0000444860969787,0.0,1500.0,18443.57
09/10/24,,NWD-416021XXXXXX2657-OSEC3180-SECUNDERAB AD,0000428310018206,0.0,1000.0,17443.57
09/10/24,UPI,UPI-RAPARTI SRIHARI-9493207195@YBL-BKID0 008627-098553912435-PAYMENT FROM PHONE,0000098553912435,0.0,13000.0,4443.57
09/10/24,IMPS,IMPS-428314384175-M MADHU YADAV-KKBK-XXX XXX7813-CASH,0000428314384175,0.0,1000.0,3443.57
09/10/24,IMPS,IMPS-428314374993-MUKKERLA MADHU-SBIN-XX XXXXX5940-CASH,0000428314374993,0.0,2000.0,1443.57
09/10/24,NEFT,NEFT CR-ICIC0099999-ANGEL ONE LIMITED CL IENT AC-MUKKERLA MADHU YADAV-CMS45689903,000CMS4568990330,7000.0,0.0,8443.57
10/10/24,NEFT,NEFT CR-YESB0000001-ZERODHA BROKING LTD- DSCNB A/C-MUKKERLA MADHU YADAV-YESF34284,YESF342840030285,8000.0,0.0,16443.57
10/10/24,UPI,UPI-ANGEL LTD NSE-ANGELONENSE@HDFCBANK-H DFC0000001-875520450219-PAYINGANGELONE,0000875520450219,0.0,2200.0,14243.57
10/10/24,UPI,UPI-ZERODHA BROKING LTD-ZERODHABROKING@H DFCBANK-HDFC0000523-616270131974-8780895 370848460 Z,0000616270131974,0.0,2000.0,12243.57
10/10/24,UPI,UPI-ZERODHA-ZERODHABROKING@YESBANK-YESB0 000022-601221853918-9173419131077520 Z,0000601221853918,0.0,4000.0,8243.57
10/10/24,UPI,UPI-ZERODHA-ZERODHABROKING@YESBANK-YESB0 000022-362636995105-0980992315706703 Z,0000362636995105,0.0,800.0,7443.57
10/10/24,UPI,UPI-ZERODHA BROKING LTD-ZERODHABROKING@H,0000799355551365,0.0,1000.0,6443.57
10/10/24,IMPS,IMPS-428418758412-RKATEL TECHNOLOGIES PR IVATE LIMITED-YESB-XXXXXXXXXXX1163-TESTI NSTA,0000428418758412,128500.0,0.0,134943.57
10/10/24,UPI,UPI-ANEESH KUMAR THOTA-9014141131@YBL-HD FC0001041-590475510151-PAYMENT FROM PHON E,0000590475510151,0.0,100000.0,34943.57
10/10/24,NEFT,NEFT CR-ICIC0099999-ANGEL ONE LIMITED CL IENT AC-MUKKERLA MADHU YADAV-CMS45718677,000CMS4571867774,10000.0,0.0,44943.57
11/10/24,UPI,UPI-T SWATHI-9014807616@AXL-SBIN0020701 -968435238953-PAYMENT FROM PHONE,0000968435238953,3825.0,0.0,48768.57
11/10/24,UPI,UPI-DAFTARDAR ANAND-7731898619@AXL-HDFC0 000545-720498475967-PAYMENT FROM PHONE,0000720498475967,4975.0,0.0,53743.57
11/10/24,IMPS,IMPS-428514301777-M MADHU YADAV-KKBK-XXX XXX7813-CASH,0000428514301777,0.0,28500.0,25243.57
11/10/24,UPI,UPI-SAMARJIT DAS-8016265252@AXL-SBIN004 0462-465131683556-PAYMENT FROM PHONE,0000465131683556,15559.0,0.0,40802.57
11/10/24,UPI,UPI-G PRASHANTH-7702920675@AXL-UTIB00008 81-938520498304-PAYMENT FROM PHONE,0000938520498304,0.0,19690.0,21112.57
11/10/24,NEFT,NEFT CR-ICIC0099999-ANGEL ONE LIMITED CL IENT AC-MUKKERLA MADHU YADAV-CMS45741432,000CMS4574143296,3700.0,0.0,24812.57
12/10/24,UPI,UPI-ARRA SANTHOSHA-9949123063@YBL-UTIB00 1@OKAXIS-KKBK0007463-544734480953-UPI,0000465272803021,21167.0,0.0,45979.57
12/10/24,UPI,UPI-KARAN JAIN-9063908658-2@YBL-FDRL0005 555-503994010745-PAYMENT FROM PHONE,0000503994010745,0.0,20000.0,25979.57
13/10/24,UPI,UPI-BHARKATHPURA-BHARKATHPURA.60983458@H DFCBANK-HDFC0000001-780364070983-PAYMENT FROM PHONE,0000780364070983,0.0,58.0,25921.57
13/10/24,UPI,UPI-ANGEL LTD NSE-ANGELONENSE@HDFCBANK-H DFC0000001-836491292622-PAYINGANGELONE,0000836491292622,0.0,18000.0,7921.57
13/10/24,IMPS,IMPS-428713792842-M MADHU YADAV-KKBK-XXX XXX7813-CASH,0000428713792842,15000.0,0.0,22921.57
13/10/24,UPI,UPI-ZERODHA BROKING LTD-ZERODHABROKING@H DFCBANK-HDFC0000523-613239744978-5476753 167161047 Z,0000613239744978,0.0,14500.0,8421.57
14/10/24,UPI,UPI-MR S HARI BALAJI-HARIBALAJI626@YBL-I DIB000P006-465462311091-PAYMENT FROM PHO NE,0000465462311091,810.0,0.0,9231.57
14/10/24,UPI,UPI-PHONEPE-BBPSBP@AXL-UTIB0AXLUPI-69576 6318509-PAYMENT FROM PHONE,0000695766318509,0.0,1512.28,7719.29
14/10/24,UPI,UPI-JIO RECHARGE-JIOINAPPDIRECT1@AXL-UTI B0AXLUPI-316850445029-PAYMENT FROM PHONE,0000316850445029,0.0,302.0,7417.29
14/10/24,,NET PAYIN TO NSE MF A/C -00990610005906- UCC -4114733-141024819642-0099061000590,0000000571828435,0.0,1000.0,6417.29
14/10/24,,NET PAYIN TO NSE MF A/C -00990610005906- UCC -4114733-141024820940-0099061000590,0000000571828562,0.0,1000.0,5417.29
14/10/24,UPI,NET PAYIN TO NSE MF A/C -00990610005906- UCC -4114733-141024822122-0099061000590 VEGETA-GPAY-1124438713 1@OKBIZAXIS-UTIB0000553-544884955388-UPI,0000000571828654,0.0,1000.0,4417.29
14/10/24,NEFT,NEFT CR-ICIC0099999-ANGEL ONE LIMITED CL IENT AC-MUKKERLA MADHU YADAV-CMS45788448,000CMS4578844867,7000.0,0.0,11417.29
14/10/24,UPI,UPI-ROSHINI BOOK CENTER-7337589844-3@AXL -BKID0008606-465437826649-PAYMENT FROM P HONE,0000465437826649,2320.0,0.0,13737.29
15/10/24,NEFT,NEFT CR-YESB0000001-ZERODHA BROKING LTD- DSCNB A/C-MUKKERLA MADHU YADAV-YESF34289,YESF342890386521,5000.0,0.0,18737.29
15/10/24,IMPS,IMPS-428904338599-M MADHU YADAV-KKBK-XXX XXX7813-CASH,0000428904338599,0.0,13000.0,5737.29
15/10/24,,NWD-416021XXXXXX2657-20650621-MUSHEERABA D,0000428908000033,0.0,2000.0,3737.29
15/10/24,,ACH D- LIC OF INDIA-6577926591024,0000008068893289,0.0,2488.0,1249.29
15/10/24,UPI,UPI-ZERODHA BROKING LTD-ZERODHABROKING@H DFCBANK-HDFC0000523-625998266845-4586994 293331515 Z,0000625998266845,0.0,1000.0,249.29
15/10/24,UPI,UPI-SAMBA SARITHA-8555955685@AXL-KKBK00 07463-465573643114-PAYMENT FROM PHONE,0000465573643114,42334.0,0.0,42583.29
15/10/24,UPI,UPI-ANGEL LTD NSE-ANGELONENSE@HDFCBANK-H DFC0000001-721881899094-PAYINGANGELONE,0000721881899094,0.0,10000.0,32583.29
15/10/24,IMPS,IMPS-428921328451-M MADHU YADAV-KKBK-XXX XXX7813-CASH,0000428921328451,0.0,22000.0,10583.29
16/10/24,NEFT,NEFT CR-YESB0000001-ZERODHA BROKING,YESF342900385956,13000.0,0.0,23583.29
16/10/24,UPI,UPI-ANGEL LTD NSE-ANGELONENSE@HDFCBANK-H DFC0000001-955533524672-PAYINGANGELONE,0000955533524672,0.0,5000.0,18583.29
16/10/24,UPI,UPI-ZERODHA-ZERODHABROKING@YESBANK-YESB0 000022-433014337801-3894669631623883 Z,0000433014337801,0.0,1800.0,16783.29
16/10/24,UPI,UPI-ANGEL LTD NSE-ANGELONENSE@HDFCBANK-H DFC0000001-867047377940-PAYINGANGELONE,0000867047377940,0.0,3800.0,12983.29
16/10/24,UPI,UPI-ABBOJU HARISH-9110749456@AXL-SBIN00 20128-864937693019-PAYMENT FROM PHONE,0000864937693019,40.0,0.0,13023.29
16/10/24,UPI,UPI-SRI AMBICA WINES-PAYTMQR5XIA1Q@PTYS- YESB0PTMUPI-850763760416-PAYMENT FROM PH ONE,0000850763760416,0.0,180.0,12843.29
17/10/24,UPI,UPI-M ANIL YADAV-53933315@YBL-UBIN080321 9-805455826206-PAYMENT FROM PHONE,0000805455826206,50000.0,0.0,62843.29
17/10/24,UPI,UPI-ANGEL LTD NSE-ANGELONENSE@HDFCBANK-H DFC0000001-884907169446-PAYINGANGELONE,0000884907169446,0.0,20000.0,42843.29
17/10/24,IMPS,IMPS-429109396091-SRIDEVI JT1-ICIC-XXXXX XXX3198-CASH,0000429109396091,0.0,14000.0,28843.29
17/10/24,UPI,UPI-ANGEL LTD NSE-ANGELONENSE@HDFCBANK-H DFC0000001-415014395126-PAYINGANGELONE,0000415014395126,0.0,10000.0,18843.29
18/10/24,UPI,UPI-ZERODHA BROKING LTD-ZERODHABROKING@H DFCBANK-HDFC0000523-453296547933-0448085 SUJATHA-SUJATHAGANAT13@OKSBI- SBIN0005895-545145546265-UPI,0000453296547933,0.0,5100.0,13743.29
18/10/24,NEFT,NEFT CR-UTIB0000846-ONE MOBIKWIK SYSTEMS LIMITED-M MADHU YADAV-AXISCN0781590187,AXISCN0781590187,20.0,0.0,13763.29
18/10/24,UPI,UPI-VODAFONE IDEA ANDHR-VIINAPPAP@AXL-U TIB0AXLUPI-325161662026-PAYMENT FROM PHO NE,0000325161662026,0.0,100.0,13663.29
18/10/24,,NWD-416021XXXXXX2657-00916248-HYDERABAD,0000429210017520,0.0,1000.0,12663.29
18/10/24,UPI,UPI-VODAFONE IDEA ANDHR-VIINAPPAP@AXL-U TIB0AXLUPI-530158257244-PAYMENT FROM PHO NE,0000530158257244,0.0,181.0,12482.29
18/10/24,IMPS,IMPS-429215315296-MUKKERLA MADHU-SBIN-XX XXXXX5940-CASH,0000429215315296,0.0,2000.0,10482.29
18/10/24,UPI,UPI-XXXXXX1876-SBIN0000001-088059975634- PAYMENT FROM PHONE,0000088059975634,0.0,6000.0,4482.29
18/10/24,UPI,UPI-JIO RECHARGE-JIOINAPPDIRECT1@AXL-UTI B0AXLUPI-110184284437-PAYMENT FROM PHONE,0000110184284437,0.0,19.0,4463.29
18/10/24,UPI,UPI-PHONEPE-BBPSBP@YBL-YESB0YBLUPI-39673 5637049-PAYMENT FROM PHONE,0000396735637049,0.0,855.0,3608.29
20/10/24,UPI,UPI-AMAZON INDIA-AMAZON@RAPL-RATN000RAPL -948125346992-YOU ARE PAYING FOR,0000948125346992,0.0,499.0,3109.29
20/10/24,UPI,UPI-MAHESHWARI KUKUTLA-MAHIKUKUTLA11@IBL -IBKL0000594-466064225833-PAYMENT FROM P HONE,0000466064225833,25142.0,0.0,28251.29
20/10/24,UPI,UPI-JONAGADALA ARCHANA-9398756092-5@IBL- JALA-JALAMAHENDRA@OKAXIS-K KBK0007466-508674121398-UPI,0000031250798310,0.0,350.0,27901.29
20/10/24,UPI,UPI-MOHD AHMED ALI-AQUA.AHMED98@AXL-UTIB 0001808-806995679747-PAYMENT FROM PHONE,0000806995679747,0.0,10000.0,17901.29
20/10/24,UPI,UPI-NAYI KOTI SEKHAR-SHEKAR.NAIKOTI1@YBL -CNRB0000033-164839669734-PAYMENT FROM P HONE,0000164839669734,0.0,1200.0,16701.29
20/10/24,UPI,UPI-BANDA BHAVANI YADAV-7901235777@AXL-H DFC0001628-521908207497-PAYMENT FROM PHO NE,0000521908207497,14255.0,0.0,30956.29
20/10/24,UPI,UPI-MUKKERLA GEETA SUDHA-6302856696@YBL- KKBK0007463-618348881415-PAYMENT FROM PH ONE,0000618348881415,0.0,1200.0,29756.29
20/10/24,UPI,UPI-MUKKERLA GEETA SUDHA-6302856696@YBL- KKBK0007463-153208129616-PAYMENT FROM PH ONE,0000153208129616,0.0,11000.0,18756.29
21/10/24,,ANGEL ONE LIMI-215481347,0000410216855336,10000.0,0.0,28756.29
21/10/24,UPI,UPI-ZERODHA BROKING LTD-ZERODHABROKING@H DFCBANK-HDFC0000523-180551582851-9925921 939042166 Z,0000180551582851,0.0,10000.0,18756.29
21/10/24,UPI,UPI-ZERODHA BROKING LTD-ZERODHABROKING@H DFCBANK-HDFC0000523-815666673987-9496335 439913353 Z,0000815666673987,0.0,2000.0,16756.29
21/10/24,UPI,UPI-MUKKERLA GEETA SUDHA-6302856696@YBL- ALI-AQUA.AHMED98@AXL-UTIB 0001808-824658179956-PAYMENT FROM PHONE,0000143802568610,0.0,2000.0,14756.29
21/10/24,UPI,UPI-ANDALA MADHURI-7013976660-2@IBL-SBI N0005895-199791950314-PAYMENT FROM PHONE,0000199791950314,10000.0,0.0,24756.29
21/10/24,UPI,UPI-ABBOJU HARISH-9110749456@AXL-SBIN00 20128-965227094651-PAYMENT FROM PHONE,0000965227094651,40.0,0.0,24796.29
21/10/24,NEFT,NEFT CR-ICIC0099999-ANGEL ONE LIMITED CL IENT AC-MUKKERLA MADHU YADAV-CMS45935194,000CMS4593519460,6000.0,0.0,30796.29
22/10/24,UPI,UPI-MUNTHA RAMESH YADAV-RAMEESHM6666@YBL -BKID0008604-340822082924-PAYMENT FROM P HONE,0000340822082924,0.0,8000.0,22796.29
22/10/24,UPI,UPI-ABBOJU HARISH-9110749456@YBL-SBIN00 20128-226238520385-PAYMENT FROM PHONE,0000226238520385,40.0,0.0,22836.29
22/10/24,UPI,UPI-AUTO PRIME-Q017194179@YBL-YESB0YBLUP I-618234779493-PAYMENT FROM PHONE,0000618234779493,0.0,450.0,22386.29
22/10/24,NEFT,NEFT CR-ICIC0099999-ANGEL ONE LIMITED CL IENT AC-MUKKERLA MADHU YADAV-CMS45962194,000CMS4596219427,6500.0,0.0,28886.29
23/10/24,UPI,UPI-FATAKPAY DIGITAL PRI-FATAKPAYDIGITAL 929958.RZP@RXAIRTEL-AIRP0000011-11019520 9250-FATAKPAYDIGITALPRI,0000110195209250,0.0,6001.18,22885.11
23/10/24,IMPS,IMPS-429708565363-FDPL FINANCE PRIVATE-I CIC-XXXXXXXX3844-ICITXN23884727,0000429708565363,5225.0,0.0,28110.11
23/10/24,UPI,UPI-ZERODHA BROKING LTD-ZERODHABROKING@H DFCBANK-HDFC0000523-243785972180-6313752,0000243785972180,0.0,10000.0,18110.11
23/10/24,UPI,UPI-RAPARTI SRIHARI-9493207195@YBL-BKID0 008627-903282626789-PAYMENT FROM PHONE,0000903282626789,0.0,10000.0,8110.11
23/10/24,UPI,UPI-ANGEL LTD NSE-ANGELONENSE@HDFCBANK-H DFC0000001-927046736309-PAYINGANGELONE,0000927046736309,0.0,5000.0,3110.11
23/10/24,UPI,UPI-M MADHU YADAV-M.MADHUYADAV261@YBL-KK BK0007463-330584868378-PAYMENT FROM PHON E,0000330584868378,10000.0,0.0,13110.11
23/10/24,,NWD-416021XXXXXX2657-00916173-HYDERABAD,0000429719007592,0.0,10000.0,3110.11
23/10/24,UPI,UPI-ANGEL LTD NSE-ANGELONENSE@HDFCBANK-H DFC0000001-104420359900-PAYINGANGELONE,0000104420359900,0.0,3000.0,110.11
24/10/24,UPI,UPI-M MADHU YADAV-M.MADHUYADAV261@YBL-KK BK0007463-984926496866-PAYMENT FROM PHON E,0000984926496866,10000.0,0.0,10110.11
24/10/24,UPI,UPI-ANGEL LTD NSE-ANGELONENSE@HDFCBANK-H DFC0000001-531140328337-PAYINGANGELONE,0000531140328337,0.0,10000.0,110.11
24/10/24,IMPS,IMPS-429828059752-SHADVAL PAY PRIVATE LI MITED-RATN-XXXXXXXX1978-BILL,0000429828059752,49000.0,0.0,49110.11
24/10/24,UPI,UPI-ANGEL LTD NSE-ANGELONENSE@HDFCBANK-H DFC0000001-992963735036-PAYINGANGELONE,0000992963735036,0.0,6000.0,43110.11
24/10/24,UPI,UPI-JURRU RAHUL YADAV-9963019626@YBL-SB IN0007641-739263447072-PAYMENT FROM PHON E,0000739263447072,0.0,5040.0,38070.11
24/10/24,UPI,UPI-ZERODHA BROKING LTD-ZERODHABROKING@H DFCBANK-HDFC0000523-041107485156-3833327,0000041107485156,0.0,500.0,37570.11
24/10/24,UPI,UPI-MOHD AHMED ALI-AQUA.AHMED98@AXL-UTIB 0001808-756487224108-PAYMENT FROM PHONE,0000756487224108,180.0,0.0,37750.11
24/10/24,UPI,UPI-SHEKER NAIKOTI-Q749996981@YBL-YESB0 YBLUPI-961691588315-PAYMENT FROM PHONE,0000961691588315,0.0,400.0,37350.11
24/10/24,UPI,UPI-ANGEL LTD NSE-ANGELONENSE@HDFCBANK-H DFC0000001-105880816463-PAYINGANGELONE,0000105880816463,0.0,12000.0,25350.11
25/10/24,UPI,UPI-PHONEPE-BBPSBP@AXL-UTIB0AXLUPI-05168 9676972-PAYMENT FROM PHONE,0000051689676972,0.0,12056.64,13293.47
25/10/24,UPI,UPI-ZERODHA BROKING LTD-ZERODHABROKING@H DFCBANK-HDFC0000523-488275311473-7688909 100729857 Z,0000488275311473,0.0,10000.0,3293.47
25/10/24,UPI,UPI-ANGEL LTD NSE-ANGELONENSE@HDFCBANK-H DFC0000001-420731629880-PAYINGANGELONE,0000420731629880,0.0,3000.0,293.47
25/10/24,UPI,UPI-MOHD AHMED ALI-AQUA.AHMED98@AXL-UTIB 0001808-875236439898-PAYMENT FROM PHONE,0000875236439898,90.0,0.0,383.47
27/10/24,UPI,UPI-SITHALA SATHIBABU-Q855384536@YBL-YE SB0YBLUPI-430181724542-UPI,0000430181724542,0.0,60.0,323.47
27/10/24,UPI,UPI-K RAMESH-Q693269516@YBL-YESB0YBLUPI -444742431891-PAYMENT FROM PHONE,0000444742431891,0.0,10.0,313.47
27/10/24,UPI,UPI-MADABOINA LAKSHMI PR-7801047285@YBL- ICIC0001114-130303086744-PAYMENT FROM PH ONE,0000130303086744,0.0,50.0,263.47
27/10/24,UPI,UPI-MR MADHU SUDHAN GHO-MADHUSUDHANGHOD KE2@YBL-MAHB0000383-491815945303-PAYMENT PURAM@OKSBI-HDFC0000218-509048097274-UPI,0000491815945303,2000.0,0.0,2263.47
27/10/24,UPI,UPI-ABBOJU HARISH-9110749456@AXL-SBIN00 20128-191537871015-PAYMENT FROM PHONE,0000191537871015,80.0,0.0,2343.47
27/10/24,UPI,UPI-M ANIL YADAV-53933315@YBL-UBIN080321 9-019389679302-PAYMENT FROM PHONE,0000019389679302,50000.0,0.0,52343.47
27/10/24,UPI,UPI-M ANIL YADAV-53933315@YBL-UBIN080321 9-679166189722-PAYMENT FROM PHONE,0000679166189722,30000.0,0.0,82343.47
27/10/24,UPI,UPI-ZERODHA BROKING LTD-ZERODHABROKING@H DFCBANK-HDFC0000523-318956257370-0206522 299242326 Z,0000318956257370,0.0,15000.0,67343.47
27/10/24,UPI,UPI-ANGEL LTD NSE-ANGELONENSE@HDFCBANK-H DFC0000001-234940129023-PAYINGANGELONE,0000234940129023,0.0,20000.0,47343.47
28/10/24,,NWD-416021XXXXXX2657-07641623-HIMAYATHNA GAR,0000430204020386,0.0,1500.0,45843.47
28/10/24,UPI,UPI-M ANIL YADAV-ANILYADAV63473-1@OKSBI- UBIN0803219-466890666051-UPI,0000466890666051,0.0,600.0,45243.47
28/10/24,UPI,UPI-PAYMEINDIA-PAYMEINDIAEZB1@ICICI-ICIC 0DC0099-466869973227-UPI,0000466869973227,0.0,10418.0,34825.47
28/10/24,UPI,UPI-M MADHU YADAV-M.MADHUYADAV261@YBL-KK BK0007463-602308876574-PAYMENT FROM PHON E,0000602308876574,0.0,10000.0,24825.47
28/10/24,UPI,UPI-FAIZANSALMANI6052OKI-FAIZANSALMANI60 52@OKICICI-PUNB0277600-466858994201-UPI,0000466858994201,0.0,1750.0,23075.47
28/10/24,,NWD-416021XXXXXX2657-00916173-HYDERABAD,0000430215020428,0.0,1500.0,21575.47
28/10/24,UPI,UPI-MARGAM VANI-VANIMARGAM510@OKICICI-S BIN0021100-466820308428-UPI,0000466820308428,10000.0,0.0,31575.47
28/10/24,UPI,UPI-SURESH RUPARA-KUMARRONAK7@OKA XIS-HDFC0000545-545831440265-APRIL MILK BILL,0000430218391750,1900.0,0.0,33475.47
28/10/24,UPI,UPI-LIBERTYSRIHARIOKICIC-LIBERTYSRIHARI@ OKICICI-BKID0008627-466805797344-UPI,0000466805797344,0.0,650.0,32825.47
28/10/24,UPI,UPI-M ANIL YADAV-9966254742@YBL-ANDB0000 321-580709683073-PAYMENT FROM PHONE,0000580709683073,0.0,1000.0,31825.47
28/10/24,NEFT,NEFT CR-ICIC0099999-ANGEL ONE LIMITED CL IENT AC-MUKKERLA MADHU YADAV-CMS46097332,000CMS4609733278,10000.0,0.0,41825.47
29/10/24,NEFT,NEFT CR-YESB0000001-ZERODHA BROKING LTD- DSCNB A/C-MUKKERLA MADHU YADAV-YESF34303,YESF343030019610,3500.0,0.0,45325.47
29/10/24,UPI,UPI-M ANIL YADAV-ANILYADAV63473-1@OKHDFC BANK-UBIN0803219-430333444935-UPI,0000430333444935,1070.0,0.0,46395.47
29/10/24,UPI,UPI-AKHILESH MANJEKAR-ARYAAKHIL5395@YBL- IBKL0001273-518083568732-PAYMENT FROM PH ONE,0000518083568732,10000.0,0.0,56395.47
29/10/24,UPI,UPI-RAPARTI SRIHARI-9493207195@YBL-BKID0 008627-711902679265-PAYMENT FROM PHONE,0000711902679265,0.0,52000.0,4395.47
29/10/24,UPI,UPI-RAPARTI SRIHARI-9493207195@YBL-BKID0 008627-618433230613-PAYMENT FROM PHONE,0000618433230613,50000.0,0.0,54395.47
29/10/24,UPI,UPI-RAPARTHI SRI HARI-9493207195-2@YBL-K KBK0000563-743602168814-PAYMENT FROM PHO NE,0000743602168814,50000.0,0.0,104395.47
29/10/24,,ZHDF6RM03WGIN4/BILLDKRATNAKARBANKLI,0002430365950797,0.0,27108.22,77287.25
29/10/24,UPI,IMPS-430311456001-CHAMPIONSOFTWARETE-UTI B-XXXXXXXXXXX4412-CHAMPIONSOFTWAREECTEZX ZAXIS-UTIB0000553-509249800240-UPI,0000430311456001,20000.0,0.0,97287.25
29/10/24,IMPS,IMPS-430311305924-MUKKERLA MADHU-SBIN-XX XXXXX5940-CASH,0000430311305924,0.0,70000.0,27287.25
29/10/24,UPI,UPI-NORTHERN ARC-NORTHERNARC495902.RZP@A XISBANK-UTIB0000100-268581603034-POWERED BY SMARTCO,0000268581603034,0.0,7134.54,20152.71
29/10/24,,ZHDFDUV03WIXSF/BILLDKRATNAKARBANKLI,0002430365952515,0.0,6857.0,13295.71
29/10/24,UPI,UPI-JAI DEV KUMAR JAI DE-GUBBAJAIDEV42@O KSBI-SBIN0005895-430313732069-UPI,0000430313732069,0.0,896.0,12399.71
29/10/24,UPI,UPI-LIBERTYSRIHARIOKICIC-LIBERTYSRIHARI@ OKICICI-BKID0008627-466958326721-UPI,0000466958326721,0.0,650.0,11749.71
29/10/24,UPI,UPI-SHIRISHA BICUN-SHIRISHAJALA008@OKSB I-SBIN0021926-466969939091-UPI,0000466969939091,0.0,10000.0,1749.71
29/10/24,UPI,UPI-JANARDHAN FILL POINT-BPCLJANARDHANFI LLKACHIGUDA0008@YBL-YESB0YBLUPI-46699125 0055-PAYMENT FOR GTZ447,0000466991250055,0.0,550.0,1199.71
29/10/24,UPI,UPI-MOHD AHMED ALI-AQUA.AHMED98@YBL-UTIB 0001808-662065413117-PAYMENT FROM PHONE,0000662065413117,360.0,0.0,1559.71
29/10/24,NEFT,NEFT CR-ICIC0099999-ANGEL ONE LIMITED CL IENT AC-MUKKERLA MADHU YADAV-CMS46134624,000CMS4613462437,6000.0,0.0,7559.71
29/10/24,UPI,UPI-M ANIL YADAV-9966254742@YBL-ANDB0000 321-841399407551-PAYMENT FROM PHONE,0000841399407551,0.0,1000.0,6559.71
30/10/24,NEFT,NEFT CR-YESB0000001-ZERODHA BROKING LTD- DSCNB A/C-MUKKERLA MADHU,YESF343040216289,5000.0,0.0,11559.71
30/10/24,UPI,UPI-JURRU RAHUL YADAV-Q203666937@YBL-YE SB0YBLUPI-467043681496-UPI,0000467043681496,0.0,160.0,11399.71
30/10/24,UPI,UPI-NARLA SRIKANTH YADA-Q470718822@YBL- YESB0YBLUPI-553680619060-PAYMENT FROM PH ONE,0000553680619060,0.0,75.0,11324.71
30/10/24,UPI,UPI-ANGEL LTD NSE-ANGELONENSE@HDFCBANK-H DFC0000001-760536958965-PAYINGANGELONE,0000760536958965,0.0,10000.0,1324.71
30/10/24,NEFT,NEFT CR-YESB0000001-FINKURVE FINANCIAL S ERVICES LIMITED-M MADHU YADAV-YESB430495,0YESB43049524030,8584.0,0.0,9908.71
30/10/24,UPI,UPI-OMSRIGAYATRISTORES-BHARATPE.90066767 841@FBPE-FDRL0001382-430440609814-PAY TO BHARATPE ME,0000430440609814,0.0,200.0,9708.71
30/10/24,UPI,UPI-DEEP SHIKHA GUPTA-AKG03071965@OKSBI- BARB0HIMHYD-430428296425-UPI,0000430428296425,0.0,1450.0,8258.71
30/10/24,UPI,UPI-SYEDSADAQ71OKICICI-SYEDSADAQ71@OKICI CI-ICIC0000242-467064418589-UPI,0000467064418589,0.0,500.0,7758.71
30/10/24,UPI,UPI-NUTAN MEDICAL HALL-7337557229@OKBIZA XIS-UTIB0000553-430479823667-UPI,0000430479823667,0.0,147.0,7611.71
30/10/24,UPI,UPI-MURALI GADDAM-MURALIGGADDAM@OKSBI-S BIN0016294-430466418281-UPI,0000430466418281,0.0,500.0,7111.71
30/10/24,UPI,UPI-JIO RECHARGE-JIOINAPPDIRECT@YBL-YESB 0YBLUPI-181442553338-PAYMENT FROM PHONE PI,0000181442553338,0.0,19.0,7092.71
30/10/24,NEFT,NEFT CR-ICIC0099999-ANGEL ONE LIMITED CL IENT AC-MUKKERLA MADHU YADAV-CMS46171553,000CMS4617155360,5000.0,0.0,12092.71
31/10/24,UPI,UPI-KUMBUM VIJAYA LAKSHM-LAKSHMIVIJAYA85 60@OKHDFCBANK-HDFC0000081-430535430603-U PI,0000430535430603,1515.0,0.0,13607.71
31/10/24,UPI,UPI-JURRU RAHUL YADAV-Q203666937@YBL-YE SB0YBLUPI-766374449067-PAYMENT FROM PHON E,0000766374449067,0.0,160.0,13447.71
31/10/24,UPI,UPI-SANTOSH KUMAR YADAV-Q548583816@YBL-Y ESB0YBLUPI-681149727379-PAYMENT FROM PHO NE,0000681149727379,0.0,90.0,13357.71
31/10/24,UPI,UPI-JAI DEV KUMAR JAI DE-GUBBAJAIDEV42@O KSBI-SBIN0005895-467152540935-UPI,0000467152540935,0.0,1008.0,12349.71
31/10/24,UPI,UPI-PANYAM MANJULA-MANJUPANYAM@OKSBI-SB IN0007641-430523977585-MILK BILL,0000430523977585,3600.0,0.0,15949.71
31/10/24,UPI,UPI-VAMSHIKA-SHAKTHI.VAMSHIKA@YBL-CNRB00 00033-480826672018-PAYMENT FROM PHONE,0000480826672018,0.0,450.0,15499.71
31/10/24,UPI,UPI-SHAKTHI KASHI SINGH-BHARATPE.9053452 381@FBPE-FDRL0001382-883710255400-VERIFI ED MERCHANT,0000883710255400,0.0,140.0,15359.71
31/10/24,UPI,UPI-SATYA NARAYANA CHALA-PAYTMQR1ELO0O3P D8@PAYTM-YESB0PTMUPI-180250404223-PAYMEN T FROM PHONE SRIVASTAVA-HARSHITASINGHPAB ARI@OKAXIS-KARB0000289-546076453851-UPI,0000180250404223,0.0,30.0,15329.71
31/10/24,UPI,UPI-ZERODHA BROKING LTD-ZERODHABROKING@H DFCBANK-HDFC0000523-430569742832-3422004 662552695 Z,0000430569742832,0.0,10000.0,5329.71
31/10/24,UPI,UPI-ANIL SO SHISHPAL-Q047206811@YBL-YESB 0YBLUPI-559381680360-PAYMENT FROM PHONE,0000559381680360,0.0,260.0,5069.71
31/10/24,UPI,UPI-ANGEL LTD NSE-ANGELONENSE@HDFCBANK-H DFC0000001-430544557928-PAYINGANGELONE,0000430544557928,0.0,5000.0,69.71
31/10/24,UPI,UPI-MOHD AHMED ALI-AQUA.AHMED98@AXL-UTIB 0001808-626196089299-PAYMENT FROM PHONE,0000626196089299,180.0,0.0,249.71
31/10/24,NEFT,NEFT CR-ICIC0099999-ANGEL ONE LIMITED CL IENT AC-MUKKERLA MADHU YADAV-CMS46188263,000CMS4618826346,335.64,0.0,585.35
01/11/24,UPI,UPI-JURRU RAHUL YADAV-Q203666937@YBL-YE SB0YBLUPI-467223586507-UPI,0000467223586507,0.0,60.0,525.35
01/11/24,UPI,UPI-KOUR H-HARDEEPKOUR24@OKSBI-HSBC05000 02-430690088950-UPI,0000430690088950,1395.0,0.0,1920.35
01/11/24,POS,CASH DEPOSIT-XXXXXXXXXX1847-BARKATPURA,0000000000006073,10000.0,0.0,11920.35
01/11/24,UPI,UPI-MUNTHA RAMESH YADAV-RAMEESHM6666@YBL -BKID0008604-952646362369-PAYMENT FROM P HONE,0000952646362369,0.0,4000.0,7920.35
01/11/24,UPI,UPI-AKSHAY CHINTALA-9849868607@AXISB-CNR B0000033-430630416357-PAID VIA CRED AND,0000430630416357,1215.0,0.0,9135.35
01/11/24,UPI,UPI-PANYAM,0000430615481568,880.0,0.0,10015.35
01/11/24,UPI,UPI-LAKSHMI APPALA-LAKSHME1202@OKSBI-SB IN0005895-430619727796-UPI,0000430619727796,2800.0,0.0,12815.35
01/11/24,UPI,UPI-M MADHU YADAV-M.MADHUYADAV261@YBL-KK BK0007463-394416353786-PAYMENT FROM PHON E,0000394416353786,0.0,3000.0,9815.35
01/11/24,UPI,UPI-M ANIL YADAV-9966254742@YBL-ANDB0000 321-667858848939-PAYMENT FROM PHONE,0000667858848939,0.0,1000.0,8815.35
01/11/24,UPI,UPI-MUKKERLA GEETA SUDHA-6302856696@YBL- KKBK0007463-374049670727-PAYMENT FROM PH ONE,0000374049670727,0.0,3000.0,5815.35
01/11/24,UPI,UPI-LIBERTYSRIHARIOKICIC-LIBERTYSRIHARI@ OKICICI-BKID0008627-467203235961-UPI,0000467203235961,0.0,650.0,5165.35
01/11/24,UPI,UPI-JURRU RAHUL YADAV-Q203666937@YBL-YE SB0YBLUPI-467244524464-UPI,0000467244524464,0.0,160.0,5005.35
01/11/24,UPI,UPI-MOHD AHMED ALI-AQUA.AHMED98@YBL-UTIB 0001808-962015017006-PAYMENT FROM PHONE,0000962015017006,90.0,0.0,5095.35
01/11/24,UPI,UPI-M ANIL YADAV-ANILYADAV63473-1@OKSBI- UBIN0803219-430698940546-UPI,0000430698940546,0.0,700.0,4395.35
02/11/24,UPI,UPI-JURRU RAHUL YADAV-Q758292524@YBL-YE SB0YBLUPI-467374253638-UPI,0000467374253638,0.0,240.0,4155.35
02/11/24,UPI,UPI-BHIMASHANKER SHIVDAR-Q118225625@YBL- YESB0YBLUPI-430757461399-UPI E,0000430757461399,0.0,60.0,4095.35
02/11/24,UPI,UPI-BHAGWAN DAS MARDA-7816018341@AXL-KVB L0001443-320535681557-PAYMENT FROM PHONE,0000320535681557,1485.0,0.0,5580.35
02/11/24,POS,CASH DEPOSIT-416021XXXXXX2657-BARKATPURA,0000000000006324,5500.0,0.0,11080.35
02/11/24,UPI,UPI-BHARGAVI BUDUMURU-6303219486@YBL-SB IN0020784-032185030520-PAYMENT FROM PHON E,0000032185030520,2100.0,0.0,13180.35
02/11/24,UPI,UPI-M ANIL YADAV-9966254742@YBL-ANDB0000 321-008011529844-PAYMENT FROM PHONE,0000008011529844,0.0,1000.0,12180.35
03/11/24,UPI,UPI-MOHAMMED HAFEEZ-Q788329660@YBL-YESB0 YBLUPI-467415898454-UPI,0000467415898454,0.0,440.0,11740.35
03/11/24,UPI,UPI-14067 APOLLO PHARMAC-PAYTM-83521556@ PTYS-YESB0PTMUPI-467441803788-UPI,0000467441803788,0.0,99.0,11641.35
03/11/24,UPI,UPI-RAPARTI SRIHARI-9493207195@YBL-BKID0 008627-609738537532-PAYMENT FROM PHONE,0000609738537532,0.0,10000.0,1641.35
03/11/24,POS,CASH DEPOSIT-416021XXXXXX2657-BARKATPURA,0000000000006563,56500.0,0.0,58141.35
03/11/24,UPI,UPI-N P TOOLS CORPORATIO-Q571272455@YBL- YESB0YBLUPI-467457811341-UPI,0000467457811341,0.0,40.0,58101.35
03/11/24,UPI,UPI-KRAZYBEE-CF.KRAZYBEE@ICICI-ICIC0DC00 99-467411305873-KREDITBEEPAYMENT,0000467411305873,0.0,5951.0,52150.35
03/11/24,UPI,UPI-VIVRITI CAPITAL PRIV-VIVRITICAPITALL 439736.RZP@RXAIRTEL-AIRP0000011-46741391 5912-VIVRITICAPITALLIMI,0000467413915912,0.0,7539.0,44611.35
03/11/24,UPI,UPI-PHONEPE-BBPSBP@YBL-YESB0YBLUPI-24117 1233590-PAYMENT FROM PHONE,0000241171233590,0.0,6000.0,38611.35
03/11/24,UPI,UPI-RAGHUNATH SRIDHAR-Q366667576@YBL-YE BIN0020701-509612660664-UPI,0000467464825247,0.0,350.0,38261.35
03/11/24,UPI,UPI-B VINOD KUMAR-BALERAOVINOD077@OKSBI- CNRB0000033-430860137947-UPI,0000430860137947,0.0,200.0,38061.35
04/11/24,UPI,UPI-JURRU RAHUL YADAV-Q758292524@YBL-YE SB0YBLUPI-430911550407-UPI,0000430911550407,0.0,200.0,37861.35
04/11/24,POS,CASH DEPOSIT-XXXXXXXXXX1847-HIMAYATNAGAR,0000000000009368,10000.0,0.0,47861.35
04/11/24,,ANGEL ONE LIMI-218519654,0000411048740181,2027.21,0.0,49888.56
04/11/24,UPI,UPI-ANGEL LTD NSE-ANGELONENSE@HDFCBANK-H DFC0000001-467579148820-PAYINGANGELONE,0000467579148820,0.0,2500.0,47388.56
04/11/24,,ACH D- PROTIUM FINANCE LIMI-HLZJIMIXM9PT,0000000705942925,0.0,28475.0,18913.56
04/11/24,UPI,UPI-RAPARTI SRIHARI-9493207195@YBL-BKID0 008627-008478844044-PAYMENT FROM PHONE,0000008478844044,0.0,10000.0,8913.56
04/11/24,UPI,UPI-BILLA S-9700452204-2@AXL-HSBC0500002 -631144017544-PAYMENT FROM PHONE,0000631144017544,1240.0,0.0,10153.56
04/11/24,UPI,UPI-PURUSHOTTAM ADHIKAR-9005457070@AXL- SBIN0012223-596568247486-PAYMENT FROM PH ONE,0000596568247486,1575.0,0.0,11728.56
04/11/24,UPI,UPI-NEELAM SETHI-NEELAMSETHI741@OKAXIS-U BIN0534773-430984024114-UPI,0000430984024114,3240.0,0.0,14968.56
04/11/24,UPI,UPI-SHAIK IBRAHIM-9666429643@AXL-SBIN00 15760-531149161233-PAYMENT FROM PHONE,0000531149161233,2000.0,0.0,16968.56
04/11/24,UPI,UPI-SHAIK IBRAHIM-9666429643@YBL-SBIN00 15760-072550848876-PAYMENT FROM PHONE,0000072550848876,30.0,0.0,16998.56
04/11/24,UPI,UPI-RONAK NEELESH RUPARA-KUMARRONAK7@OKA XIS-HDFC0000545-467578927755-MILK BILL KKBK0007463-546396238873-UPI,0000467578927755,1007.0,0.0,18005.56
04/11/24,UPI,UPI-VEMULA VIKRAM GOUD S-VIKRAMGOUDVEMUL A3@AXL-UBIN0532754-662956504716-PAYMENT FROM PHONE,0000662956504716,2200.0,0.0,20205.56
04/11/24,UPI,UPI-M ANIL YADAV-9966254742@YBL-ANDB0000 321-113185798875-PAYMENT FROM PHONE,0000113185798875,0.0,1000.0,19205.56
04/11/24,UPI,UPI-LIBERTYSRIHARIOKICIC-LIBERTYSRIHARI@ OKICICI-BKID0008627-467580360335-UPI,0000467580360335,0.0,650.0,18555.56
04/11/24,UPI,UPI-JAI DEV KUMAR JAI DE-GUBBAJAIDEV42@O KSBI-SBIN0005895-467595355207-UPI,0000467595355207,0.0,1008.0,17547.56
04/11/24,POS,CASH DEPOSIT-416021XXXXXX2657-HYDERGUDA,0000000000005457,8100.0,0.0,25647.56
04/11/24,UPI,UPI-LIQUILOANS-CF.LIQUILOANS@ICICI-ICIC0 DC0099-467563959643-UPI,0000467563959643,0.0,21485.29,4162.27
04/11/24,UPI,UPI-RAJESH C PATEL-CNKRAJESHPATEL@OKAXIS -KKBK0008052-430998740679-UPI,0000430998740679,3945.0,0.0,8107.27
04/11/24,UPI,UPI-SHIVARAJ MAHADEVAPPA-9494271546@AXL- SBIN0020192-606546133409-PAYMENT FROM PH ONE,0000606546133409,675.0,0.0,8782.27
04/11/24,UPI,UPI-SASHIKALA BHANDARI-9032117972@AXL-S BIN0005895-118853566310-PAYMENT FROM PHO NE,0000118853566310,3490.0,0.0,12272.27
04/11/24,POS,CASH DEPOSIT-XXXXXXXXXX1847-BARKATPURA,0000000000006904,13500.0,0.0,25772.27
04/11/24,UPI,UPI-M MADHU YADAV-M.MADHUYADAV261@YBL-KK BK0007463-784136438535-PAYMENT FROM PHON E,0000784136438535,0.0,20000.0,5772.27
05/11/24,UPI,UPI-M ARVIND MIYA-8074523914@YBL-LAVB0 000572-929666703090-PAYMENT FROM PHONE,0000849713040565,0.0,1.0,5771.27
05/11/24,UPI,UPI-ANGEL LTD NSE-ANGELONENSE@HDFCBANK-H DFC0000001-467670202519-PAYINGANGELONE,0000467670202519,0.0,3000.0,2771.27
05/11/24,,ANGEL ONE LIMI-218905845,0000411050410332,195.76,0.0,2967.03
05/11/24,UPI,UPI-M ANIL YADAV-9966254742@YBL-ANDB0000 321-599901056187-PAYMENT FROM PHONE,0000599901056187,0.0,1000.0,1967.03
05/11/24,UPI,UPI-MADHURI MARAM-LIPIKAMARAM@OKICICI-IC IC0000008-431015812130-UPI,0000431015812130,3825.0,0.0,5792.03
05/11/24,UPI,UPI-B SHIRISHA-SIRISHA0413@YBL-UBIN08007 67-770995297289-PAYMENT FROM PHONE,0000770995297289,2100.0,0.0,7892.03
05/11/24,UPI,UPI-PARAS TECHNOLOGIES-Q417014413@YBL-YE SB0YBLUPI-431041428378-UPI,0000431041428378,0.0,830.0,7062.03
05/11/24,UPI,UPI-KISHOR SINGH-RPKISHOR780@OKAXIS-KKB K0007478-431012212431-UPI,0000431012212431,1000.0,0.0,8062.03
05/11/24,UPI,UPI-RIYAZ AHMED UDDIN-RIYAZAHMEDUDDIN@YB L-HDFC0001997-989943710806-PAYMENT FROM PHONE,0000989943710806,580.0,0.0,8642.03
05/11/24,UPI,UPI-NAGRAJ-MUKKERLANAGRAJ@OKHDFCBANK-UBI N0803219-431000368590-UPI,0000431000368590,2480.0,0.0,11122.03
05/11/24,UPI,UPI-M MADHU YADAV-M.MADHUYADAV261@YBL-KK BK0007463-477332400790-PAYMENT FROM PHON E,0000477332400790,2000.0,0.0,13122.03
05/11/24,,IB BILLPAY DR-HDFC92-434155XXXXXX1025,MB05201534225T46,0.0,12077.0,1045.03
05/11/24,UPI,UPI-EPPALAPALLY SHIVAKUM-SHIVAKUMAR.EPPA,0000431066825254,4250.0,0.0,5295.03
05/11/24,UPI,UPI-K MADHUSUDHAN REDDY-MADHU816@AXL-KKB K0007463-974104533575-PAYMENT FROM PHONE,0000974104533575,1240.0,0.0,6535.03
06/11/24,POS,CASH DEPOSIT-XXXXXXXXXX1847-HIMAYATNAGAR,0000000000000282,5500.0,0.0,12035.03
06/11/24,UPI,UPI-M ARVIND RAJ-ARVINDRAJ57964-1@OKHDFC BANK-HDFC0000512-431110919075-UPI,0000431110919075,1015.0,0.0,13050.03
06/11/24,UPI,UPI-M ARVIND RAJ-ARVINDRAJ57964-1@OKHDFC BANK-HDFC0000512-431110973152-UPI,0000431110973152,35.0,0.0,13085.03
06/11/24,UPI,UPI-ANGEL LTD NSE-ANGELONENSE@HDFCBANK-H DFC0000001-467718655020-PAYINGANGELONE,0000467718655020,0.0,2000.0,11085.03
06/11/24,UPI,UPI-AVULA DEEPIKA-9390042802-2@YBL-UTIB0 005151-146629594658-PAYMENT FROM PHONE,0000146629594658,1000.0,0.0,12085.03
06/11/24,UPI,UPI-KOPPARTHI RAJESH-KOPPARTHIRAJESH991@ IBL-ICIC0001313-386084486914-PAYMENT FRO M PHONE,0000386084486914,440.0,0.0,12525.03
06/11/24,UPI,UPI-SUHAS MADHUKAR CHAUD-DRSUHAS2003@OKH DFCBANK-KKBK0001367-431140988914-UPI,0000431140988914,1260.0,0.0,13785.03
06/11/24,UPI,UPI-NAGRAJ-MUKKERLANAGRAJ@OKHDFCBANK-UBI N0803219-431151195951-UPI,0000431151195951,0.0,300.0,13485.03
06/11/24,UPI,UPI-JAI DEV KUMAR JAI DE-GUBBAJAIDEV42@O KSBI-SBIN0005895-467726092515-UPI,0000467726092515,0.0,1008.0,12477.03
06/11/24,UPI,UPI-M ANIL YADAV-9966254742@YBL-ANDB0000 321-515998235792-PAYMENT FROM PHONE,0000515998235792,0.0,1000.0,11477.03
06/11/24,UPI,UPI-M ANIL YADAV-ANILYADAV63473-1@OKHDFC BANK-UBIN0803219-431148335011-UPI,0000431148335011,5700.0,0.0,17177.03
07/11/24,UPI,UPI-NARLA SRIKANTH YADA-Q470718822@YBL- YESB0YBLUPI-467886913229-UPI,0000467886913229,0.0,70.0,17107.03
07/11/24,UPI,UPI-ANGEL LTD NSE-ANGELONENSE@HDFCBANK-H DFC0000001-431267501929-PAYINGANGELONE,0000431267501929,0.0,12000.0,5107.03
07/11/24,IMPS,IMPS-431227095929-SHADVAL PAY PRIVATE LI MITED-RATN-XXXXXXXX1978-BILL,0000431227095929,29400.0,0.0,34507.03
07/11/24,UPI,UPI-RAPARTI SRIHARI-9493207195@YBL-BKID0 008627-000218342414-PAYMENT FROM PHONE,0000000218342414,0.0,2000.0,32507.03
07/11/24,UPI,UPI-M ANIL YADAV-ANILYADAV63473-1@OKHDFC BANK-UBIN0803219-467800712922-UPI,0000467800712922,0.0,2000.0,30507.03
07/11/24,UPI,UPI-LIBERTYSRIHARIOKICIC-LIBERTYSRIHARI@ OKICICI-BKID0008627-431253523968-UPI,0000431253523968,0.0,650.0,29857.03
07/11/24,UPI,UPI-MOHIT SETHIA-MOHITSJ.1995@OKICICI- KKBK0007452-467866420122-UPI,0000467866420122,1100.0,0.0,30957.03
07/11/24,UPI,UPI-MOHD AHMED ALI-AQUA.AHMED98@YBL-UTIB 0001808-295619562376-PAYMENT FROM PHONE,0000295619562376,540.0,0.0,31497.03
07/11/24,UPI,UPI-NAYAKOTI SHEKAR-MAHESH.SHEKER09-1@OK AXIS-TSAB0000103-467846335831-UPI,0000467846335831,0.0,500.0,30997.03
07/11/24,UPI,UPI-M ANIL YADAV-9966254742@YBL-ANDB0000 321-374123495947-PAYMENT FROM PHONE,0000374123495947,0.0,1000.0,29997.03
07/11/24,UPI,UPI-TRUE CREDITS PVT LTD-TRUECREDITS.PAY U@ICICI-ICIC0DC0099-431224645164-UPIINTE NT,0000431224645164,0.0,4736.0,25261.03
07/11/24,UPI,UPI-MUKKERLA GEETA,0000859328638089,0.0,15000.0,10261.03
07/11/24,UPI,UPI-MUKKERLA GEETA SUDHA-6302856696@YBL- KKBK0007463-883962792467-PAYMENT FROM PH ONE,0000883962792467,1200.0,0.0,11461.03
08/11/24,UPI,UPI-MAHENDAR KUMAR BAHET-MAHENDAR.BAHETI @OKICICI-ICIC0000040-467915854277-FROM M AHENDAR,0000467915854277,25000.0,0.0,36461.03
08/11/24,UPI,UPI-M ANIL YADAV-ANILYADAV63473-1@OKSBI- UBIN0803219-467951162633-UPI,0000467951162633,0.0,6000.0,30461.03
08/11/24,,ACH D- HERO FINCORP LTD-62405711,0000000915657197,0.0,10855.0,19606.03
08/11/24,UPI,UPI-LIBERTYSRIHARIOKICIC-LIBERTYSRIHARI@ OKICICI-BKID0008627-431391476377-UPI,0000431391476377,0.0,650.0,18956.03
08/11/24,UPI,UPI-BHARATHI BHARATHI-BHARTHI9573@YBL-S BIN0020701-467984375572-UPI,0000467984375572,0.0,6000.0,12956.03
08/11/24,UPI,UPI-M ANIL YADAV-9966254742@YBL-ANDB0000 321-056733471619-PAYMENT FROM PHONE,0000056733471619,0.0,1000.0,11956.03
08/11/24,UPI,UPI-JAI DEV KUMAR JAI DE-GUBBAJAIDEV42@O KSBI-SBIN0005895-431340379211-UPI,0000431340379211,0.0,952.0,11004.03
08/11/24,UPI,UPI-ANAND RAO IOCL PRANE-Q553962178@YBL- YESB0YBLUPI-467935374347-UPI,0000467935374347,0.0,350.0,10654.03
08/11/24,UPI,UPI-PANYAM MANJULA-MANJUPANYAM@OKSBI-SB IN0007641-431306584638-MILK,0000431306584638,1500.0,0.0,12154.03
08/11/24,UPI,UPI-KOLLAPURAM,0000467940091763,0.0,40.0,12114.03
09/11/24,UPI,UPI-SITHALA SATHIBABU-Q855384536@YBL-YE SB0YBLUPI-468090409959-UPI,0000468090409959,0.0,50.0,12064.03
09/11/24,UPI,UPI-SYEDA NASREEN SULTAN-AFREENSYEDA-1@O KICICI-ICIC0003867-468004821177-UPI,0000468004821177,2610.0,0.0,14674.03
09/11/24,UPI,UPI-NARLA SRIKANTH YADA-Q470718822@YBL- YESB0YBLUPI-468098606058-UPI,0000468098606058,0.0,70.0,14604.03
09/11/24,UPI,UPI-MURALIKRISHNA VEGETA-GPAY-1124438713 1@OKBIZAXIS-UTIB0000553-468039292637-UPI,0000468039292637,0.0,270.0,14334.03
09/11/24,UPI,UPI-PHONEPE-BBPSBP@YBL-YESB0YBLUPI-22916 5314650-PAYMENT FROM PHONE,0000229165314650,0.0,855.0,13479.03
09/11/24,POS,CASH DEPOSIT-416021XXXXXX2657-BARKATPURA,0000000000008190,10500.0,0.0,23979.03
09/11/24,UPI,UPI-RAPARTI SRIHARI-9493207195@YBL-BKID0 008627-690760234665-PAYMENT FROM PHONE,0000690760234665,0.0,13000.0,10979.03
09/11/24,UPI,UPI-M ANIL YADAV-9966254742@YBL-ANDB0000 321-944075051022-PAYMENT FROM PHONE,0000944075051022,0.0,1000.0,9979.03
09/11/24,UPI,UPI-LIBERTYSRIHARIOKICIC-LIBERTYSRIHARI@ OKICICI-BKID0008627-468037018694-UPI,0000468037018694,0.0,650.0,9329.03
09/11/24,UPI,UPI-JUPELLI CHIRANJEEVI-Q107277129@YBL- YESB0YBLUPI-431405228244-UPI,0000431405228244,0.0,110.0,9219.03
09/11/24,UPI,UPI-SOMALWAR SHRINIVAS-SOMALWAR73@OKSBI -SBIN0010356-431438926349-UPI,0000431438926349,1320.0,0.0,10539.03
09/11/24,UPI,UPI-SHUBHAM TIWARI-SHUBHAMTIWARI074@OKS BI-SBIN0000468-431440499293-UPI,0000431440499293,870.0,0.0,11409.03
09/11/24,UPI,UPI-MUKKERLA GEETA SUDHA-GEETHAMUKKERLA- 1@OKAXIS-KKBK0007463-546646098113-UPI,0000431409036380,0.0,5200.0,6209.03
09/11/24,UPI,UPI-ABSIPURAM PRASOONA-9948434877@YBL-S BIN0020083-737934333020-PAYMENT FROM PHO NE,0000737934333020,1500.0,0.0,7709.03
09/11/24,UPI,UPI-B RAYUDU-RAYUDU10-1@OKHDFCBANK-HDFC0 000042-431474428913-MILK AMT,0000431474428913,1085.0,0.0,8794.03
09/11/24,UPI,UPI-MOHD AHMED ALI-AQUA.AHMED98@AXL-UTIB 0001808-386566970601-PAYMENT FROM PHONE,0000386566970601,180.0,0.0,8974.03
09/11/24,UPI,UPI-NAYAKOTI SHEKAR-MAHESH.SHEKER09-1@OK AXIS-TSAB0000103-468098238530-UPI,0000468098238530,0.0,1000.0,7974.03
09/11/24,UPI,UPI-GANTA SUJATHA-SUJATHAGANAT13@OKAXIS -SBIN0005895-431495234217-UPI,0000431495234217,0.0,1.0,7973.03
09/11/24,UPI,UPI-GANTA SUJATHA-SUJATHAGANAT13@OKAXIS -SBIN0005895-468043577664-UPI,0000468043577664,50000.0,0.0,57973.03
09/11/24,UPI,UPI-GANTA SUJATHA-SUJATHAGANAT13@OKAXIS -SBIN0005895-431482385301-UPI,0000431482385301,4000.0,0.0,61973.03
09/11/24,UPI,UPI-JIO RECHARGE-JIOINAPPDIRECT1@YBL-YES B0YBLUPI-426790637331-PAYMENT FROM PHONE,0000426790637331,0.0,19.0,61954.03
09/11/24,UPI,UPI-M MADHU YADAV-9985065404-2@YBL-SBIN 0006645-015928170150-PAYMENT FROM PHONE,0000015928170150,0.0,2000.0,59954.03
10/11/24,UPI,UPI-UDUPI AAHARS WOOD S-Q142876691@YBL-Y ESB0YBLUPI-431532670248-UPI,0000431532670248,0.0,80.0,59874.03
10/11/24,UPI,UPI-BHARATHI BHARATHI-BHARTHI9573@YBL-S BIN0020701-431587365034-UPI,0000431587365034,0.0,6000.0,53874.03
10/11/24,UPI,UPI-LIBERTYSRIHARIOKICIC-LIBERTYSRIHARI@ OKICICI-BKID0008627-468127565280-UPI,0000468127565280,0.0,650.0,53224.03
10/11/24,UPI,UPI-JAI DEV KUMAR JAI DE-GUBBAJAIDEV42@O KSBI-SBIN0005895-431512653404-UPI,0000431512653404,0.0,336.0,52888.03
10/11/24,,ATW-416021XXXXXX2657-P3ENTS55-HYDERABAD,0000000000005728,0.0,1000.0,51888.03
10/11/24,UPI,UPI-SRI BALAJI BAKERY-PAYTMQR5C8BEV@PTYS -YESB0PTMUPI-468114100995-UPI,0000468114100995,0.0,48.0,51840.03
10/11/24,UPI,UPI-NAGRAJ-MUKKERLANAGRAJ@OKHDFCBANK-UBI N0803219-431547208724-UPI,0000431547208724,0.0,1000.0,50840.03
10/11/24,UPI,UPI-M ANIL YADAV-9966254742@YBL-ANDB0000 321-546135054283-PAYMENT FROM PHONE,0000546135054283,0.0,1000.0,49840.03
11/11/24,,NWD-416021XXXXXX2657-07641623-HIMAYATHNA GAR,0000431604024675,0.0,1000.0,48840.03
11/11/24,UPI,UPI-AZAAD KHAN-9949271078@YBL-SBIN00200 83-201714648404-PAYMENT FROM PHONE,0000201714648404,52524.0,0.0,101364.03
11/11/24,UPI,UPI-ANGEL LTD NSE-ANGELONENSE@HDFCBANK-H DFC0000001-468257426659-PAYINGANGELONE,0000468257426659,0.0,30000.0,71364.03
11/11/24,UPI,UPI-ANGEL LTD NSE-ANGELONENSE@HDFCBANK-H DFC0000001-468255331716-PAYINGANGELONE,0000468255331716,0.0,2500.0,68864.03
11/11/24,UPI,UPI-ZOMATO-PAYZOMATO@HDFCBANK-HDFC000049 9-965284825608-PAYMENT FROM PHONE,0000965284825608,0.0,391.05,68472.98
11/11/24,UPI,UPI-SYED HAMED-HAMEDSYED10@YBL-SBIN0020 083-673776506365-PAYMENT FROM PHONE,0000673776506365,9000.0,0.0,77472.98
11/11/24,UPI,UPI-JIO,0000234022743193,0.0,302.0,77170.98
11/11/24,UPI,UPI-BOIRI KRISHNA RAO-BOIRIKRISHNARAO@NA VIAXIS-HDFC0005879-431600860179-PAID VIA NAVI,0000431600860179,14445.0,0.0,91615.98
11/11/24,UPI,REV-UPI-50100123131847-9985065404@YBL-21 2483380053-PAYMENT FROM PHONEPE,0000212483380053,1500.0,0.0,93115.98
11/11/24,UPI,UPI-GUBBA JAI DEV KUMAR-8919352964@PTSBI -KKBK0007473-212483380053-PAYMENT FROM P HONE,0000212483380053,0.0,1500.0,91615.98
11/11/24,UPI,UPI-JAI DEV KUMAR JAI DE-9949906165@YBL- SBIN0005895-972842630275-PAYMENT FROM PH ONE,0000972842630275,0.0,1500.0,90115.98
11/11/24,UPI,UPI-MOHD AHMED ALI-AQUA.AHMED98@AXL-UTIB 0001808-623064477355-PAYMENT FROM PHONE,0000623064477355,180.0,0.0,90295.98
11/11/24,UPI,UPI-LIBERTYSRIHARIOKICIC-LIBERTYSRIHARI@ OKICICI-BKID0008627-468266057939-UPI,0000468266057939,0.0,650.0,89645.98
11/11/24,UPI,UPI-M ANIL YADAV-9966254742@YBL-ANDB0000 321-256101734650-PAYMENT FROM PHONE,0000256101734650,0.0,1000.0,88645.98
11/11/24,UPI,UPI-ANGEL LTD NSE-ANGELONENSE@HDFCBANK-H DFC0000001-431624751680-PAYINGANGELONE,0000431624751680,0.0,40000.0,48645.98
12/11/24,UPI,UPI-JURRU RAHUL YADAV-Q758292524@YBL-YE SB0YBLUPI-431713070132-UPI,0000431713070132,0.0,80.0,48565.98
12/11/24,UPI,UPI-NARLA SRIKANTH YADA-Q470718822@YBL- YESB0YBLUPI-468393374201-UPI,0000468393374201,0.0,70.0,48495.98
12/11/24,UPI,UPI-PAKANATI NITISH-NITISHPAKANATI125@OK,0000431711575173,0.0,3000.0,45495.98
12/11/24,UPI,UPI-K RADHIKA-KUKUTLARADHIKA@YBL-PUNB099 6000-818168633183-PAYMENT FROM PHONE,0000818168633183,0.0,40000.0,5495.98
12/11/24,UPI,UPI-LIBERTYSRIHARIOKICIC-LIBERTYSRIHARI@ OKICICI-BKID0008627-468312677290-UPI,0000468312677290,0.0,650.0,4845.98
12/11/24,UPI,UPI-V S NAARAYANA-PPR.00848.21042023.00 011302@CNRB-CNRB0000848-431719690397-PAY TO MERCHANT,0000431719690397,0.0,251.0,4594.98
12/11/24,UPI,UPI-SWISSCASTLEBAKERY NA-VYAPAR.17198633 3553@HDFCBANK-HDFC0000001-468383411514-U PI,0000468383411514,0.0,292.0,4302.98
12/11/24,NEFT,NEFT CR-ICIC0099999-ANGEL ONE LIMITED CL IENT AC-MUKKERLA MADHU YADAV-CMS46466604,000CMS4646660404,10000.0,0.0,14302.98
12/11/24,UPI,UPI-M ANIL YADAV-9966254742@YBL-ANDB0000 321-308726526481-PAYMENT FROM PHONE,0000308726526481,0.0,1000.0,13302.98
13/11/24,UPI,UPI-JAI DEV KUMAR JAI DE-9949906165@YBL- SBIN0005895-644631617768-PAYMENT FROM PH ONE,0000644631617768,0.0,520.0,12782.98
13/11/24,,NET PAYIN TO NSE MF A/C -57500001396612- UCC -4114733-443180004023-5750000139661,0000000581797460,0.0,1000.0,11782.98
13/11/24,,NET PAYIN TO NSE MF A/C -57500001396612- UCC -4114733-443180004025-5750000139661,0000000581797699,0.0,1000.0,10782.98
13/11/24,,NET PAYIN TO NSE MF A/C -57500001396612- UCC -4114733-443180004024-5750000139661,0000000581798229,0.0,1000.0,9782.98
13/11/24,UPI,UPI-LIBERTYSRIHARIOKICIC-LIBERTYSRIHARI@,0000468454427088,0.0,650.0,9132.98
13/11/24,UPI,UPI-JAI DEV KUMAR JAI DE-GUBBAJAIDEV42@O KSBI-SBIN0005895-431820123999-UPI,0000431820123999,0.0,672.0,8460.98
13/11/24,UPI,UPI-NUTAN MEDICAL HALL-7337557229@OKBIZA XIS-UTIB0000553-431871737082-UPI,0000431871737082,0.0,92.0,8368.98
13/11/24,UPI,UPI-SANTOSH KUMAR YADAV-Q548583816@YBL-Y ESB0YBLUPI-468421239051-UPI,0000468421239051,0.0,70.0,8298.98
13/11/24,UPI,UPI-MOHD ABDUL RAHEEM-ABDULRAHEEMM818@OK HDFCBANK-KKBK0007474-431819429295-UPI,0000431819429295,0.0,500.0,7798.98
13/11/24,UPI,UPI-M K A PARVEZ HUSSAI-MOHAMMEDPARVEZ1 0@YBL-SBIN0020061-468430649879-UPI,0000468430649879,0.0,250.0,7548.98
13/11/24,NEFT,NEFT CR-ICIC0099999-ANGEL ONE LIMITED CL IENT AC-MUKKERLA MADHU YADAV-CMS46490968,000CMS4649096894,20000.0,0.0,27548.98
13/11/24,UPI,UPI-M ANIL YADAV-9966254742@YBL-ANDB0000 321-389504328014-PAYMENT FROM PHONE,0000389504328014,0.0,1000.0,26548.98
14/11/24,UPI,UPI-SITHALA SATHIBABU-Q855384536@YBL-YE SB0YBLUPI-431985674311-UPI,0000431985674311,0.0,80.0,26468.98
14/11/24,,ATW-416021XXXXXX2657-P3ENTS55-HYDERABAD,0000000000006410,0.0,10000.0,16468.98
14/11/24,UPI,UPI-ANGEL LTD NSE-ANGELONENSE@HDFCBANK-H DFC0000001-431968866959-PAYINGANGELONE,0000431968866959,0.0,2400.0,14068.98
14/11/24,UPI,UPI-MSNEXUS RESEARCH-EAZYPAY.2000060736@ ICICI-ICIC0DC0099-156437034770-PAYMENT F ROM PHONE NB0159700-579095251959-PAYMENT FROM PHON E,0000156437034770,0.0,4000.0,10068.98
14/11/24,UPI,UPI-KBMAHESH-Q245671051@YBL-YESB0YBLUPI- 431931477453-UPI,0000431931477453,0.0,200.0,9868.98
14/11/24,UPI,UPI-GSN LIQUOR MART-Q723336071@YBL-YESB0 YBLUPI-468528886347-UPI,0000468528886347,0.0,210.0,9658.98
14/11/24,UPI,UPI-SRI ANEE COMMUNICATI-BAJAJPAY.687972 9.ET8LM3GS@INDUS-INDB0MERCHA-46858557894 3-UPI,0000468585578943,0.0,250.0,9408.98
14/11/24,UPI,UPI-MEHRAN KHAN-BHARATPE90723881822@YES BANKLTD-YESB0YESUPI-431950691083-PAY TO BHARATPE ME,0000431950691083,0.0,42.0,9366.98
14/11/24,UPI,UPI-NAYAKOTI SHEKAR-MAHESH.SHEKER09-1@OK AXIS-TSAB0000103-468578505103-UPI,0000468578505103,0.0,1500.0,7866.98
14/11/24,UPI,UPI-LIBERTYSRIHARIOKICIC-LIBERTYSRIHARI@ OKICICI-BKID0008627-431977814124-UPI,0000431977814124,0.0,650.0,7216.98
14/11/24,UPI,UPI-KOLLAPURAM MALLIKARJ-MALLIKARJUNKOLA PURAM@OKSBI-HDFC0000218-431930807825-UPI,0000431930807825,0.0,250.0,6966.98
14/11/24,NEFT,NEFT CR-ICIC0099999-ANGEL ONE LIMITED CL IENT AC-MUKKERLA MADHU YADAV-CMS46519594,000CMS4651959459,30000.0,0.0,36966.98
14/11/24,UPI,UPI-M ANIL YADAV-9966254742@YBL-ANDB0000 321-512441766731-PAYMENT FROM PHONE,0000512441766731,0.0,1000.0,35966.98
14/11/24,UPI,UPI-M ANIL YADAV-ANILYADAV63473-1@OKSBI- UBIN0803219-468513517811-UPI,0000468513517811,0.0,2500.0,33466.98
14/11/24,UPI,UPI-M ANIL YADAV-ANILYADAV63473-1@OKSBI- UBIN0803219-431978611066-UPI RECHARGE-JIOINAPPDIRECT@YBL-YESB 0YBLUPI-687318832892-PAYMENT FROM PHONE,0000431978611066,0.0,7500.0,25966.98
15/11/24,,ACH D- LIC OF INDIA-6577926591124,0000008086362320,0.0,2488.0,23478.98
15/11/24,UPI,UPI-M ARVIND-ARVINDYADAV69552@OKAXIS-K KBK0007473-468645320857-UPI,0000468645320857,0.0,300.0,23178.98
15/11/24,UPI,UPI-LIBERTYSRIHARIOKICIC-LIBERTYSRIHARI@ OKICICI-BKID0008627-432047961095-UPI,0000432047961095,0.0,650.0,22528.98
15/11/24,UPI,UPI-JAI DEV KUMAR JAI DE-GUBBAJAIDEV42@O KSBI-SBIN0005895-432000757910-UPI,0000432000757910,0.0,332.0,22196.98
15/11/24,UPI,REV-UPI-50100123131847-M.MADHUYADAV26-3@ OKICICI-432000757910-UPI,0000432000757910,332.0,0.0,22528.98
15/11/24,UPI,UPI-M ANIL YADAV-9966254742@YBL-ANDB0000 321-444605475696-PAYMENT FROM PHONE,0000444605475696,0.0,1000.0,21528.98
15/11/24,UPI,UPI-MOHD AHMED ALI-AQUA.AHMED98@AXL-UTIB 0001808-455198833621-PAYMENT FROM PHONE,0000455198833621,360.0,0.0,21888.98
16/11/24,UPI,UPI-JURRU RAHUL YADAV-Q758292524@YBL-YE SB0YBLUPI-432128879091-UPI,0000432128879091,0.0,240.0,21648.98
16/11/24,UPI,UPI-B RAJESHWARI-RAJESHWARIYADAV147@OKSB I-SBIN0RRDCGB-432166532374-UPI,0000432166532374,35000.0,0.0,56648.98
16/11/24,UPI,UPI-G PRASHANTH-7702920675@AXL-UTIB00008 81-481654437191-PAYMENT FROM PHONE,0000481654437191,20000.0,0.0,76648.98
16/11/24,UPI,UPI-BASHEER UDDIN KHAN-BASHEERUDDINKHAN@ OKSBI-IBKL0000594-468726584514-UPI,0000468726584514,0.0,40000.0,36648.98
16/11/24,UPI,UPI-MR RAPATHI NARSING -Q084776718@YBL- YESB0YBLUPI-432164771752-UPI,0000432164771752,0.0,120.0,36528.98
16/11/24,UPI,UPI-MOHD AHMED ALI-AQUA.AHMED98@YBL-UTIB 0001808-667199405741-PAYMENT FROM PHONE,0000667199405741,0.0,5000.0,31528.98
16/11/24,UPI,UPI-SANTHOSHA ARRA-SANTHU.SANTHOSHA2004 -1@OKAXIS-KKBK0007487-432169578619-UPI,0000432169578619,0.0,20000.0,11528.98
16/11/24,UPI,UPI-SANTHOSHA ARRA-ARRASANTHOSHA@YBL-KK BK0007487-854923782582-PAYMENT FROM PHON E,0000854923782582,19534.0,0.0,31062.98
16/11/24,UPI,UPI-LIFE STYLE INTERNATI-LANDMARKMAXRETA IL@YBL-YESB0YBLUPI-432148991080-PAYMENT FOR 501539,0000432148991080,0.0,1807.0,29255.98
16/11/24,UPI,UPI-AIRTEL RECHARGE-AIRTELPREDIRECT1@YBL -YESB0YBLUPI-369605766289-PAYMENT FROM P HONE,0000369605766289,0.0,512.0,28743.98
17/11/24,UPI,UPI-LIBERTYSRIHARIOKICIC-LIBERTYSRIHARI@ OKICICI-BKID0008627-432296231060-UPI,0000432296231060,0.0,1300.0,27443.98
17/11/24,UPI,UPI-M ANIL YADAV-ANILYADAV63473-1@OKSBI- UBIN0803219-432264718697-UPI,0000432264718697,0.0,13000.0,14443.98
17/11/24,UPI,UPI-SANTOSH KUMAR YADAV-Q548583816@YBL-Y ESB0YBLUPI-468807122719-UPI,0000468807122719,0.0,60.0,14383.98
17/11/24,UPI,UPI-SANTOSH KUMAR YADAV-Q548583816@YBL-Y ESB0YBLUPI-432291628233-UPI,0000432291628233,0.0,60.0,14323.98
17/11/24,UPI,UPI-MURALIKRISHNA VEGETA-GPAY-1124438713 1@OKBIZAXIS-UTIB0000553-432237528499-UPI,0000432237528499,0.0,310.0,14013.98
17/11/24,UPI,UPI-SANJAY UIKEY-7997088152@IBL-SBIN000 6962-432259057819-UPI,0000432259057819,0.0,5000.0,9013.98
17/11/24,UPI,UPI-MAHENDRA YADAV-KKBK-XXX XXX7813-CASH,0000468857901588,35000.0,0.0,44013.98
17/11/24,UPI,UPI-SOMALWAR SHRINIVAS-SOMALWAR73@OKSBI -SBIN0010356-468868460940-UPI,0000468868460940,0.0,10000.0,34013.98
17/11/24,UPI,UPI-MOHD AHMED ALI-AQUA.AHMED98@YBL-UTIB 0001808-324030435537-PAYMENT FROM PHONE,0000324030435537,180.0,0.0,34193.98
17/11/24,UPI,UPI-M ANIL YADAV-9966254742@YBL-ANDB0000 321-636037036344-PAYMENT FROM PHONE,0000636037036344,0.0,2000.0,32193.98
18/11/24,UPI,UPI-ANGEL LTD NSE-ANGELONENSE@HDFCBANK-H DFC0000001-468977368997-PAYINGANGELONE,0000468977368997,0.0,20000.0,12193.98
18/11/24,UPI,UPI-JURRU RAHUL YADAV-Q758292524@YBL-YE SB0YBLUPI-468993974088-UPI,0000468993974088,0.0,160.0,12033.98
18/11/24,UPI,UPI-ANGEL LTD NSE-ANGELONENSE@HDFCBANK-H DFC0000001-468975374102-PAYINGANGELONE,0000468975374102,0.0,5000.0,7033.98
18/11/24,UPI,UPI-GADIGE BHASKARU-Q136697930@YBL-YESB 0YBLUPI-432355189875-UPI,0000432355189875,0.0,40.0,6993.98
18/11/24,POS,CASH DEPOSIT-416021XXXXXX2657-BARKATPURA,0000000000000358,8000.0,0.0,14993.98
18/11/24,UPI,UPI-G MEENA-9959041883@YBL-ANDB0001425-6 93545200793-PAYMENT FROM PHONE,0000693545200793,10350.0,0.0,25343.98
18/11/24,UPI,UPI-BHARATHI BHARATHI-BHARTHI9573@YBL-S BIN0020701-432363895182-UPI,0000432363895182,0.0,6000.0,19343.98
18/11/24,UPI,UPI-JAI DEV KUMAR JAI DE-GUBBAJAIDEV42@O KSBI-SBIN0005895-468939792485-UPI,0000468939792485,0.0,448.0,18895.98
18/11/24,UPI,UPI-LIBERTYSRIHARIOKICIC-LIBERTYSRIHARI@ OKICICI-BKID0008627-432352993165-UPI,0000432352993165,0.0,650.0,18245.98
18/11/24,IMPS,IMPS-432315363468-SRIDEVI JT1-ICIC-XXXXX XXX3198-CASH,0000432315363468,0.0,14000.0,4245.98
18/11/24,UPI,UPI-SRIRAGHAVENDRATIFFIN-PAYTMQR17U07CIZ 21@PAYTM-YESB0PTMUPI-432313603507-UPI,0000432313603507,0.0,10.0,4235.98
18/11/24,UPI,UPI-SAMARJIT DAS-8016265252@AXL-SBIN004 0462-853898839355-PAYMENT FROM PHONE,0000853898839355,9767.0,0.0,14002.98
18/11/24,UPI,UPI-SREELA TEXTILES-BHARATPE90726798412@ YESBANKLTD-YESB0YESUPI-432377707194-PAY TO BHARATPE ME,0000432377707194,0.0,2300.0,11702.98
18/11/24,UPI,UPI-SAMBA SARITHA-8555955685@AXL-KKBK00 07463-334322242879-PAYMENT FROM PHONE,0000334322242879,39068.0,0.0,50770.98
18/11/24,UPI,UPI-NAYAKOTI SHEKAR-MAHESH.SHEKER09-1@OK AXIS-TSAB0000103-468965508716-UPI,0000468965508716,0.0,4000.0,46770.98
18/11/24,UPI,UPI-RAGHUNATH SRIDHAR-Q366667576@YBL-YE SB0YBLUPI-468902615106-UPI,0000468902615106,0.0,175.0,46595.98
18/11/24,UPI,UPI-M ARVIND-ARVINDYADAV69552@OKAXIS-K KBK0007473-468935912440-UPI,0000468935912440,0.0,500.0,46095.98
18/11/24,NEFT,NEFT CR-ICIC0099999-ANGEL ONE LIMITED CL IENT AC-MUKKERLA MADHU YADAV-CMS46589291,000CMS4658929129,20000.0,0.0,66095.98
18/11/24,UPI,UPI-M ANIL YADAV-9966254742@YBL-ANDB0000 321-599377699108-PAYMENT FROM PHONE,0000599377699108,0.0,1000.0,65095.98
18/11/24,UPI,UPI-MUKKERLA GEETA SUDHA-6302856696@YBL- KKBK0007463-124292093585-PAYMENT FROM PH ONE YESB0YBLUPI-510954803218-UPI,0000124292093585,0.0,2500.0,62595.98
18/11/24,UPI,UPI-MUKKERLA GEETA SUDHA-6302856696@YBL- KKBK0007463-928213389270-PAYMENT FROM PH ONE,0000928213389270,0.0,20000.0,42595.98
19/11/24,UPI,UPI-JURRU RAHUL YADAV-Q758292524@YBL-YE SB0YBLUPI-432496130090-UPI,0000432496130090,0.0,80.0,42515.98
19/11/24,UPI,UPI-SANTOSH KUMAR YADAV-Q548583816@YBL-Y ESB0YBLUPI-432436135189-UPI,0000432436135189,0.0,70.0,42445.98
19/11/24,UPI,UPI-ADLA SAI YADAV-Q255839147@YBL-YESB0Y BLUPI-432454827833-UPI,0000432454827833,0.0,90.0,42355.98
19/11/24,UPI,UPI-SRI BALAJI BAKERY-PAYTMQR5C8BEV@PTYS -YESB0PTMUPI-469003818423-UPI,0000469003818423,0.0,48.0,42307.98
19/11/24,UPI,UPI-ANGEL LTD NSE-ANGELONENSE@HDFCBANK-H DFC0000001-432462722272-PAYINGANGELONE,0000432462722272,0.0,8000.0,34307.98
19/11/24,UPI,UPI-MSNEXUS RESEARCH-EAZYPAY.2000060736@ ICICI-ICIC0DC0099-469045119821-UPI,0000469045119821,0.0,5000.0,29307.98
19/11/24,UPI,UPI-RAPARTI SRIHARI-9493207195@YBL-BKID0 008627-320865033786-PAYMENT FROM PHONE,0000320865033786,0.0,13000.0,16307.98
19/11/24,UPI,UPI-SANTOSH KUMAR YADAV-Q548583816@YBL-Y ESB0YBLUPI-469083536974-UPI,0000469083536974,0.0,70.0,16237.98
19/11/24,UPI,UPI-NAGRAJ-MUKKERLANAGRAJ@OKHDFCBANK-UBI N0803219-469010527826-UPI,0000469010527826,0.0,10000.0,6237.98
19/11/24,UPI,UPI-G RAVINDER REDDY-SAFETYPACKAGING69@O KHDFCBANK-KKBK0007473-432451154505-UPI,0000432451154505,0.0,30.0,6207.98
19/11/24,UPI,UPI-MASQATI SUPER MARKET-PINELABS.100554 12@MAIRTEL-AIRP0000001-469060754098-GENE RATING DYNAMIC,0000469060754098,0.0,275.0,5932.98
19/11/24,UPI,UPI-LIBERTYSRIHARIOKICIC-LIBERTYSRIHARI@ OKICICI-BKID0008627-432487046022-UPI,0000432487046022,0.0,650.0,5282.98
19/11/24,UPI,UPI-SURAGONI SRINIVASULU-Q873226236@YBL- YESB0YBLUPI-432414436091-UPI,0000432414436091,0.0,140.0,5142.98
19/11/24,UPI,UPI-SWISSCASTLEBAKERY NA-VYAPAR.17198633 3553@HDFCBANK-HDFC0000001-469062959012-U PI,0000469062959012,0.0,232.0,4910.98
19/11/24,UPI,UPI-DRESS LAND-DRESSLAND.63070916@HDFCBA NK-HDFC0000001-432493064200-UPI,0000432493064200,0.0,300.0,4610.98
19/11/24,NEFT,NEFT CR-ICIC0099999-ANGEL ONE LIMITED CL IENT AC-MUKKERLA MADHU YADAV-CMS46614748,000CMS4661474871,20000.0,0.0,24610.98
20/11/24,UPI,UPI-SHIVARAJ MAHADEVAPPA-9494271546@AXL- SBIN0020192-116710782749-PAYMENT FROM PH ONE,0000116710782749,495.0,0.0,25105.98
20/11/24,UPI,UPI-M ARVIND RAJ-ARVINDRAJ57964-1@OKHDFC BANK-HDFC0000512-432553638103-UPI,0000432553638103,600.0,0.0,25705.98
20/11/24,UPI,UPI-PATTHI RUSHI VARDHAN-BHARATPE9072529 8734@YESBANKLTD-YESB0YESUPI-432560985861 -PAY TO PATTHI RUSH,0000432560985861,0.0,60.0,25645.98
20/11/24,UPI,UPI-M ANIL YADAV-ANILYADAV63473-1@OKSBI-,0000432590863167,0.0,600.0,25045.98
20/11/24,UPI,UPI-MUKKERLA GEETA SUDHA-GEETHAMUKKERLA- 1@OKAXIS-KKBK0007463-432568237557-UPI,0000432568237557,5000.0,0.0,30045.98
20/11/24,UPI,UPI-PRASANTH KUMAR T-PRASHANTH8639@AXL-B ARB0VJPUBL-335934815006-PAYMENT FROM PHO NE,0000335934815006,19534.0,0.0,49579.98
20/11/24,UPI,UPI-AIRTEL RECHARGE-AIRTELPREDIRECT2@YBL -YESB0YBLUPI-711272688557-PAYMENT FROM P HONE,0000711272688557,0.0,302.0,49277.98
20/11/24,UPI,UPI-T SHOBHA-7337589844-3@AXL-BKID000860 6-115991965281-PAYMENT FROM PHONE,0000115991965281,2480.0,0.0,51757.98
20/11/24,,ATW-416021XXXXXX2657-P3ENTS55-HYDERABAD,0000000000007485,0.0,2500.0,49257.98
20/11/24,UPI,UPI-MUDDE GAYATHRI-MUDDAEGAYATHRI@OKSBI -SBIN0020650-432504061819-CHHITTI,0000432504061819,18000.0,0.0,67257.98
20/11/24,UPI,UPI-NAGRAJ-MUKKERLANAGRAJ@OKHDFCBANK-UBI N0803219-469193792740-UPI,0000469193792740,0.0,1000.0,66257.98
20/11/24,UPI,UPI-MOHD AHMED ALI-AQUA.AHMED98@AXL-UTIB 0001808-817700582233-PAYMENT FROM PHONE,0000817700582233,180.0,0.0,66437.98
20/11/24,UPI,UPI-MAHENDARBAHETIOKICIC-MAHENDAR.BAHETI @OKICICI-ICIC0000040-432533823571-UPI,0000432533823571,0.0,25000.0,41437.98
20/11/24,UPI,UPI-ZERODHA BROKING LTD-ZERODHABROKING@H DFCBANK-HDFC0000523-432505616181-6252326 167192926 Z,0000432505616181,0.0,20000.0,21437.98
21/11/24,UPI,UPI-SANTOSH KUMAR YADAV-Q548583816@YBL-Y 000572-252195578890-PAYMENT FROM PHONE,0000432633526239,0.0,90.0,21347.98
21/11/24,UPI,UPI-MSNEXUS RESEARCH-EAZYPAY.2000060736@ ICICI-ICIC0DC0099-432621129953-UPI,0000432621129953,0.0,5000.0,16347.98
21/11/24,UPI,UPI-ANGEL LTD NSE-ANGELONENSE@HDFCBANK-H DFC0000001-432649825374-PAYINGANGELONE,0000432649825374,0.0,4000.0,12347.98
21/11/24,UPI,UPI-B RAJESHWARI-RAJESHWARIYADAV147@OKSB I-SBIN0RRDCGB-432632036943-UPI,0000432632036943,31761.0,0.0,44108.98
21/11/24,UPI,UPI-ANGEL LTD NSE-ANGELONENSE@HDFCBANK-H DFC0000001-432698423359-PAYINGANGELONE,0000432698423359,0.0,15000.0,29108.98
21/11/24,UPI,UPI-GADIGE BHASKARU-Q136697930@YBL-YESB 0YBLUPI-432634524484-UPI,0000432634524484,0.0,25.0,29083.98
21/11/24,UPI,UPI-MUKKERLA GEETA SUDHA-GEETHAMUKKERLA- 1@OKAXIS-KKBK0007463-469229035238-UPI,0000469229035238,0.0,10000.0,19083.98
21/11/24,UPI,UPI-ANGEL LTD NSE-ANGELONENSE@HDFCBANK-H DFC0000001-432657650519-PAYINGANGELONE,0000432657650519,0.0,8000.0,11083.98
21/11/24,UPI,UPI-SATHYA WINES-PAYTMQR5W5AKZ@PTYS-YESB 0PTMUPI-469228137137-UPI,0000469228137137,0.0,210.0,10873.98
22/11/24,UPI,UPI-LIBERTYSRIHARIOKICIC-LIBERTYSRIHARI@ OKICICI-BKID0008627-469318968785-UPI,0000469318968785,0.0,1300.0,9573.98
22/11/24,UPI,UPI-JURRU RAHUL YADAV-Q758292524@YBL-YE SB0YBLUPI-469388376367-UPI,0000469388376367,0.0,160.0,9413.98
22/11/24,UPI,UPI-SHAIK RAZIA BEGUM-BHARATPE.900604871 52@FBPE-FDRL0001382-432772979672-PAY TO 426009721 Z,0000432772979672,0.0,80.0,9333.98
22/11/24,NEFT,NEFT CR-YESB0000001-ZERODHA BROKING LTD- DSCNB A/C-MUKKERLA MADHU YADAV-YESF34327,YESF343273012636,5000.0,0.0,14333.98
22/11/24,UPI,UPI-SANJAY UIKEY-7997088152@IBL-SBIN000 6962-985502161528-PAYMENT FROM PHONE,0000985502161528,5000.0,0.0,19333.98
22/11/24,UPI,UPI-ANGEL LTD NSE-ANGELONENSE@HDFCBANK-H DFC0000001-432708487550-PAYINGANGELONE,0000432708487550,0.0,3700.0,15633.98
22/11/24,UPI,UPI-M MADHU YADAV-M.MADHUYADAV261@YBL-KK BK0007463-133788889157-PAYMENT FROM PHON E,0000133788889157,0.0,2000.0,13633.98
22/11/24,IMPS,IMPS-432714892182-RKATEL TECHNOLOGIES PR IVATE LIMITED-YESB-XXXXXXXXXXX1163-TESTI NSTA,0000432714892182,20900.0,0.0,34533.98
22/11/24,UPI,UPI-MANJEKAR AKHILESH-9966555427@AXL-IND B0000004-147881108145-PAYMENT FROM PHONE,0000147881108145,0.0,900.0,33633.98
22/11/24,UPI,UPI-MUKUND MANIKRAO KULK-8639614552@YBL- BARB0BARKAT-583919469743-PAYMENT FROM PH ONE,0000583919469743,735.0,0.0,34368.98
22/11/24,UPI,UPI-ANGEL LTD NSE-ANGELONENSE@HDFCBANK-H DFC0000001-432776492633-PAYINGANGELONE,0000432776492633,0.0,2500.0,31868.98
22/11/24,,ATW-416021XXXXXX2657-P3ENTS55-HYDERABAD,0000000000007836,0.0,6500.0,25368.98
22/11/24,UPI,UPI-LAXMI NARSHIMA 0006645-237981529703-PAYMENT FROM PHONE,0000469387797811,0.0,20.0,25348.98
22/11/24,UPI,UPI-DAMODAR NAYAK-PAYTMQR5Y0GUT@PTYS-YES B0PTMUPI-469341413633-UPI,0000469341413633,0.0,60.0,25288.98
22/11/24,UPI,UPI-MOHD AHMED ALI-AQUA.AHMED98@AXL-UTIB 0001808-859158878412-PAYMENT FROM PHONE,0000859158878412,180.0,0.0,25468.98
22/11/24,UPI,UPI-S N AUTOMOBILE-GPAY-11235309132@OKBI ZAXIS-UTIB0000553-432706212136-UPI,0000432706212136,0.0,370.0,25098.98
22/11/24,UPI,UPI-MUKKERLA RAJESH YADA-MRYADAV3235@OKA XIS-KKBK0007473-432759917489-UPI,0000432759917489,100.0,0.0,25198.98
23/11/24,NEFT,NEFT CR-YESB0000001-ZERODHA BROKING LTD- DSCNB A/C-MUKKERLA MADHU YADAV-YESF34328,YESF343280110962,12000.0,0.0,37198.98
23/11/24,UPI,UPI-JURRU RAHUL YADAV-Q758292524@YBL-YE SB0YBLUPI-469424524569-UPI,0000469424524569,0.0,160.0,37038.98
23/11/24,UPI,UPI-SITHALA SATHIBABU-Q855384536@YBL-YE SB0YBLUPI-432845034738-UPI,0000432845034738,0.0,60.0,36978.98
23/11/24,UPI,UPI-VADICHERLA LAKSHMI-Q714035513@YBL-Y ESB0YBLUPI-469496635214-UPI,0000469496635214,0.0,180.0,36798.98
23/11/24,UPI,UPI-RAPARTI SRIHARI-9493207195@YBL-BKID0 008627-401339871269-PAYMENT FROM PHONE,0000401339871269,0.0,10000.0,26798.98
23/11/24,UPI,UPI-FATAKPAY DIGITAL PRI-FATAKPAYDIGITAL 136700.RZP@AXISBANK-UTIB0000100-43286273 9039-OUTSTANDINGAMOUNT,0000432862739039,0.0,6001.18,20797.8
23/11/24,UPI,UPI-DEZIRE FANCY MENS WE-PAYTMQR1WWBJYHI O8@PAYTM-YESB0PTMUPI-469485357488-UPI,0000469485357488,0.0,21.0,20776.8
23/11/24,UPI,UPI-SWISSCASTLEBAKERY NA-VYAPAR.17198633 3553@HDFCBANK-HDFC0000001-469492569716-U PI,0000469492569716,0.0,240.0,20536.8
24/11/24,UPI,UPI-LIBERTYSRIHARIOKICIC-LIBERTYSRIHARI@ OKICICI-BKID0008627-469581786985-UPI,0000469581786985,0.0,1300.0,19236.8
24/11/24,UPI,UPI-MOHD MAHABOOB-MAHABOOBMOHD65@OKSBI- SBIN0007641-469592802655-UPI,0000469592802655,0.0,200.0,19036.8
24/11/24,UPI,UPI-ANIL SO SHISHPAL-Q047206811@YBL-YESB 0YBLUPI-432916210128-UPI,0000432916210128,0.0,160.0,18876.8
24/11/24,UPI,UPI-MOHD AHMED ALI-AQUA.AHMED98@YBL-UTIB 0001808-894725445608-PAYMENT FROM PHONE,0000894725445608,180.0,0.0,19056.8
24/11/24,UPI,UPI-MALATHI PERUMA-Q289171667@YBL-YESB0 YBLUPI-432971721911-UPI,0000432971721911,0.0,160.0,18896.8
24/11/24,UPI,UPI-M ARVIND-ARVINDYADAV69552@OKAXIS-K KBK0007473-469526437040-UPI,0000469526437040,20000.0,0.0,38896.8
24/11/24,UPI,UPI-JIO RECHARGE-JIOINAPPDIRECT@YBL-YESB 0YBLUPI-020701717814-PAYMENT FROM PHONE,0000020701717814,0.0,302.0,38594.8
25/11/24,UPI,UPI-JURRU RAHUL YADAV-Q758292524@YBL-YE SB0YBLUPI-469692230704-UPI,0000469692230704,0.0,160.0,38434.8
25/11/24,UPI,UPI-SRI BALAJI BAKERY-PAYTMQR5C8BEV@PTYS -YESB0PTMUPI-469680639289-UPI,0000469680639289,0.0,28.0,38406.8
25/11/24,UPI,UPI-ANGEL LTD NSE-ANGELONENSE@HDFCBANK-H DFC0000001-433020626951-PAYINGANGELONE,0000433020626951,0.0,2500.0,35906.8
25/11/24,UPI,UPI-PHONEPE-BBPSBP@YBL-YESB0YBLUPI-75986 6142821-PAYMENT FROM PHONE,0000759866142821,0.0,15047.06,20859.74
25/11/24,UPI,UPI-PHONEPE-BBPSBP@YBL-YESB0YBLUPI-41434 1213402-PAYMENT FROM PHONE,0000414341213402,0.0,900.0,19959.74
25/11/24,UPI,UPI-AIRTEL RECHARGE-AIRTELPREDIRECT2@YBL -YESB0YBLUPI-978201167653-PAYMENT FROM P HONE,0000978201167653,0.0,302.0,19657.74
25/11/24,UPI,UPI-MAHENDRA JALA-JALAMAHENDRA@OKAXIS-K KBK0007466-433052762751-UPI,0000433052762751,66000.0,0.0,85657.74
25/11/24,UPI,UPI-ANGEL LTD NSE-ANGELONENSE@HDFCBANK-H DFC0000001-469695943322-PAYINGANGELONE,0000469695943322,0.0,3700.0,81957.74
25/11/24,IMPS,IMPS-433012180662-SHADVALPAYPRIVATE-UTIB -XXXXXXXXXXX7397-BIL,0000433012180662,14700.0,0.0,96657.74
25/11/24,UPI,UPI-M ANIL YADAV-ANILYADAV63473-1@OKSBI- UBIN0803219-469679148900-UPI,0000469679148900,0.0,2500.0,94157.74
25/11/24,UPI,UPI-M ANIL YADAV-ANILYADAV63473-1@OKSBI- UBIN0803219-469639449035-UPI,0000469639449035,0.0,3000.0,91157.74
25/11/24,UPI,UPI-M ANIL YADAV-9966254742@YBL-ANDB0000 321-165095140091-PAYMENT FROM PHONE,0000165095140091,0.0,3000.0,88157.74
25/11/24,UPI,UPI-ANGEL LTD NSE-ANGELONENSE@HDFCBANK-H DFC0000001-469642442497-PAYINGANGELONE,0000469642442497,0.0,2000.0,86157.74
25/11/24,UPI,UPI-ANNU-Q661451808@YBL-YESB0YBLUPI-4330 47260851-UPI XXX7813-CASH,0000433047260851,0.0,90.0,86067.74
25/11/24,,ATW-416021XXXXXX2657-P3ENTS55-HYDERABAD,0000000000008377,0.0,1000.0,85067.74
25/11/24,UPI,UPI-S N AUTOMOBILE-GPAY-11235309132@OKBI ZAXIS-UTIB0000553-469659554842-UPI,0000469659554842,0.0,70.0,84997.74
25/11/24,UPI,UPI-SRIRAGHAVENDRATIFFIN-PAYTMQR17U07CIZ 21@PAYTM-YESB0PTMUPI-433041559536-UPI,0000433041559536,0.0,10.0,84987.74
25/11/24,UPI,UPI-K S CONSTRUCTIONS-ASHWINYADAV85-1@OK SBI-AUBL0002591-433011065663-UPI,0000433011065663,0.0,50000.0,34987.74
25/11/24,UPI,UPI-NAYAKOTI SHEKAR-MAHESH.SHEKER09-1@OK AXIS-TSAB0000103-469669862746-UPI,0000469669862746,0.0,1600.0,33387.74
25/11/24,UPI,UPI-GANTA SUJATHA-SUJATHAGANAT13@OKAXIS -SBIN0005895-469642458883-UPI,0000469642458883,0.0,10000.0,23387.74
25/11/24,UPI,UPI-GANTA SUJATHA-SUJATHAGANAT13@OKAXIS -SBIN0005895-433032308514-UPI,0000433032308514,1050.0,0.0,24437.74
25/11/24,UPI,UPI-JANARDHAN FILL POINT-BPCLJANARDHANFI LLKACHIGUDA0008@YBL-YESB0YBLUPI-46968156 1206-PAYMENT FOR GTZ347,0000469681561206,0.0,350.0,24087.74
26/11/24,UPI,UPI-BHIMASHANKER SHIVDAR-Q118225625@YBL- YESB0YBLUPI-469758886683-UPI,0000469758886683,0.0,60.0,24027.74
26/11/24,UPI,UPI-ANGEL LTD NSE-ANGELONENSE@HDFCBANK-H DFC0000001-433135982225-PAYINGANGELONE,0000433135982225,0.0,2500.0,21527.74
26/11/24,UPI,UPI-K RADHIKA-KUKUTLARADHIKA@YBL-PUNB099 6000-744174402343-PAYMENT FROM PHONE,0000744174402343,0.0,20000.0,1527.74
26/11/24,UPI,UPI-MR MADHU SUDHAN GHOD-MADHUSUDHANGHOD,0000433147105219,0.0,220.0,1307.74
26/11/24,UPI,UPI-NAYAKOTI SHEKAR-MAHESH.SHEKER09-1@OK AXIS-TSAB0000103-433107510571-UPI,0000433107510571,0.0,400.0,907.74
26/11/24,UPI,UPI-CHEKKA MOUNIKA-8790684053@YBL-SBIN0 005895-437002802265-PAYMENT FROM PHONE,0000437002802265,0.0,500.0,407.74
27/11/24,UPI,UPI-MANE NAVNEETHA-PAYTMQR5X7M3L@PTYS-YE SB0PTMUPI-469876620855-UPI,0000469876620855,0.0,30.0,377.74
27/11/24,UPI,UPI-KEERTHI NEELI-SAI.TAANYA26@OKAXIS-BA RB0BARKAT-433249564526-UPI,0000433249564526,500.0,0.0,877.74
27/11/24,UPI,UPI-BHUJARANIPALLI DATTU-9206668666@YBL- HDFC0003777-984108450043-PAYMENT FROM PH ONE,0000984108450043,1850.0,0.0,2727.74
27/11/24,UPI,UPI-LIBERTYSRIHARIOKICIC-LIBERTYSRIHARI@ OKICICI-BKID0008627-433254380618-UPI,0000433254380618,0.0,650.0,2077.74
27/11/24,UPI,UPI-MOHD AHMED ALI-AQUA.AHMED98@AXL-UTIB 0001808-934795692931-PAYMENT FROM PHONE,0000934795692931,270.0,0.0,2347.74
27/11/24,UPI,UPI-NAYAKOTI SHEKAR-MAHESH.SHEKER09-1@OK AXIS-TSAB0000103-469852767991-UPI,0000469852767991,0.0,1000.0,1347.74
27/11/24,UPI,UPI-SRI AMBICA WINES-PAYTMQR5XIA1Q@PTYS- YESB0PTMUPI-469881782955-UPI,0000469881782955,0.0,170.0,1177.74
28/11/24,UPI,UPI-MANE NAVNEETHA-PAYTMQR5X7M3L@PTYS-YE SB0PTMUPI-469912782559-UPI,0000469912782559,0.0,30.0,1147.74
28/11/24,,FT- 1509561236-57500000389159 - INDIAN C LEARING CORPORATION LIMITED -,0000000853562931,2807.79,0.0,3955.53
28/11/24,UPI,UPI-OMBKAADZ146605XD4ZBZ-OMBK.AADZ146605 XD4ZBZ4DP@MBK-PPIW0881822-469904203951-U PI,0000469904203951,0.0,380.0,3575.53
28/11/24,UPI,UPI-A NARESH KUMAR-Q749466560@YBL-YESB0Y BLUPI-469986012150-UPI,0000469986012150,0.0,15.0,3560.53
28/11/24,UPI,UPI-LAXMI NARSHIMA SWAMY-GPAY-1124082018 5@OKBIZAXIS-UTIB0000553-469922509683-UPI,0000469922509683,0.0,20.0,3540.53
28/11/24,UPI,UPI-GANTA SUJATHA-SUJATHAGANAT13@OKAXIS -SBIN0005895-433348321315-UPI,0000433348321315,0.0,1.0,3539.53
28/11/24,UPI,UPI-GANTA SUJATHA-SUJATHAGANAT13@OKAXIS -SBIN0005895-433300024630-UPI,0000433300024630,45000.0,0.0,48539.53
28/11/24,UPI,UPI-NAYAKOTI SHEKAR-MAHESH.SHEKER09-1@OK AXIS-TSAB0000103-469926027263-UPI,0000469926027263,0.0,1000.0,47539.53
28/11/24,,PQK7DLQZZSKRRZ/RAZPRBLBANKCREDITCAR,0002433368864032,0.0,36000.0,11539.53
28/11/24,UPI,UPI-MUKELRA VANI-VANIRAJESHYADAV@OKAXIS- BARB0MALKAJ-469999237840-UPI,0000469999237840,100.0,0.0,11639.53
28/11/24,IMPS,IMPS-433325264782-KIKPAY SOLUTIONS PVT L TD-RATN-XXXXXXXX3661-241128201451297966,0000433325264782,30070.0,0.0,41709.53
28/11/24,UPI,UPI-AIRTEL RECHARGE-AIRTELPREDIRECT2@YBL -YESB0YBLUPI-011039217565-PAYMENT FROM P HONE,0000011039217565,0.0,26.0,41683.53
28/11/24,UPI,UPI-JIO RECHARGE-JIOINAPPDIRECT1@YBL-YES B0YBLUPI-771632260399-PAYMENT FROM PHONE,0000771632260399,0.0,19.0,41664.53
28/11/24,UPI,UPI-LIBERTYSRIHARIOKICIC-LIBERTYSRIHARI@ OKICICI-BKID0008627-469972630267-UPI,0000469972630267,0.0,650.0,41014.53
29/11/24,UPI,UPI-JURRU RAHUL YADAV-Q758292524@YBL-YE SB0YBLUPI-470093843368-UPI,0000470093843368,0.0,80.0,40934.53
29/11/24,UPI,UPI-NARLA SRIKANTH YADA-Q470718822@YBL- YESB0YBLUPI-433469838966-UPI,0000433469838966,0.0,35.0,40899.53
29/11/24,UPI,UPI-MAHENDRA JALA-JALAMAHENDRA@OKAXIS-K KBK0007466-470049254620-UPI,0000470049254620,46000.0,0.0,86899.53
29/11/24,UPI,UPI-SRI BALAJI BAKERY-PAYTMQR5C8BEV@PTYS -YESB0PTMUPI-433405137668-UPI,0000433405137668,0.0,40.0,86859.53
29/11/24,UPI,UPI-PHONEPE-BBPSBP@YBL-YESB0YBLUPI-16836 1350109-PAYMENT FROM PHONE,0000168361350109,0.0,42575.8,44283.73
29/11/24,UPI,UPI-ANGEL ONE LIMITED-ANGELONENSE@ICICI- ICIC0DC0099-433467243091-PAYINGANGELONE,0000433467243091,0.0,5000.0,39283.73
29/11/24,UPI,UPI-DEEP SHIKHA GUPTA-AKG03071965@OKSBI- BARB0HIMHYD-470048344488-UPI,0000470048344488,0.0,1450.0,37833.73
29/11/24,UPI,UPI-RAPARTI SRIHARI-9493207195@YBL-BKID0 008627-372068519017-PAYMENT FROM PHONE,0000372068519017,0.0,13000.0,24833.73
29/11/24,IMPS,IMPS-433425232949-SHADVAL PAY PRIVATE LI MITED-RATN-XXXXXXXX1978-BILL,0000433425232949,38800.0,0.0,63633.73
29/11/24,UPI,UPI-M ANIL YADAV-ANILYADAV63473-1@OKSBI- UBIN0803219-433405747892-UPI,0000433405747892,0.0,3000.0,60633.73
29/11/24,UPI,UPI-M ANIL YADAV-ANILYADAV63473-1@OKSBI- UBIN0803219-433441267172-UPI,0000433441267172,0.0,600.0,60033.73
29/11/24,UPI,ZHDFBBH077OC3V/BILLDKRATNAKARBANKLI YESBANKLTD-YESB0YESUPI-511952059390-PAY TO J SHIVANARA,0002433468946854,0.0,6857.0,53176.73
29/11/24,UPI,UPI-MOHD PASHA MIYA-8074523914@YBL-LAVB0 000572-014799211211-PAYMENT FROM PHONE,0000014799211211,0.0,2000.0,51176.73
29/11/24,UPI,UPI-LIBERTYSRIHARIOKICIC-LIBERTYSRIHARI@ OKICICI-BKID0008627-470030490491-UPI,0000470030490491,0.0,650.0,50526.73
30/11/24,UPI,UPI-MAHENDRA JALA-JALAMAHENDRA@OKAXIS-K KBK0007466-470196215537-UPI,0000470196215537,50000.0,0.0,100526.73
30/11/24,UPI,UPI-K S CONSTRUCTIONS-ASHWINYADAV85-1@OK SBI-AUBL0002591-470168607146-UPI,0000470168607146,0.0,50000.0,50526.73
30/11/24,UPI,UPI-MR MARYPEDDY YADAIAH-PAYTMQR1QEBB0LQ 0U@PAYTM-YESB0PTMUPI-433515604157-UPI,0000433515604157,0.0,35.0,50491.73
30/11/24,UPI,UPI-BALAJI BIRADAR-9603152787@AXL-SBIN0 012720-433561302263-UPI,0000433561302263,0.0,540.0,49951.73
30/11/24,UPI,UPI-P NAND KISHOR-BHARATPE.90069295183@F BPE-FDRL0001382-433514693350-PAY TO BHAR ATPE ME,0000433514693350,0.0,80.0,49871.73
30/11/24,UPI,UPI-TAPSTART CAPITAL PRI-MWYNTECHPRIVATE 77.RZP@ICICI-ICIC0DC0099-433582194830-PA YVIARAZORPAY,0000433582194830,0.0,1873.02,47998.71
30/11/24,UPI,UPI-CHILUKALA VAMSHI YAD-VAMSHIY764@OKSB I-KKBK0007452-433520805858-UPI,0000433520805858,0.0,500.0,47498.71
30/11/24,UPI,UPI-NORTHERN ARC-NORTHERNARC495902.RZP@A XISBANK-UTIB0000100-762866023354-POWERED BY SMARTCO,0000762866023354,0.0,7134.54,40364.17
30/11/24,UPI,UPI-MARGAM VANI-VANIMARGAM510@OKAXIS-SB,0000470167244683,30000.0,0.0,70364.17
30/11/24,UPI,UPI-MR TAUTI MADHU BABU-Q336762087@YBL- YESB0YBLUPI-433548720442-UPI,0000433548720442,0.0,50.0,70314.17
30/11/24,UPI,UPI-JIO RECHARGE-JIOINAPPDIRECT1@YBL-YES B0YBLUPI-301794654374-PAYMENT FROM PHONE,0000301794654374,0.0,19.0,70295.17
01/12/24,UPI,UPI-CHANDRA SEKHAR POLA-8985563579@YBL-H DFC0000521-604892907512-PAYMENT FROM PHO NE,0000604892907512,0.0,101.0,70194.17
01/12/24,UPI,UPI-MR RAPATHI NARSING -Q084776718@YBL- YESB0YBLUPI-763502493328-PAYMENT FROM PH ONE,0000763502493328,0.0,130.0,70064.17
01/12/24,UPI,UPI-LIBERTYSRIHARIOKICIC-LIBERTYSRIHARI@ OKICICI-BKID0008627-433608158536-UPI,0000433608158536,0.0,1300.0,68764.17
01/12/24,UPI,UPI-LAKSHMI APPALA-LAKSHME1202@OKSBI-SB IN0005895-433660075211-UPI,0000433660075211,3000.0,0.0,71764.17
01/12/24,UPI,UPI-SAINATH HULSURE-Q254740911@YBL-YES B0YBLUPI-433632245695-UPI,0000433632245695,0.0,100.0,71664.17
01/12/24,UPI,UPI-BITTU KUMAR-BITTUKUMARSPJ936@OKHDFC BANK-UBIN0567736-433661756257-UPI,0000433661756257,0.0,70.0,71594.17
01/12/24,UPI,UPI-JYOTHI-PAYTMQR5W2L0I@PTYS-YESB0PTMUP I-433646646414-UPI,0000433646646414,0.0,140.0,71454.17
01/12/24,UPI,UPI-MEERPETI MURALI-BHARATPE.9053096200@ FBPE-FDRL0001382-433687350739-VERIFIED M ERCHANT,0000433687350739,0.0,280.0,71174.17
01/12/24,UPI,UPI-SOMALWAR SHRINIVAS-SOMALWAR73@OKSBI,0000433661161810,1200.0,0.0,72374.17
01/12/24,UPI,UPI-MUNTHA RAMESH YADAV-RAMEESHM6666@YBL -BKID0008604-075935777617-PAYMENT FROM P HONE,0000075935777617,0.0,4000.0,68374.17
01/12/24,UPI,UPI-M MADHU YADAV-M.MADHUYADAV261@YBL-KK BK0007463-617934847078-PAYMENT FROM PHON E,0000617934847078,0.0,5000.0,63374.17
01/12/24,UPI,UPI-MUKKERLA GEETA SUDHA-6302856696@YBL- KKBK0007463-437606997886-PAYMENT FROM PH ONE,0000437606997886,0.0,3000.0,60374.17
01/12/24,UPI,UPI-BHARGAVI BUDUMURU-6303219486@YBL-SB IN0020784-509392559721-PAYMENT FROM PHON E,0000509392559721,2100.0,0.0,62474.17
01/12/24,UPI,UPI-AKSHAY CHINTALA-9849868607@AXISB-CNR B0000033-433613453400-PAID VIA CRED AND,0000433613453400,1350.0,0.0,63824.17
01/12/24,UPI,UPI-ANIL SO SHISHPAL-Q047206811@YBL-YESB 0YBLUPI-433663064307-UPI,0000433663064307,0.0,220.0,63604.17
01/12/24,UPI,UPI-M MADHU YADAV-9985065404-2@YBL-SBIN 0006645-948125119314-PAYMENT FROM PHONE,0000948125119314,38000.0,0.0,101604.17
01/12/24,UPI,UPI-ANGEL LTD NSE-ANGELONENSE@HDFCBANK-H DFC0000001-433696775583-PAYINGANGELONE,0000433696775583,0.0,43000.0,58604.17
01/12/24,UPI,UPI-ZERODHA BROKING LTD-ZERODHABROKING@H DFCBANK-HDFC0000523-470219566418-6709577 408221984 Z,0000470219566418,0.0,12000.0,46604.17
01/12/24,UPI,UPI-PANYAM L-CBIN0284811-088069098969-PAYMENT FROM PHONE,0000433696738755,2500.0,0.0,49104.17
01/12/24,UPI,UPI-RONAK NEELESH RUPARA-KUMARRONAK7@OKA XIS-HDFC0000545-470271410755-MILK BILL N OVEMBER,0000470271410755,945.0,0.0,50049.17
01/12/24,UPI,UPI-BALA KASHYAP-BALA.KASHYAP1@YBL-HDFC0 000126-277807555099-PAYMENT FROM PHONE,0000277807555099,420.0,0.0,50469.17
01/12/24,UPI,UPI-MOHD AHMED ALI-AQUA.AHMED98@AXL-UTIB 0001808-481720817550-PAYMENT FROM PHONE,0000481720817550,360.0,0.0,50829.17
01/12/24,UPI,UPI-KOUR H-HARDEEPKOUR24@OKAXIS-HSBC0500 002-433664723073-UPI,0000433664723073,1350.0,0.0,52179.17
01/12/24,UPI,UPI-XXXXXX1876-SBIN0000001-224906552031- PAYMENT FROM PHONE,0000224906552031,0.0,2300.0,49879.17
01/12/24,UPI,UPI-MUKKERLA GEETA SUDHA-6302856696@YBL- KKBK0007463-084076242427-PAYMENT FROM PH ONE,0000084076242427,0.0,16000.0,33879.17
02/12/24,UPI,UPI-MANE NAVNEETHA-PAYTMQR5C8BFC@PTYS-YE SB0PTMUPI-433777994071-UPI,0000433777994071,0.0,30.0,33849.17
02/12/24,UPI,UPI-MR PRASAD KURUMETI-BHARATPE.900572 58535@FBPE-FDRL0001382-470301702981-PAY TO BHARATPE ME,0000470301702981,0.0,50.0,33799.17
02/12/24,UPI,UPI-ANGEL LTD NSE-ANGELONENSE@HDFCBANK-H DFC0000001-470341707663-PAYINGANGELONE,0000470341707663,0.0,5000.0,28799.17
02/12/24,UPI,UPI-ANGEL LTD NSE-ANGELONENSE@HDFCBANK-H E,0000470376107908,0.0,500.0,28299.17
02/12/24,UPI,UPI-ZERODHA BROKING LTD-ZERODHABROKING@H DFCBANK-HDFC0000523-433760712068-7542753 581343240 Z,0000433760712068,0.0,1300.0,26999.17
02/12/24,UPI,UPI-M ARVIND-ARVINDYADAV69552@OKAXIS-K KBK0007473-470323598904-UPI,0000470323598904,0.0,1000.0,25999.17
02/12/24,,BAJAJFIN_BF-1286306_102243524,000000000000000,0.0,3209.0,22790.17
02/12/24,,BAJAJFIN_BF-1286306_102364128,000000000000000,0.0,9503.0,13287.17
02/12/24,,BAJAJFIN_BF-1286306_102340270,000000000000000,0.0,9101.0,4186.17
02/12/24,UPI,UPI-MAHENDAR KUMAR BAHET-MAHENDAR.BAHETI @OKICICI-ICIC0000040-470364129833-NOV MI LK,0000470364129833,2000.0,0.0,6186.17
02/12/24,UPI,UPI-JAI SANTOSHI MATHA K-PAYTMQR14XHUCJN D9@PAYTM-YESB0PTMUPI-433748516766-UPI,0000433748516766,0.0,754.0,5432.17
02/12/24,UPI,UPI-MARGAM VANI-VANIMARGAM510@OKAXIS-SB IN0021100-433734187843-UPI,0000433734187843,30000.0,0.0,35432.17
02/12/24,UPI,UPI-LIBERTYSRIHARIOKICIC-LIBERTYSRIHARI@ OKICICI-BKID0008627-470330143868-UPI,0000470330143868,0.0,650.0,34782.17
02/12/24,NEFT,NEFT CR-ICIC0099999-ANGEL ONE LIMITED CL IENT AC-MUKKERLA MADHU YADAV-CMS46922791,000CMS4692279166,14000.0,0.0,48782.17
03/12/24,NEFT,NEFT CR-YESB0000001-ZERODHA BROKING LTD- DSCNB A/C-MUKKERLA MADHU YADAV-YESF34338 ONE,YESF343380015098,2000.0,0.0,50782.17
03/12/24,UPI,UPI-JURRU RAHUL YADAV-Q758292524@YBL-YE SB0YBLUPI-433854265838-UPI,0000433854265838,0.0,200.0,50582.17
03/12/24,UPI,UPI-SYEDA NASREEN SULTAN-AFREENSYEDA-1@O KICICI-ICIC0003867-433841158483-UPI,0000433841158483,2700.0,0.0,53282.17
03/12/24,UPI,UPI-ANGEL LTD NSE-ANGELONENSE@HDFCBANK-H DFC0000001-433833556936-PAYINGANGELONE,0000433833556936,0.0,10000.0,43282.17
03/12/24,UPI,UPI-ZERODHA BROKING LTD-ZERODHABROKING@H DFCBANK-HDFC0000523-470480852260-0190603 535542641 Z,0000470480852260,0.0,8000.0,35282.17
03/12/24,UPI,UPI-RAPARTI SRIHARI-9493207195@YBL-BKID0 008627-172482217728-PAYMENT FROM PHONE,0000172482217728,0.0,10000.0,25282.17
03/12/24,UPI,UPI-KRAZYBEE-CF.KRAZYBEE@KOTAK-KKBK00009 58-470461766988-KREDITBEEPAYMENT,0000470461766988,0.0,5951.0,19331.17
03/12/24,UPI,UPI-LAXMI NARSHIMA SWAMY-GPAY-1124082018 5@OKBIZAXIS-UTIB0000553-747388877025-PAY MENT FROM PHONE,0000747388877025,0.0,44.0,19287.17
03/12/24,UPI,UPI-ZERODHA BROKING LTD-ZERODHABROKING@H DFCBANK-HDFC0000523-470434060262-9637563 333239218 Z,0000470434060262,0.0,2500.0,16787.17
03/12/24,UPI,UPI-SURAPALLY SAIKUMAR-9381568131@IBL-S BIN0021096-439361520278-PAYMENT FROM PHO NE,0000439361520278,1350.0,0.0,18137.17
03/12/24,UPI,UPI-B SHIRISHA-SIRISHA0413@YBL-UBIN08007 67-776090141667-PAYMENT FROM PHONE,0000776090141667,2250.0,0.0,20387.17
03/12/24,UPI,UPI-KUMBUM VIJAYA LAKSHM-LAKSHMIVIJAYA85 0012916-753153824949-PAYMENT FROM PHONE,0000433863437964,1390.0,0.0,21777.17
03/12/24,UPI,UPI-SRIRAGHAVENDRATIFFIN-PAYTMQR17U07CIZ 21@PAYTM-YESB0PTMUPI-433890082770-UPI,0000433890082770,0.0,12.0,21765.17
03/12/24,UPI,UPI-MR VISHAL KUMAR-VISHALKUMARVISHAL829 8@OKHDFCBANK-IDIB000M721-433872478470-UP I,0000433872478470,3750.0,0.0,25515.17
03/12/24,UPI,UPI-BHAGWAN DAS MARDA-7816018341@AXL-KVB L0001443-606598704648-PAYMENT FROM PHONE,0000606598704648,1305.0,0.0,26820.17
03/12/24,UPI,UPI-MR SUHAS MADHUKAR CH-DRSUHAS2003@OKI CICI-IDIB000M238-470446695161-UPI,0000470446695161,1170.0,0.0,27990.17
03/12/24,UPI,UPI-PURUSHOTTAM ADHIKAR-9005457070@AXL- SBIN0012223-935444801897-PAYMENT FROM PH ONE,0000935444801897,3150.0,0.0,31140.17
03/12/24,UPI,UPI-MARGAM VANI-VANIMARGAM510@OKSBI-SBI N0021100-433892650483-UPI,0000433892650483,8000.0,0.0,39140.17
04/12/24,NEFT,NEFT CR-YESB0000001-ZERODHA BROKING LTD- DSCNB A/C-MUKKERLA MADHU YADAV-YESF34339,YESF343390025024,7500.0,0.0,46640.17
04/12/24,UPI,UPI-JURRU RAHUL YADAV-Q758292524@YBL-YE SB0YBLUPI-433931811723-UPI,0000433931811723,0.0,160.0,46480.17
04/12/24,UPI,UPI-SANTOSH KUMAR YADAV-Q548583816@YBL-Y ESB0YBLUPI-470522120850-UPI YADAV-KKBK-XXX XXX7813-CASH,0000470522120850,0.0,80.0,46400.17
04/12/24,UPI,UPI-MANE NAVNEETHA-PAYTMQR5X7M3L@PTYS-YE SB0PTMUPI-433901323771-UPI,0000433901323771,0.0,30.0,46370.17
04/12/24,UPI,UPI-ZERODHA BROKING LTD-ZERODHABROKING@H DFCBANK-HDFC0000523-433961929788-8063305 497048684 Z,0000433961929788,0.0,2000.0,44370.17
04/12/24,,ANGEL ONE LIMI-225240047,0000412040699075,15000.0,0.0,59370.17
04/12/24,UPI,UPI-LIQUILOANS-CF.LIQUILOANS@ICICI-ICIC0 DC0099-470503421319-UPI,0000470503421319,0.0,21485.29,37884.88
04/12/24,,ACH D- PROTIUM FINANCE LIMI-S42GRUSELQ7N,0000001840972687,0.0,28475.0,9409.88
04/12/24,UPI,UPI-M MADHU YADAV-9985065404-2@YBL-SBIN 0006645-121204377191-PAYMENT FROM PHONE,0000121204377191,4000.0,0.0,13409.88
04/12/24,UPI,UPI-RAPARTI SRIHARI-9493207195@YBL-BKID0 008627-162978812613-PAYMENT FROM PHONE,0000162978812613,0.0,10000.0,3409.88
04/12/24,UPI,UPI-MOHD SAIF-PAYTMQRFGZRP91W8H@PAYTM-YE SB0PTMUPI-433953629511-UPI,0000433953629511,0.0,293.0,3116.88
04/12/24,UPI,UPI-ANGEL LTD NSE-ANGELONENSE@HDFCBANK-H DFC0000001-470507023673-PAYINGANGELONE,0000470507023673,0.0,1200.0,1916.88
04/12/24,UPI,UPI-B VINOD KUMAR-BALERAOVINOD077@OKSBI- CNRB0000033-433937041682-UPI,0000433937041682,0.0,400.0,1516.88
04/12/24,UPI,UPI-NEELAM SETHI-NEELAMSETHI741@OKAXIS-U BIN0534773-470534723465-UPI,0000470534723465,2780.0,0.0,4296.88
04/12/24,UPI,UPI-FAIZANSALMANI6052OKI-FAIZANSALMANI60 52@OKICICI-PUNB0277600-470501751513-UPI,0000470501751513,0.0,750.0,3546.88
04/12/24,UPI,UPI-MARGAM VANI-VANIMARGAM510@OKSBI-SBI,0000433939041590,30000.0,0.0,33546.88
04/12/24,UPI,UPI-SANJAY UIKEY-7997088152@IBL-SBIN000 6962-731687804005-PAYMENT FROM PHONE,0000731687804005,0.0,5000.0,28546.88
04/12/24,UPI,UPI-K MADHUSUDHAN REDDY-MADHU816@AXL-KKB K0007463-218257673762-PAYMENT FROM PHONE,0000218257673762,1200.0,0.0,29746.88
04/12/24,UPI,UPI-M MADHU YADAV-M.MADHUYADAV261@YBL-KK BK0007463-116080127195-PAYMENT FROM PHON E,0000116080127195,0.0,7000.0,22746.88
04/12/24,NEFT,NEFT CR-ICIC0099999-ANGEL ONE LIMITED CL IENT AC-MUKKERLA MADHU YADAV-CMS46983003,000CMS4698300310,10000.0,0.0,32746.88
04/12/24,UPI,UPI-MUKKERLA GEETA SUDHA-GEETHAMUKKERLA- 1@OKAXIS-KKBK0007463-470552758065-UPI,0000470552758065,0.0,10000.0,22746.88
05/12/24,UPI,UPI-JURRU RAHUL YADAV-Q758292524@YBL-YE SB0YBLUPI-434038069417-UPI,0000434038069417,0.0,240.0,22506.88
05/12/24,UPI,UPI-MARGAM VANI-VANIMARGAM510@OKSBI-SBI N0021100-434049893732-UPI,0000434049893732,7000.0,0.0,29506.88
05/12/24,UPI,UPI-ANGEL LTD NSE-ANGELONENSE@HDFCBANK-H DFC0000001-470691976086-PAYINGANGELONE,0000470691976086,0.0,10000.0,19506.88
05/12/24,UPI,UPI-SRIKANTH POOJA STORE-GPAY-1124457832 8@OKBIZAXIS-UTIB0000553-470678664715-UPI,0000470678664715,0.0,110.0,19396.88
05/12/24,UPI,UPI-M ANIL YADAV-ANILYADAV63473-1@OKHDFC BANK-UBIN0803219-434042517571-CASH,0000434042517571,10000.0,0.0,29396.88
05/12/24,UPI,UPI-ZERODHA BROKING PHONE,0000470659778001,0.0,500.0,28896.88
05/12/24,UPI,UPI-TAPSTART CAPITAL PRI-MWYNTECHPRIVATE 794.RZP@AXISBANK-UTIB0000100-43408048327 9-PAYVIARAZORPAY,0000434080483279,0.0,1770.0,27126.88
05/12/24,UPI,UPI-ANGEL LTD NSE-ANGELONENSE@HDFCBANK-H DFC0000001-434017888910-PAYINGANGELONE,0000434017888910,0.0,1500.0,25626.88
05/12/24,UPI,UPI-SANTHOSHA ARRA-SANTHU.SANTHOSHA2004 -1@OKAXIS-KKBK0007487-434027786533-UPI,0000434027786533,0.0,10000.0,15626.88
05/12/24,UPI,UPI-PAYMEINDIA-PAYMEINDIAEZB1@ICICI-ICIC 0DC0099-434084678561-UPI,0000434084678561,0.0,10462.0,5164.88
05/12/24,UPI,UPI-RITESH JAIN MUTHA-GREEVA.ELECTRICALS @OKAXIS-BARB0WARANG-470698185924-UPI,0000470698185924,3550.0,0.0,8714.88
05/12/24,UPI,UPI-AVULA DEEPIKA-9390042802-2@YBL-UTIB0 005151-798808323527-PAYMENT FROM PHONE,0000798808323527,1000.0,0.0,9714.88
05/12/24,UPI,UPI-MOHIT SETHIA-MOHITSJ.1995@OKICICI- KKBK0007452-470621598850-UPI,0000470621598850,1100.0,0.0,10814.88
05/12/24,UPI,UPI-SASHIKALA BHANDARI-9032117972@YBL-S BIN0005895-283025633144-PAYMENT FROM PHO NE,0000283025633144,3000.0,0.0,13814.88
05/12/24,UPI,UPI-RAJESH C PATEL-CNKRAJESHPATEL@OKAXIS -KKBK0008052-470608200460-UPI,0000470608200460,3420.0,0.0,17234.88
05/12/24,UPI,UPI-MOHD AHMED ALI-AQUA.AHMED98@AXL-UTIB 0001808-991086682061-PAYMENT FROM PHONE,0000991086682061,300.0,0.0,17534.88
05/12/24,UPI,UPI-NAYI KOTI,0000074961812398,0.0,3000.0,14534.88
05/12/24,NEFT,NEFT CR-ICIC0099999-ANGEL ONE LIMITED CL IENT AC-MUKKERLA MADHU YADAV-CMS47013121,000CMS4701312115,7000.0,0.0,21534.88
06/12/24,UPI,UPI-LIBERTYSRIHARIOKICIC-LIBERTYSRIHARI@ OKICICI-BKID0008627-434179629752-UPI,0000434179629752,0.0,1300.0,20234.88
06/12/24,UPI,UPI-MANE NAVNEETHA-PAYTMQR5X7LS9@PTYS-YE SB0PTMUPI-434116517043-UPI,0000434116517043,0.0,30.0,20204.88
06/12/24,,IB BILLPAY DR-HDFC92-434155XXXXXX1025,MB06083153965T47,0.0,10191.0,10013.88
06/12/24,UPI,UPI-MUKKERLA GEETA SUDHA-GEETHAMUKKERLA- 1@OKAXIS-KKBK0007463-470770433374-UPI,0000470770433374,25000.0,0.0,35013.88
06/12/24,UPI,UPI-ANGEL LTD NSE-ANGELONENSE@HDFCBANK-H DFC0000001-434143216677-PAYINGANGELONE,0000434143216677,0.0,20000.0,15013.88
06/12/24,UPI,UPI-ANGEL LTD NSE-ANGELONENSE@HDFCBANK-H DFC0000001-470723626298-PAYINGANGELONE,0000470723626298,0.0,10000.0,5013.88
06/12/24,UPI,UPI-BILLA S-9700452204-2@AXL-HSBC0500002 -599596725463-PAYMENT FROM PHONE,0000599596725463,1000.0,0.0,6013.88
06/12/24,UPI,UPI-MADHURI MARAM-LIPIKAMARAM@OKICICI-IC IC0000008-434109648453-UPI,0000434109648453,3645.0,0.0,9658.88
06/12/24,NEFT,NEFT CR-YESB0000001-FINKURVE FINANCIAL S ERVICES LIMITED-M MADHU YADAV-YESB434138,0YESB43413866318,8584.0,0.0,18242.88
06/12/24,UPI,UPI-MOHAMMAD BHARATHI-BHARTHI9573@YBL-S BIN0020701-549293790170-UPI,0000576143360341,2025.0,0.0,20267.88
06/12/24,UPI,UPI-MUKKERLA RAJESH YADA-MRYADAV3235@OKA XIS-KKBK0007473-434194693068-UPI,0000434194693068,200.0,0.0,20467.88
06/12/24,UPI,UPI-JIO RECHARGE-JIOINAPPDIRECT@YBL-YESB 0YBLUPI-711398452661-PAYMENT FROM PHONE,0000711398452661,0.0,19.0,20448.88
06/12/24,UPI,UPI-JIO RECHARGE-JIOINAPPDIRECT@YBL-YESB 0YBLUPI-246633140930-PAYMENT FROM PHONE,0000246633140930,0.0,19.0,20429.88
07/12/24,UPI,UPI-MUKKERLA GEETA SUDHA-GEETHAMUKKERLA- 1@OKAXIS-KKBK0007463-470893304905-UPI,0000470893304905,14000.0,0.0,34429.88
07/12/24,UPI,UPI-VARTHYAVATH THIRUPAT-THIRUPATHI1981N AIK@YBL-ANDB0001424-871306141501-PAYMENT FROM PHONE,0000871306141501,2200.0,0.0,36629.88
07/12/24,UPI,UPI-SRI VINAYAKA ENTERPR-SUBBARAJU198900 @YBL-KKBK0007460-542840303330-PAYMENT FR OM PHONE,0000542840303330,0.0,25000.0,11629.88
07/12/24,UPI,UPI-M MADHU YADAV-9985065404-2@YBL-SBIN 0006645-976131957631-PAYMENT FROM PHONE,0000976131957631,9500.0,0.0,21129.88
07/12/24,UPI,UPI-SHAIK AKBER NLAXMAIA-Q093219408@YBL- YESB0YBLUPI-434229091697-UPI,0000434229091697,0.0,350.0,20779.88
07/12/24,UPI,UPI-M ANIL YADAV-ANILYADAV63473-1@OKHDFC BANK-UBIN0803219-434257247379-UPI,0000434257247379,4520.0,0.0,25299.88
07/12/24,UPI,UPI-NAYI KOTI SEKHAR-SHEKAR.NAIKOTI1@YBL,0000224101045862,0.0,2000.0,23299.88
07/12/24,UPI,UPI-MOHD MAHMOOD ALI-9347010777@IBL-PUNB 0020700-022681080201-PAYMENT FROM PHONE,0000022681080201,2000.0,0.0,25299.88
07/12/24,UPI,UPI-LIBERTYSRIHARIOKICIC-LIBERTYSRIHARI@ OKICICI-BKID0008627-470800816266-UPI,0000470800816266,0.0,650.0,24649.88
08/12/24,UPI,UPI-MAADEVI-Q552508687@YBL-YESB0YBLUPI-4 70966731129-UPI,0000470966731129,0.0,240.0,24409.88
08/12/24,,ACH D- HERO FINCORP LTD-62405711,0000002082001205,0.0,10855.0,13554.88
08/12/24,UPI,UPI-BHARATHI BHARATHI-BHARTHI9573@YBL-S BIN0020701-434373342917-UPI,0000434373342917,0.0,6000.0,7554.88
08/12/24,UPI,UPI-KANAKA DURGA RESTAU-Q780412417@YBL-Y ESB0YBLUPI-470995340794-UPI,0000470995340794,0.0,230.0,7324.88
08/12/24,UPI,UPI-M MADHU YADAV-9985065404-2@YBL-SBIN 0006645-893334403032-PAYMENT FROM PHONE,0000893334403032,14500.0,0.0,21824.88
08/12/24,UPI,UPI-RAPARTI SRIHARI-9493207195@YBL-BKID0 008627-323484980959-PAYMENT FROM PHONE,0000323484980959,0.0,21000.0,824.88
08/12/24,UPI,UPI-K RAVINDER-PAYTMQR60KI8Y@PTYS-YESB0P TMUPI-434392259025-UPI,0000434392259025,0.0,10.0,814.88
08/12/24,UPI,UPI-M ARVIND RAJ-ARVINDRAJ57964-1@OKHDFC BANK-HDFC0000512-434316274827-UPI,0000434316274827,1595.0,0.0,2409.88
08/12/24,UPI,UPI-JIO RECHARGE-JIOINAPPDIRECT1@YBL-YES B0YBLUPI-771071318287-PAYMENT FROM PHONE,0000771071318287,0.0,19.0,2390.88
08/12/24,UPI,UPI-LIBERTYSRIHARIOKICIC-LIBERTYSRIHARI@ OKICICI-BKID0008627-434306475291-UPI LTD- DSCNB A/C-MUKKERLA MADHU YADAV-YESBN1202 493112 5050801493112,0000434306475291,0.0,650.0,1740.88
08/12/24,UPI,UPI-MOHAMMED MASIUDDIN-Q988017422@YBL-Y ESB0YBLUPI-434336874957-UPI,0000434336874957,0.0,170.0,1570.88
09/12/24,UPI,UPI-NARLA SRIKANTH YADA-Q470718822@YBL- YESB0YBLUPI-471009688868-UPI,0000471009688868,0.0,35.0,1535.88
09/12/24,UPI,UPI-B RAYUDU-RAYUDU10-1@OKHDFCBANK-HDFC0 000042-434432848235-MILK AMT,0000434432848235,1120.0,0.0,2655.88
09/12/24,,IB BILLPAY DR-HDFC92-434155XXXXXX1025,MB09084413578T28,0.0,2500.0,155.88
09/12/24,UPI,UPI-MUKKERLA GEETA SUDHA-GEETHAMUKKERLA- 1@OKAXIS-KKBK0007463-434409987413-UPI,0000434409987413,8000.0,0.0,8155.88
09/12/24,UPI,UPI-VINOD KUMAR BALE-PAYTMQR60KOJ5@PTYS- YESB0PTMUPI-471030421470-UPI,0000471030421470,0.0,150.0,8005.88
09/12/24,UPI,UPI-MOHD AHMED ALI-AQUA.AHMED98@AXL-UTIB 0001808-815276314352-PAYMENT FROM PHONE,0000815276314352,180.0,0.0,8185.88
09/12/24,UPI,UPI-BOPPAWAD PRASHANTHI -Q324755315@YBL- YESB0YBLUPI-434409836273-UPI,0000434409836273,0.0,35.0,8150.88
09/12/24,UPI,UPI-JIO RECHARGE-JIOINAPPDIRECT@YBL-YESB 0YBLUPI-325680694537-PAYMENT FROM PHONE,0000325680694537,0.0,302.0,7848.88
09/12/24,UPI,UPI-M MADHU YADAV-9985065404-2@YBL-SBIN 0006645-709035648222-PAYMENT FROM PHONE,0000709035648222,7500.0,0.0,15348.88
09/12/24,UPI,UPI-LIBERTYSRIHARIOKICIC-LIBERTYSRIHARI@ OKICICI-BKID0008627-471068434138-UPI,0000471068434138,0.0,650.0,14698.88
09/12/24,UPI,UPI-JONNA KANTI SRIKRIS-Q131493680@YBL- YESB0YBLUPI-471022325177-UPI,0000471022325177,0.0,70.0,14628.88
09/12/24,UPI,UPI-JIO SRIHARI-LIBERTYSRIHARI@OKAXI S-BKID0008627-512869564679-DAILY 1300 IN TO 1,0000045140867735,0.0,302.0,14326.88
09/12/24,IMPS,IMPS-434428255789-TAPSTART CAPITAL PVT L TD-RATN-XXXXXXXX6589-WITHDRAWAL,0000434428255789,2634.2,0.0,16961.08
10/12/24,UPI,UPI-MANE NAVNEETHA-PAYTMQR5X7LS9@PTYS-YE SB0PTMUPI-471185351093-UPI,0000471185351093,0.0,60.0,16901.08
10/12/24,UPI,UPI-ANGEL LTD NSE-ANGELONENSE@HDFCBANK-H DFC0000001-434551743702-PAYINGANGELONE,0000434551743702,0.0,3500.0,13401.08
10/12/24,UPI,UPI-ZERODHA BROKING LTD-ZERODHABROKING@H DFCBANK-HDFC0000523-471130249888-0984462 859333264 Z,0000471130249888,0.0,700.0,12701.08
10/12/24,UPI,UPI-LIBERTYSRIHARIOKICIC-LIBERTYSRIHARI@ OKICICI-BKID0008627-434518552892-UPI,0000434518552892,0.0,650.0,12051.08
10/12/24,UPI,UPI-KONDREDDY MANJULA-PAYTMQR5F3YP2@PTYS -YESB0PTMUPI-471181852361-UPI,0000471181852361,0.0,120.0,11931.08
10/12/24,UPI,UPI-BHARATHI BHARATHI-BHARTHI9573@YBL-S BIN0020701-434588468178-UPI,0000434588468178,0.0,6000.0,5931.08
10/12/24,UPI,UPI-BOBBALA HEMCHAND-8466816117-4@YBL-IC IC0003714-205123686889-PAYMENT FROM PHON E,0000205123686889,450.0,0.0,6381.08
11/12/24,UPI,UPI-MANE NAVNEETHA-PAYTMQR5X7LS9@PTYS-YE SB0PTMUPI-471248206870-UPI,0000471248206870,0.0,30.0,6351.08
11/12/24,UPI,UPI-ANGEL ONE LIMITED-ANGELONENSE@ICICI- ICIC0DC0099-471251310134-PAYINGANGELONE YESB0YBLUPI-549551688300-UPI,0000471251310134,0.0,800.0,5551.08
11/12/24,UPI,UPI-ZERODHA BROKING LTD-ZERODHABROKING@H DFCBANK-HDFC0000523-434617902844-0092092 861541385 Z,0000434617902844,0.0,250.0,5301.08
11/12/24,,FT- 1538582794-57500000389159 - INDIAN C LEARING CORPORATION LIMITED -,0000000871516925,0.06,0.0,5301.14
11/12/24,UPI,UPI-M MADHU YADAV-M.MADHUYADAV261@YBL-KK BK0007463-893326647678-PAYMENT FROM PHON E,0000893326647678,400.0,0.0,5701.14
11/12/24,UPI,UPI-M ANIL YADAV-ANILYADAV63473-1@OKHDFC BANK-UBIN0803219-434647823029-2700 AMRUT HA VARSH,0000434647823029,17700.0,0.0,23401.14
11/12/24,UPI,UPI-SRI BALAJI BAKERY-PAYTMQR5C8BEV@PTYS -YESB0PTMUPI-471253630962-UPI,0000471253630962,0.0,30.0,23371.14
11/12/24,UPI,UPI-VENKATESH DOTI-9666454935@YBL-HDFC00 00081-430389174660-PAYMENT FROM PHONE,0000430389174660,0.0,14500.0,8871.14
11/12/24,UPI,UPI-G PRASHANTH-7702920675@AXL-UTIB00008 81-919557191825-PAYMENT FROM PHONE,0000919557191825,0.0,5845.0,3026.14
11/12/24,UPI,UPI-JURRU RAHUL YADAV-Q758292524@YBL-YE SB0YBLUPI-471218240399-UPI,0000471218240399,0.0,400.0,2626.14
11/12/24,UPI,UPI-LIBERTYSRIHARIOKICIC-LIBERTYSRIHARI@ OKICICI-BKID0008627-471216752912-UPI,0000471216752912,0.0,650.0,1976.14
11/12/24,UPI,UPI-KURINDULA RAJASHEKAR-9966883802-4@YB L-HDFC0000218-003047401518-PAYMENT FROM PHONE,0000003047401518,2400.0,0.0,4376.14
11/12/24,UPI,UPI-JIO THIRUPA-THIRUPATI1981NA IK-1@OKSBI-SBIN0021009-513009116836-UPI,0000373010248319,0.0,19.0,4357.14
11/12/24,UPI,UPI-JONNA KANTI SRIKANTH-PAYTMQR28100505 01011BHTBXXSE9UQ@PAYTM-YESB0PTMUPI-43461 1661900-UPI,0000434611661900,0.0,130.0,4227.14
12/12/24,UPI,UPI-ANGEL ONE LIMITED-ANGELONENSE@ICICI- ICIC0DC0099-471393159060-PAYINGANGELONE,0000471393159060,0.0,3150.0,1077.14
12/12/24,UPI,UPI-SUDHA JAISWAL-OMSUDHAJ@AXL-HDFC00042 16-617390857461-PAYMENT FROM PHONE,0000617390857461,1260.0,0.0,2337.14
12/12/24,UPI,UPI-AIRTEL RECHARGE-AIRTELPREDIRECT1@YBL -YESB0YBLUPI-540538247370-PAYMENT FROM P HONE,0000540538247370,0.0,302.0,2035.14
12/12/24,UPI,UPI-M ANIL YADAV-ANILYADAV63473-1@OKSBI- UBIN0803219-434798371744-UPI,0000434798371744,0.0,600.0,1435.14
12/12/24,UPI,UPI-KOPPARTHI RAJESH-KOPPARTHIRAJESH991@ IBL-ICIC0001313-580970740009-PAYMENT FRO M PHONE,0000580970740009,520.0,0.0,1955.14
12/12/24,UPI,UPI-MOHD AHMED ALI-AQUA.AHMED98@AXL-UTIB 0001808-066296347521-PAYMENT FROM PHONE,0000066296347521,270.0,0.0,2225.14
12/12/24,UPI,UPI-SRI MAHANKALI WINE M-Q742769210@YBL- YESB0YBLUPI-434767700130-UPI,0000434767700130,0.0,180.0,2045.14
12/12/24,UPI,UPI-LIBERTYSRIHARIOKICIC-LIBERTYSRIHARI@ OKICICI-BKID0008627-434758502846-UPI,0000434758502846,0.0,650.0,1395.14
12/12/24,UPI,UPI-JIO OKICICI-BKID0008627-513043279009-UPI,0000703735154936,0.0,19.0,1376.14
13/12/24,UPI,UPI-NAGRAJ-MUKKERLANAGRAJ@OKHDFCBANK-UBI N0803219-434822194915-UPI,0000434822194915,5000.0,0.0,6376.14
13/12/24,UPI,UPI-GEETA BAMNAY-BAMNAYRAM@OKHDFCBANK-IB KL0000594-434870004920-UPI,0000434870004920,0.0,150.0,6226.14
13/12/24,UPI,UPI-BASHEER UDDIN KHAN-BASHEERUDDINKHAN@ OKICICI-IBKL0000594-434838332808-UPI,0000434838332808,11250.0,0.0,17476.14
13/12/24,UPI,UPI-M ANIL YADAV-ANILYADAV63473-1@OKSBI- UBIN0803219-434834835056-UPI,0000434834835056,0.0,1500.0,15976.14
13/12/24,UPI,UPI-ARUKALA ANUSHA-BHARATPE.9R0O0M7U3V33 4996@FBPE-FDRL0001382-471498425179-PAY T O BHARATPE ME,0000471498425179,0.0,120.0,15856.14
13/12/24,UPI,UPI-KADTHLA SAI RAM-KSAIRAM805@OKSBI-SB IN0020083-434813218838-UPI,0000434813218838,0.0,350.0,15506.14
13/12/24,UPI,UPI-LIBERTYSRIHARIOKICIC-LIBERTYSRIHARI@ OKICICI-BKID0008627-471498954803-UPI,0000471498954803,0.0,650.0,14856.14
14/12/24,UPI,UPI-JURRU RAHUL YADAV-Q758292524@YBL-YE SB0YBLUPI-434988868202-UPI,0000434988868202,0.0,360.0,14496.14
14/12/24,UPI,UPI-SITHALA SATHIBABU-Q855384536@YBL-YE SB0YBLUPI-471599566142-UPI,0000471599566142,0.0,40.0,14456.14
14/12/24,UPI,UPI-MANE NAVNEETHA-PAYTMQR5X7M3L@PTYS-YE SB0PTMUPI-471517261866-UPI,0000471517261866,0.0,30.0,14426.14
14/12/24,UPI,UPI-KACHIGUDA ROA D,0000434939982604,0.0,103.0,14323.14
14/12/24,UPI,UPI-SUPRABATH TIFFINS-PAYTMQR5CYPRP@PTYS -YESB0PTMUPI-434994479378-UPI,0000434994479378,0.0,12.0,14311.14
14/12/24,UPI,UPI-MOHD AHMED ALI-AQUA.AHMED98@YBL-UTIB 0001808-788692219503-PAYMENT FROM PHONE,0000788692219503,180.0,0.0,14491.14
14/12/24,UPI,UPI-SRI MAHANKALI WINE M-Q742769210@YBL- YESB0YBLUPI-434990891573-UPI,0000434990891573,0.0,350.0,14141.14
14/12/24,UPI,UPI-M MADHU YADAV-M.MADHUYADAV261@YBL-KK BK0007463-331326613716-PAYMENT FROM PHON E,0000331326613716,0.0,500.0,13641.14
14/12/24,UPI,UPI-LIBERTYSRIHARIOKICIC-LIBERTYSRIHARI@ OKICICI-BKID0008627-471517902797-UPI,0000471517902797,0.0,650.0,12991.14
15/12/24,UPI,UPI-MOHD SHAFEEQ HUSSAIN-PAYTMQR60NZD6@P TYS-YESB0PTMUPI-471624818038-UPI,0000471624818038,0.0,50.0,12941.14
15/12/24,,ACH D- LIC OF INDIA-6577926591224,0000008031088350,0.0,2488.0,10453.14
15/12/24,UPI,UPI-DAMODAR NAYAK-PAYTMQR3WBWCQEK4N@PAYT M-YESB0PTMUPI-435042314748-UPI,0000435042314748,0.0,200.0,10253.14
15/12/24,UPI,UPI-MAADEVI-Q552508687@YBL-YESB0YBLUPI-4 35004313783-UPI,0000435004313783,0.0,160.0,10093.14
15/12/24,UPI,UPI-NAGESHWARI BODA-Q154393933@YBL-YESB0 YBLUPI-435018520910-UPI,0000435018520910,0.0,40.0,10053.14
15/12/24,UPI,UPI-SRI BALAJI BAKERY-PAYTMQR5C8BEV@PTYS -YESB0PTMUPI-471694422774-UPI,0000471694422774,0.0,170.0,9883.14
15/12/24,UPI,UPI-SRI BALAJI,0000435025823884,0.0,170.0,9713.14
15/12/24,UPI,UPI-PUNJAB WINES-Q837805642@YBL-YESB0YBL UPI-435070336824-UPI,0000435070336824,0.0,350.0,9363.14
15/12/24,UPI,UPI-KACHIGUDA BAKERS-GPAY-11244361928@OK BIZAXIS-UTIB0000553-435074542403-UPI,0000435074542403,0.0,100.0,9263.14
15/12/24,UPI,UPI-SRIRAGHAVENDRATIFFIN-PAYTMQR17U07CIZ 21@PAYTM-YESB0PTMUPI-471651945435-UPI,0000471651945435,0.0,20.0,9243.14
15/12/24,UPI,UPI-MR DIGLESHA VINODKU-Q361656464@YBL- YESB0YBLUPI-435053453871-UPI,0000435053453871,0.0,470.0,8773.14
15/12/24,UPI,UPI-P VINOD KUMAR-Q801724639@YBL-YESB0YB LUPI-471694263510-UPI,0000471694263510,0.0,250.0,8523.14
16/12/24,UPI,UPI-LIBERTYSRIHARIOKICIC-LIBERTYSRIHARI@ OKICICI-BKID0008627-471747672808-UPI,0000471747672808,0.0,1300.0,7223.14
16/12/24,UPI,UPI-MANE NAVNEETHA-PAYTMQR5X7M3L@PTYS-YE SB0PTMUPI-471754056190-UPI,0000471754056190,0.0,60.0,7163.14
16/12/24,,FT- 1547910202-57500000389159 - INDIAN C LEARING CORPORATION LIMITED -,0000000876286232,5805.7,0.0,12968.84
16/12/24,,FT- 1547910200-57500000389159 - INDIAN C LEARING CORPORATION LIMITED -,0000000876283993,1129.95,0.0,14098.79
16/12/24,UPI,UPI-INDARAPU ANIL-9849006243@YBL-SBIN00 20144-896073184243-PAYMENT FROM PHONE,0000896073184243,24432.0,0.0,38530.79
16/12/24,,NWD-416021XXXXXX2657-00916173-HYDERABAD,0000435116018288,0.0,2000.0,36530.79
16/12/24,UPI,UPI-SHAIK HISAMUDDIN-9703298957@YBL-SBI N0020471-030953814256-PAYMENT FROM PHONE,0000030953814256,0.0,16410.0,20120.79
16/12/24,UPI,UPI-NAYAKOTI SHEKAR-MAHESH.SHEKER09-1@OK AXIS-TSAB0000103-435172117065-UPI 008627-618457488094-PAYMENT FROM PHONE,0000435172117065,0.0,500.0,19620.79
16/12/24,UPI,UPI-M ARVIND-ARVINDYADAV69552@OKAXIS-K KBK0007473-471794904742-UPI,0000471794904742,0.0,500.0,19120.79
16/12/24,UPI,UPI-PAKANATI NITISH-NITISHPAKANATI125@OK SBI-PUNB0363200-471756197687-UPI,0000471756197687,0.0,3000.0,16120.79
16/12/24,UPI,UPI-NALLAMOTHU GEETHIKA-8897116606@YBL-A NDB0001550-739125313360-PAYMENT FROM PHO NE,0000739125313360,20000.0,0.0,36120.79
16/12/24,UPI,UPI-TINKUPRADEEP1986OKIC-TINKUPRADEEP198 6@OKICICI-IBKL0000594-471725408838-UPI,0000471725408838,0.0,3000.0,33120.79
16/12/24,UPI,UPI-JIO RECHARGE-JIOINAPPDIRECT1@YBL-YES B0YBLUPI-652554535545-PAYMENT FROM PHONE,0000652554535545,0.0,19.0,33101.79
17/12/24,UPI,UPI-JURRU RAHUL YADAV-Q758292524@YBL-YE SB0YBLUPI-471897527937-UPI,0000471897527937,0.0,380.0,32721.79
17/12/24,UPI,UPI-M MOUNIKA-PAYTM.S15D6Y1@PTY-YESB0MCH UPI-471872823354-UPI,0000471872823354,0.0,105.0,32616.79
17/12/24,UPI,UPI-MAROTU POLIPALLI-BHARATPE.9007186230 2@FBPE-FDRL0001382-435292739107-PAY TO B HARATPE ME,0000435292739107,0.0,100.0,32516.79
17/12/24,,ATW-416021XXXXXX2657-P3ENTS55-HYDERABAD,0000000000002385,0.0,2000.0,30516.79
17/12/24,UPI,UPI-MOHD AHMED ALI-AQUA.AHMED98@YBL-UTIB 0001808-780099888573-PAYMENT FROM PHONE,0000780099888573,270.0,0.0,30786.79
17/12/24,UPI,UPI-NAYAKOTI SHEKAR-MAHESH.SHEKER09-1@OK AXIS-TSAB0000103-471829860564-UPI L-HDFC0001635-372916194084-PAYMENT FROM PHONE,0000471829860564,0.0,900.0,29886.79
18/12/24,UPI,UPI-JURRU RAHUL YADAV-Q758292524@YBL-YE SB0YBLUPI-471920174140-UPI,0000471920174140,0.0,700.0,29186.79
18/12/24,UPI,UPI-OMBKAADZ175965XDIU79-OMBK.AADZ175965 XDIU79YRP@MBK-PPIW0881822-435311686867-U PI,0000435311686867,0.0,25.0,29161.79
18/12/24,UPI,UPI-M ANIL YADAV-ANILYADAV63473-1@OKSBI- UBIN0803219-435343571844-UPI,0000435343571844,0.0,600.0,28561.79
18/12/24,UPI,UPI-LIBERTYSRIHARIOKICIC-LIBERTYSRIHARI@ OKICICI-BKID0008627-471990480384-UPI,0000471990480384,0.0,1300.0,27261.79
18/12/24,UPI,UPI-MR VIKAS DAYAMA-Q819158497@YBL-YES B0YBLUPI-435306981925-UPI,0000435306981925,0.0,9.0,27252.79
18/12/24,UPI,UPI-PHONEPE-BBPSBP@YBL-YESB0YBLUPI-07105 6852691-PAYMENT FROM PHONE,0000071056852691,0.0,855.0,26397.79
18/12/24,UPI,UPI-BHARATHI BHARATHI-BHARTHI9573@YBL-S BIN0020701-435323494141-UPI,0000435323494141,0.0,6000.0,20397.79
18/12/24,UPI,UPI-DEEP SHIKHA GUPTA-AKG03071965@OKSBI- BARB0HIMHYD-471980286989-UPI,0000471980286989,0.0,1450.0,18947.79
18/12/24,UPI,UPI-KOUR H-HARDEEPKOUR24@OKSBI-HSBC05000 02-435314900137-UPI,0000435314900137,495.0,0.0,19442.79
18/12/24,UPI,UPI-SRI MAHANKALI WINE M-Q742769210@YBL- YESB0YBLUPI-435352018382-UPI,0000435352018382,0.0,170.0,19272.79
18/12/24,UPI,UPI-MRS SAILAJA MAIDEN K-SAILU1697@OKICI CI-MAHB0001319-435332522790-UPI,0000435332522790,56000.0,0.0,75272.79
18/12/24,UPI,UPI-SHAIK HISAMUDDIN-9703298957@YBL-SBI N0020471-177589954786-PAYMENT FROM PHONE,0000177589954786,0.0,50000.0,25272.79
19/12/24,UPI,UPI-JURRU RAHUL YADAV-Q758292524@YBL-YE SB0YBLUPI-472098133365-UPI DSCNB A/C-MUKKERLA MADHU YADAV-YESBN1202 736353 5051500736353,0000472098133365,0.0,140.0,25132.79
19/12/24,UPI,UPI-MANE NAVNEETHA-PAYTMQR5X7M3L@PTYS-YE SB0PTMUPI-435440824421-UPI,0000435440824421,0.0,30.0,25102.79
19/12/24,UPI,UPI-RAPARTI SRIHARI-9493207195@YBL-BKID0 008627-955359678215-PAYMENT FROM PHONE,0000955359678215,0.0,13000.0,12102.79
19/12/24,UPI,UPI-SHAMA AKBAR SHAIKH-7498982036@AXL-SB IN0012480-435488839100-UPI,0000435488839100,0.0,350.0,11752.79
19/12/24,UPI,UPI-LIBERTYSRIHARIOKICIC-LIBERTYSRIHARI@ OKICICI-BKID0008627-472025759073-UPI,0000472025759073,0.0,4550.0,7202.79
19/12/24,UPI,UPI-SRI BALAJI BAKERY-PAYTMQR5C8BEV@PTYS -YESB0PTMUPI-435462140831-UPI,0000435462140831,0.0,10.0,7192.79
19/12/24,UPI,UPI-JURRU RAHUL YADAV-Q758292524@YBL-YE SB0YBLUPI-472018664637-UPI,0000472018664637,0.0,25.0,7167.79
19/12/24,UPI,UPI-MUKKERLA RAJESH YADA-MRYADAV3235@OKA XIS-KKBK0007473-472030674961-UPI,0000472030674961,80.0,0.0,7247.79
19/12/24,UPI,UPI-SRI BALAJI WINES-PAYTMQR11PZPHQ2DI@P AYTM-YESB0PTMUPI-472059775912-UPI,0000472059775912,0.0,170.0,7077.79
19/12/24,UPI,UPI-RAPARTI SRIHARI-LIBERTYSRIHARI@OKAXI S-BKID0008627-472076878730-DAILY 650 IN TO 10,0000472076878730,50000.0,0.0,57077.79
19/12/24,UPI,UPI-PADMA RAPOTHU-9705830887@AXL-SBIN00 20083-523290476166-PAYMENT FROM PHONE,0000523290476166,0.0,20000.0,37077.79
19/12/24,UPI,UPI-ANGEL ONE LIMITED-ANGELONENSE@ICICI- ICIC0DC0099-472081567783-PAYINGANGELONE,0000472081567783,0.0,17000.0,20077.79
20/12/24,UPI,UPI-JURRU RAHUL BPE-FDRL0001382-513530915838-PAY TO BHAR ATPE ME,0000472147390749,0.0,140.0,19937.79
20/12/24,UPI,UPI-GANESH SUNKARI-PAYTMQR5VWCHN@PTYS-YE SB0PTMUPI-472104478527-UPI,0000472104478527,0.0,150.0,19787.79
20/12/24,UPI,UPI-MOHD FAREED-PAYTMQR60LAHS@PTYS-YESB0 PTMUPI-435512071013-UPI,0000435512071013,0.0,20.0,19767.79
20/12/24,UPI,UPI-MR G SATISH-PAYTMQR5591SC@PAYTM-YESB 0PTMUPI-472199488073-UPI,0000472199488073,0.0,50.0,19717.79
20/12/24,UPI,UPI-MOHD ABDUL WASEEM-BHARATPE907254462 25@YESBANKLTD-YESB0YESUPI-435597591225-P AY TO MOHD ABDUL,0000435597591225,0.0,30.0,19687.79
20/12/24,UPI,UPI-MANE NAVNEETHA-PAYTMQR5X7M3L@PTYS-YE SB0PTMUPI-472132488232-UPI,0000472132488232,0.0,30.0,19657.79
20/12/24,UPI,UPI-ANGEL ONE LIMITED-ANGELONENSE@ICICI- ICIC0DC0099-472122693792-PAYINGANGELONE,0000472122693792,0.0,10000.0,9657.79
20/12/24,UPI,UPI-ANGEL ONE LIMITED-ANGELONENSE@ICICI- ICIC0DC0099-472158503091-PAYINGANGELONE,0000472158503091,0.0,2000.0,7657.79
20/12/24,UPI,UPI-ANGEL ONE LIMITED-ANGELONENSE@ICICI- ICIC0DC0099-472162397975-PAYINGANGELONE,0000472162397975,0.0,7000.0,657.79
20/12/24,UPI,UPI-LIBERTYSRIHARIOKICIC-LIBERTYSRIHARI@ OKICICI-BKID0008627-472110220573-UPI,0000472110220573,0.0,650.0,7.79
21/12/24,UPI,UPI-LAKSHMI APPALA-LAKSHME1202@OKAXIS-S BIN0005895-472289798878-UPI,0000472289798878,1500.0,0.0,1507.79
21/12/24,UPI,UPI-VENKATESWARLU V-9948667757VENKAT@YBL -HSBC0500002-719823299955-PAYMENT FROM P HONE,0000719823299955,10000.0,0.0,11507.79
21/12/24,UPI,UPI-MOHD AHMED ALI-AQUA.AHMED98@AXL-UTIB 0001808-017591262809-PAYMENT FROM PHONE,0000017591262809,360.0,0.0,11867.79
21/12/24,UPI,UPI-GORIPARTHI KRISHNA S-8886599778@AXL- COSB0000069-335785162031-PAYMENT FROM PH ONE,0000335785162031,3000.0,0.0,14867.79
21/12/24,UPI,UPI-LIBERTYSRIHARIOKICIC-LIBERTYSRIHARI@ OKICICI-BKID0008627-435699488309-UPI,0000435699488309,0.0,650.0,14217.79
22/12/24,UPI,UPI-JURRU RAHUL YADAV-Q758292524@YBL-YE SB0YBLUPI-472396004263-UPI,0000472396004263,0.0,240.0,13977.79
22/12/24,UPI,UPI-MUNTHA RAMESH YADAV-RAMEESHM6666@YBL -BKID0008604-429403029297-PAYMENT FROM P HONE,0000429403029297,0.0,8000.0,5977.79
22/12/24,UPI,UPI-MURALIKRISHNA VEGETA-GPAY-1124438713 1@OKBIZAXIS-UTIB0000553-435791790299-UPI,0000435791790299,0.0,200.0,5777.79
22/12/24,UPI,UPI-DAMODAR NAYAK-PAYTMQR3WBWCQEK4N@PAYT M-YESB0PTMUPI-435747089430-UPI,0000435747089430,0.0,30.0,5747.79
22/12/24,UPI,UPI-PANDRI KRISHNAVENI-BHARATPE09914465 228@YESBANKLTD-YESB0YESUPI-435781303664- PAY TO PANDRI KRI,0000435781303664,0.0,50.0,5697.79
22/12/24,UPI,UPI-LIBERTYSRIHARIOKICIC-LIBERTYSRIHARI@ OKICICI-BKID0008627-472302013525-UPI,0000472302013525,0.0,650.0,5047.79
22/12/24,UPI,UPI-BHARGAVI BUDUMURU-6303219486@YBL-SB,0000469772388495,1500.0,0.0,6547.79
22/12/24,UPI,UPI-BHAGWAN DAS MARDA-7816018341@AXL-KVB L0001443-708991630305-PAYMENT FROM PHONE,0000708991630305,1000.0,0.0,7547.79
22/12/24,UPI,UPI-DUDIKIKAR SHAILAJA-8367261624@AXL- KKBK0007472-645355072019-PAYMENT FROM PH ONE,0000645355072019,600.0,0.0,8147.79
22/12/24,UPI,UPI-SASHIKALA BHANDARI-9032117972@AXL-S BIN0005895-031788635394-PAYMENT FROM PHO NE,0000031788635394,1000.0,0.0,9147.79
22/12/24,UPI,UPI-AKSHAY CHINTALA-9849868607@AXISB-CNR B0000033-472323397344-PAID VIA CRED AND,0000472323397344,1000.0,0.0,10147.79
22/12/24,UPI,UPI-MAHAVIR SETHI-9392489604@AXL-SBIN00 05895-914577533189-PAYMENT FROM PHONE,0000914577533189,1000.0,0.0,11147.79
22/12/24,UPI,UPI-GANTA SUJATHA-SUJATHAGANAT13@OKSBI- SBIN0005895-435708061704-UPI,0000435708061704,1050.0,0.0,12197.79
23/12/24,UPI,UPI-JURRU RAHUL YADAV-Q758292524@YBL-YE SB0YBLUPI-472422339502-UPI,0000472422339502,0.0,150.0,12047.79
23/12/24,UPI,UPI-RAPARTI SRIHARI-9493207195@YBL-BKID0 008627-826901545594-PAYMENT FROM PHONE,0000826901545594,0.0,10000.0,2047.79
23/12/24,UPI,UPI-RAPARTI SRIHARI-LIBERTYSRIHARI@OKSBI -BKID0008627-435838131773-DAILY 1300 IN TO 1,0000435838131773,50000.0,0.0,52047.79
23/12/24,UPI,UPI-ANGEL ONE LIMITED-ANGELONENSE@ICICI- ICIC0DC0099-472456959454-PAYINGANGELONE,0000472456959454,0.0,12000.0,40047.79
23/12/24,UPI,UPI-DADIGA SHIVA N0021100-513905706389-UPI,0000472430856849,0.0,900.0,39147.79
23/12/24,IMPS,IMPS-435813334997-SRIDEVI JT1-ICIC-XXXXX XXX3198-CASH,0000435813334997,0.0,14000.0,25147.79
23/12/24,IMPS,IMPS-435816047307-PERFIOS SOFTWARE SOL-I DFB-XXXXXXX9432-INDIAINFOLINELIMITEDBANK ACCOUNTVALIDATION,0000435816047307,1.0,0.0,25148.79
23/12/24,UPI,UPI-SWISSCASTLEBAKERY NA-VYAPAR.17198633 3553@HDFCBANK-HDFC0000001-435807778179-U PI,0000435807778179,0.0,184.0,24964.79
23/12/24,UPI,UPI-KEERTHI NEELI-SAI.TAANYA26@OKAXIS-BA RB0BARKAT-472459248524-UPI,0000472459248524,1000.0,0.0,25964.79
23/12/24,UPI,UPI-LIBERTYSRIHARIOKICIC-LIBERTYSRIHARI@ OKICICI-BKID0008627-472490591093-UPI,0000472490591093,0.0,1300.0,24664.79
23/12/24,UPI,UPI-B RAJESHWARI-RAJESHWARIYADAV147-1@OK HDFCBANK-SBIN0RRDCGB-472429581197-UPI,0000472429581197,0.0,8680.0,15984.79
24/12/24,UPI,UPI-JURRU RAHUL YADAV-Q758292524@YBL-YE SB0YBLUPI-472555402124-UPI,0000472555402124,0.0,150.0,15834.79
24/12/24,UPI,UPI-TIRIVISETTY SATYANA-SATHISHREDDY648 61@AXL-SBIN0002731-435945606176-UPI,0000435945606176,0.0,40.0,15794.79
24/12/24,UPI,UPI-MANE NAVNEETHA-PAYTMQR5C8BFC@PTYS-YE SB0PTMUPI-472542805973-UPI,0000472542805973,0.0,40.0,15754.79
24/12/24,UPI,UPI-ILLA SRI VENKATA MAN-8341044239@YBL- PUNB0109310-529645620560-PAYMENT FROM PH ONE,0000529645620560,0.0,920.0,14834.79
24/12/24,UPI,UPI-XXXXXX2248-ESFB0001001-435907314930- S-YESB0PTMUPI-514064677553-UPI,0000435907314930,0.0,5000.0,9834.79
24/12/24,UPI,UPI-LIBERTYSRIHARIOKICIC-LIBERTYSRIHARI@ OKICICI-BKID0008627-435946320193-UPI,0000435946320193,0.0,1300.0,8534.79
24/12/24,UPI,UPI-MOHD AHMED ALI-AQUA.AHMED98@AXL-UTIB 0001808-211071622167-PAYMENT FROM PHONE,0000211071622167,270.0,0.0,8804.79
24/12/24,UPI,UPI-G PRASHANTH-PRASHANTH.GHANKOT07@OKHD FCBANK-UTIB0000881-435971566834-UPI,0000435971566834,15000.0,0.0,23804.79
24/12/24,NEFT,NEFT CR-ICIC0099999-ANGEL ONE LIMITED CL IENT AC-MUKKERLA MADHU YADAV-CMS47497969,000CMS4749796914,15000.0,0.0,38804.79
25/12/24,UPI,UPI-M MADHU YADAV-M.MADHUYADAV261@YBL-KK BK0007463-435246241299-PAYMENT FROM PHON E,0000435246241299,0.0,25000.0,13804.79
25/12/24,UPI,UPI-JURRU RAHUL YADAV-Q758292524@YBL-YE SB0YBLUPI-436066248531-UPI,0000436066248531,0.0,230.0,13574.79
25/12/24,UPI,UPI-PHONEPE-BBPSBP@YBL-YESB0YBLUPI-37570 3830164-PAYMENT FROM PHONE,0000375703830164,0.0,6598.13,6976.66
25/12/24,UPI,UPI-KYASA SAI KRISHNA-PAYTMQR28100505010 11DPPZQD85UCX@PAYTM-YESB0PTMUPI-43605785 8861-UPI,0000436057858861,0.0,300.0,6676.66
25/12/24,UPI,UPI-MAYURA TEA STALL-GPAY-11251363572@OK BIZAXIS-UTIB0000553-436097254313-UPI,0000436097254313,0.0,20.0,6656.66
25/12/24,UPI,UPI-SRI VASAVI KIRANA AN-Q040455526@YBL- YESB0YBLUPI-436089559909-UPI,0000436089559909,0.0,250.0,6406.66
25/12/24,UPI,UPI-ARUKALA ANUSHA-BHARATPE.9R0O0M7U3V33,0000472626272450,0.0,120.0,6286.66
25/12/24,IMPS,IMPS-436026107984-SHADVAL PAY PRIVATE LI MITED-RATN-XXXXXXXX1978-BILL,0000436026107984,20000.0,0.0,26286.66
25/12/24,UPI,UPI-LIBERTYSRIHARIOKICIC-LIBERTYSRIHARI@ OKICICI-BKID0008627-436036286446-UPI,0000436036286446,0.0,1300.0,24986.66
25/12/24,UPI,UPI-NAYAKOTI SHEKAR-MAHESH.SHEKER09-1@OK AXIS-TSAB0000103-436056785119-UPI,0000436056785119,0.0,600.0,24386.66
25/12/24,UPI,UPI-RAJA IOCL RELIABLE -Q295257084@YBL- YESB0YBLUPI-472605482647-UPI,0000472605482647,0.0,350.0,24036.66
26/12/24,UPI,UPI-JURRU RAHUL YADAV-Q758292524@YBL-YE SB0YBLUPI-436108403333-UPI,0000436108403333,0.0,150.0,23886.66
26/12/24,UPI,UPI-GANTA SUJATHA-SUJATHAGANAT13@OKHDFC BANK-SBIN0005895-436146996087-UPI,0000436146996087,0.0,10000.0,13886.66
26/12/24,UPI,UPI-ANGEL ONE LIMITED-ANGELONENSE@ICICI- ICIC0DC0099-436131397957-PAYINGANGELONE,0000436131397957,0.0,5000.0,8886.66
26/12/24,UPI,UPI-ANGEL ONE LIMITED-ANGELONENSE@ICICI- ICIC0DC0099-436151607112-PAYINGANGELONE,0000436151607112,0.0,500.0,8386.66
26/12/24,UPI,UPI-ANGEL ONE LIMITED-ANGELONENSE@ICICI- ICIC0DC0099-436151499728-PAYINGANGELONE,0000436151499728,0.0,1000.0,7386.66
26/12/24,UPI,UPI-G PRASHANTH-7702920675@AXL-UTIB00008 81-492064099999-PAYMENT FROM PHONE,0000492064099999,50000.0,0.0,57386.66
26/12/24,UPI,UPI-MADIGELA MUKESH-MUKESHMADIGELA@OKSB I-SBIN0005895-472714018964-UPI,0000472714018964,0.0,1500.0,55886.66
26/12/24,UPI,UPI-MAHENDRA B0YBLUPI-550769863069-UPI,0000472732719188,0.0,32000.0,23886.66
26/12/24,UPI,UPI-MOHD AHMED ALI-AQUA.AHMED98@AXL-UTIB 0001808-304776139534-PAYMENT FROM PHONE,0000304776139534,180.0,0.0,24066.66
26/12/24,UPI,UPI-T SANJEEV SINGH-PAYTMQR5KDCNW@PTYS-Y ESB0PTMUPI-472757730541-UPI,0000472757730541,0.0,50.0,24016.66
26/12/24,UPI,UPI-LIBERTYSRIHARIOKICIC-LIBERTYSRIHARI@ OKICICI-BKID0008627-472783042529-UPI,0000472783042529,0.0,1300.0,22716.66
26/12/24,UPI,UPI-JIO RECHARGE-JIOINAPPDIRECT@YBL-YESB 0YBLUPI-159833755547-PAYMENT FROM PHONE,0000159833755547,0.0,19.0,22697.66
27/12/24,UPI,UPI-JURRU RAHUL YADAV-Q758292524@YBL-YE SB0YBLUPI-472819344572-UPI,0000472819344572,0.0,150.0,22547.66
27/12/24,UPI,UPI-TIRIVISETTY SATYANA-SATHISHREDDY648 61@AXL-SBIN0002731-472838843554-UPI,0000472838843554,0.0,40.0,22507.66
27/12/24,UPI,UPI-MOHD FAREED-PAYTMQR60LAHS@PTYS-YESB0 PTMUPI-472884758070-UPI,0000472884758070,0.0,20.0,22487.66
27/12/24,UPI,UPI-MEGHA PAN HOUSE-PAYTMQR5ER1LL@PTYS-Y ESB0PTMUPI-472868373821-UPI,0000472868373821,0.0,10.0,22477.66
27/12/24,UPI,UPI-JONNA KANTI SRIKANTH-PAYTMQR28100505 01011BHTBXXSE9UQ@PAYTM-YESB0PTMUPI-47288 4462538-UPI,0000472884462538,0.0,200.0,22277.66
27/12/24,UPI,UPI-NAYAKOTI SHEKAR-MAHESH.SHEKER09-1@OK AXIS-TSAB0000103-436252682728-UPI ALI-AQUA.AHMED98@AXL-UTIB 0001808-140427902424-PAYMENT FROM PHONE,0000436252682728,0.0,500.0,21777.66
27/12/24,UPI,UPI-LIBERTYSRIHARIOKICIC-LIBERTYSRIHARI@ OKICICI-BKID0008627-472855390084-UPI,0000472855390084,0.0,1300.0,20477.66
27/12/24,UPI,UPI-MR MADHU SUDHAN GHOD-MADHUSUDHANGHOD KE-2@OKHDFCBANK-MAHB0000383-436202665580 -UPI,0000436202665580,100.0,0.0,20577.66
27/12/24,UPI,UPI-SRI BALAJI WINES-PAYTMQR11PZPHQ2DI@P AYTM-YESB0PTMUPI-436275594660-UPI,0000436275594660,0.0,210.0,20367.66
27/12/24,UPI,UPI-M ANIL YADAV-ANILYADAV63473-1@OKSBI- UBIN0803219-472850499839-UPI,0000472850499839,0.0,600.0,19767.66
27/12/24,UPI,UPI-NAGRAJ-MUKKERLANAGRAJ@OKHDFCBANK-UBI N0803219-436260289266-UPI,0000436260289266,0.0,500.0,19267.66
27/12/24,UPI,UPI-MENDE MONMOHAN YADA-Q199398888@YBL- YESB0YBLUPI-436249290085-UPI,0000436249290085,0.0,40.0,19227.66
28/12/24,UPI,UPI-JURRU RAHUL YADAV-Q758292524@YBL-YE SB0YBLUPI-436385895793-UPI,0000436385895793,0.0,230.0,18997.66
28/12/24,UPI,UPI-BURRA AJAY-PAYTMQRISP9M8A22Y@PAYTM-Y ESB0PTMUPI-436388101521-UPI,0000436388101521,0.0,35.0,18962.66
28/12/24,UPI,UPI-MANE NAVNEETHA-PAYTMQR5X7M3L@PTYS-YE SB0PTMUPI-472993998674-UPI,0000472993998674,0.0,30.0,18932.66
28/12/24,UPI,UPI-GANTA SUJATHA-SUJATHAGANAT13@OKHDFC BANK-SBIN0005895-472973704121-UPI,0000472973704121,0.0,5000.0,13932.66
28/12/24,UPI,UPI-MUKKERLA GEETA SUDHA-GEETHAMUKKERLA- 1@OKAXIS-KKBK0007463-472973413548-UPI L-HDFC0001635-833305381456-PAYMENT FROM PHONE,0000472973413548,0.0,3000.0,10932.66
28/12/24,UPI,UPI-ARVIND IOCL PRANEETH-Q531683887@YBL- YESB0YBLUPI-436362227141-UPI,0000436362227141,0.0,150.0,10782.66
28/12/24,UPI,UPI-ARRALO RANI-8309617327@PTYES-FDRL000 1332-436304217069-UPI,0000436304217069,0.0,500.0,10282.66
28/12/24,UPI,UPI-M ANIL YADAV-ANILYADAV63473-1@OKHDFC BANK-UBIN0803219-436334929048-PEDDMA AMT,0000436334929048,50000.0,0.0,60282.66
28/12/24,UPI,UPI-ARVOG-ARVOG.ESBZ@KOTAK-KKBK0000958-4 36398130583-PAY,0000436398130583,0.0,10283.49,49999.17
28/12/24,UPI,UPI-K S CONSTRUCTIONS-ASHWINYADAV85-1@OK SBI-AUBL0002591-472976130161-UPI,0000472976130161,0.0,20000.0,29999.17
28/12/24,UPI,UPI-LIBERTYSRIHARIOKICIC-LIBERTYSRIHARI@ OKICICI-BKID0008627-436380636517-UPI,0000436380636517,0.0,1300.0,28699.17
28/12/24,UPI,UPI-MOHD AHMED ALI-AQUA.AHMED98@AXL-UTIB 0001808-331079371056-PAYMENT FROM PHONE,0000331079371056,180.0,0.0,28879.17
29/12/24,UPI,UPI-JURRU RAHUL YADAV-Q758292524@YBL-YE SB0YBLUPI-436435348256-UPI,0000436435348256,0.0,150.0,28729.17
29/12/24,UPI,UPI-M ANIL YADAV-ANILYADAV63473-1@OKHDFC BANK-UBIN0803219-436458202175-PEDMA AMT GIVING F,0000436458202175,50000.0,0.0,78729.17
29/12/24,UPI,UPI-K S CONSTRUCTIONS-ASHWINYADAV85-1@OK SBI-AUBL0002591-473027367619-UPI,0000473027367619,0.0,50000.0,28729.17
29/12/24,UPI,UPI-T JANAKI RAM-AKHIL.BUNTOO500@OKHDFCB ANK-UBIN0802018-473001949197-UPI,0000473001949197,0.0,300.0,28429.17
29/12/24,UPI,UPI-MANE NAVNEETHA-PAYTMQR5C8BFC@PTYS-YE,0000473021355354,0.0,30.0,28399.17
29/12/24,UPI,UPI-RAPARTI SRIHARI-9493207195@YBL-BKID0 008627-530808760706-PAYMENT FROM PHONE,0000530808760706,0.0,13000.0,15399.17
29/12/24,POS,CASH DEPOSIT-416021XXXXXX2657-BARKATPURA,0000000000000037,39000.0,0.0,54399.17
29/12/24,IMPS,IMPS-436412300088-MUKKERLA MADHU-SBIN-XX XXXXX5940-CASH,0000436412300088,0.0,30000.0,24399.17
29/12/24,UPI,UPI-PATA SHARAT BABU-Q812669223@YBL-YESB 0YBLUPI-473066269247-UPI,0000473066269247,0.0,95.0,24304.17
29/12/24,UPI,UPI-JIO RECHARGE-JIOINAPPDIRECT1@YBL-YES B0YBLUPI-669614355245-PAYMENT FROM PHONE,0000669614355245,0.0,19.0,24285.17
29/12/24,UPI,UPI-LIBERTYSRIHARIOKICIC-LIBERTYSRIHARI@ OKICICI-BKID0008627-436457601582-UPI,0000436457601582,0.0,1300.0,22985.17
30/12/24,,ZHDFCAY09JR01F/BILLDKRATNAKARBANKLI,0002436571769452,0.0,13353.0,9632.17
30/12/24,UPI,UPI-JURRU RAHUL YADAV-Q758292524@YBL-YE SB0YBLUPI-436569192629-UPI,0000436569192629,0.0,230.0,9402.17
30/12/24,UPI,UPI-TIRIVISETTY SATYANA-SATHISHREDDY648 61@AXL-SBIN0002731-473181394267-UPI,0000473181394267,0.0,70.0,9332.17
30/12/24,UPI,UPI-MURALIKRISHNA VEGETA-GPAY-1124438713 1@OKBIZAXIS-UTIB0000553-473130100432-UPI,0000473130100432,0.0,270.0,9062.17
30/12/24,UPI,UPI-GANESH AND SONS-PAYTM.D19185750057@P TY-YESB0MCHUPI-473114394033-UPI,0000473114394033,0.0,250.0,8812.17
30/12/24,UPI,UPI-AVULA DEEPIKA-9390042802-2@YBL-UTIB0 005151-683799609793-PAYMENT FROM PHONE,0000683799609793,1000.0,0.0,9812.17
30/12/24,IMPS,IMPS-436528106288-SHADVAL PAY PRIVATE LI MITED-RATN-XXXXXXXX1978-BILL,0000436528106288,9700.0,0.0,19512.17
30/12/24,POS,CASH DEPOSIT-416021XXXXXX2657-HYDERGUDA,0000000000008939,30000.0,0.0,49512.17
30/12/24,UPI,UPI-MARGAM VANI-9392657723@YBL-SBIN0021 100-015127717066-PAYMENT FROM PHONE,0000015127717066,0.0,40000.0,9512.17
30/12/24,UPI,UPI-LIBERTYSRIHARIOKICIC-LIBERTYSRIHARI@ OKICICI-BKID0008627-436584920957-UPI,0000436584920957,0.0,1300.0,8212.17
30/12/24,,ATW-416021XXXXXX2657-P3ENTS55-HYDERABAD,0000000000004625,0.0,1000.0,7212.17
30/12/24,IMPS,IMPS-436515778439-NAIDU SOFTWARE TECHNOL OGIE S PRIVATE LIMITED-YESB-XXXXXXXXXXX3 640-VENDOR PAYMENT,0000436515778439,120000.0,0.0,127212.17
30/12/24,UPI,UPI-K S CONSTRUCTIONS-9393995648-2@YBL-A UBL0002591-679847212413-PAYMENT FROM PHO NE,0000679847212413,22500.0,0.0,149712.17
30/12/24,NEFT,NEFT CR-YESB0000001-FINKURVE FINANCIAL S ERVICES LIMITED-M MADHU YADAV-YESCB43650,YESCB43650282870,17168.0,0.0,166880.17
30/12/24,UPI,UPI-K S CONSTRUCTIONS-9393995648-2@YBL-A UBL0002591-696401996117-TOTAL 144000 WIT H,0000696401996117,1500.0,0.0,168380.17
30/12/24,UPI,UPI-PHONEPE-BBPSBP@YBL-YESB0YBLUPI-32624 9418392-PAYMENT FROM PHONE,0000326249418392,0.0,5566.32,162813.85
30/12/24,UPI,UPI-ANGEL ONE LIMITED-ANGELONENSE@ICICI- ICIC0DC0099-436500638143-PAYINGANGELONE,0000436500638143,0.0,10000.0,152813.85
30/12/24,UPI,UPI-ZERODHA BROKING LTD-ZERODHABROKING@H DFCBANK-HDFC0000523-473115529645-0487788 701356106 Z 000572-866135609525-PAYMENT FROM PHONE,0000473115529645,0.0,5000.0,147813.85
30/12/24,UPI,UPI-SRI VINAYAKA ENTERPR-SUBBARAJU198900 @YBL-KKBK0007460-493871000581-PAYMENT FR OM PHONE,0000493871000581,0.0,20000.0,127813.85
30/12/24,,ZHDF5EP09N0I3S/BILLDKRATNAKARBANKLI,0002436571833201,0.0,6857.0,120956.85
30/12/24,UPI,UPI-JIO RECHARGE-JIOINAPPDIRECT1@YBL-YES B0YBLUPI-227701029142-PAYMENT FROM PHONE,0000227701029142,0.0,19.0,120937.85
31/12/24,UPI,UPI-JURRU RAHUL YADAV-Q758292524@YBL-YE SB0YBLUPI-473224851429-UPI,0000473224851429,0.0,150.0,120787.85
31/12/24,IMPS,IMPS-436607354707-M MADHU YADAV-KKBK-XXX XXX7813-CASH,0000436607354707,0.0,50000.0,70787.85
31/12/24,UPI,UPI-ZERODHA BROKING LTD-ZERODHABROKING@H DFCBANK-HDFC0000523-436626848873-9496709 857322755 Z,0000436626848873,0.0,10000.0,60787.85
31/12/24,UPI,UPI-ANGEL ONE LIMITED-ANGELONENSE@ICICI- ICIC0DC0099-473269268918-PAYINGANGELONE,0000473269268918,0.0,14000.0,46787.85
31/12/24,UPI,UPI-MUKKAMI ANAND-ANAND.MUKKAMI-1@OKSBI -SBIN0000952-436664618106-FLAT 403 SREE KRIS,0000436664618106,720.0,0.0,47507.85
31/12/24,UPI,UPI-CHITRA APPLARAJU-GPAY-11256411307@OK BIZAXIS-UTIB0000553-473220745232-UPI,0000473220745232,0.0,30.0,47477.85
31/12/24,UPI,UPI-MANE NAVNEETHA-PAYTMQR5C8BFC@PTYS-YE SB0PTMUPI-436674344914-UPI ESB0PTMUPI-551490877458-UPI,0000436674344914,0.0,30.0,47447.85
31/12/24,UPI,UPI-PUNY PALS HIGH SCHOO-PUNYPALSHIGHSCH OOLDORMA@ICICI-ICIC0DC0099-436661449555- UPI,0000436661449555,0.0,5717.0,41730.85
31/12/24,UPI,UPI-MANE NAVNEETHA-PAYTMQR5X7M3L@PTYS-YE SB0PTMUPI-436655164784-UPI,0000436655164784,0.0,30.0,41700.85
31/12/24,UPI,UPI-ZERODHA BROKING LTD-ZERODHABROKING@H DFCBANK-HDFC0000523-473212346237-8867071 774395528 Z,0000473212346237,0.0,5000.0,36700.85
31/12/24,UPI,UPI-ZERODHA BROKING LTD-ZERODHABROKING@H DFCBANK-HDFC0000523-436650969854-0062582 739848674 Z,0000436650969854,0.0,3200.0,33500.85
31/12/24,UPI,UPI-MWYN TECH PRIVATE LI-MWYNTECHPRIVATE 893267.RZP@RXAIRTEL-AIRP0000011-47327506 3714-MWYNTECHPRIVATELIM,0000473275063714,0.0,1166.02,32334.83
31/12/24,UPI,UPI-ANIL KUMAR BIRADAR-PAYTMQR5C9CFJ@PTY S-YESB0PTMUPI-436619465221-UPI,0000436619465221,0.0,1000.0,31334.83
31/12/24,UPI,UPI-ZERODHA BROKING LTD-ZERODHABROKING@H DFCBANK-HDFC0000523-473203063421-2383868 887016686 Z,0000473203063421,0.0,1100.0,30234.83
31/12/24,UPI,UPI-NEMALI KARUNAKAR-PAYTMQR60K40M@PTYS- YESB0PTMUPI-473221465091-UPI,0000473221465091,0.0,1400.0,28834.83
31/12/24,UPI,UPI-SREE BALAJI WINES-PAYTMQR6133UJ@PTYS -YESB0PTMUPI-473229873149-UPI NK-YESB0000016-514941840014-BRANCH PAYME NT,0000473229873149,0.0,170.0,28664.83
31/12/24,UPI,UPI-BASHEER UDDIN KHAN-BASHEERUDDINKHAN@ OKICICI-IBKL0000594-436617065355-UPI,0000436617065355,15000.0,0.0,43664.83
31/12/24,UPI,UPI-JEETTI NAGESHWAR-Q105885278@YBL-YES B0YBLUPI-473267773423-UPI,0000473267773423,0.0,50.0,43614.83
31/12/24,UPI,UPI-GOWTHAM TATIPAMULA-PAYTMQR61347H@PTY S-YESB0PTMUPI-473246278410-UPI,0000473246278410,0.0,40.0,43574.83
31/12/24,UPI,UPI-MOHD AHMED ALI-AQUA.AHMED98@AXL-UTIB 0001808-875099953728-PAYMENT FROM PHONE,0000875099953728,270.0,0.0,43844.83
31/12/24,UPI,UPI-LIBERTYSRIHARIOKICIC-LIBERTYSRIHARI@ OKICICI-BKID0008627-473214988047-UPI,0000473214988047,0.0,1300.0,42544.83
31/12/24,UPI,UPI-MARGAM VANI-VANIMARGAM510@OKAXIS-SB IN0021100-473266291815-UPI,0000473266291815,0.0,14000.0,28544.83
31/12/24,UPI,UPI-MALLESHJ528OKICICI-MALLESHJ528@OKICI CI-CNRB0000033-473226496032-UPI,0000473226496032,0.0,1500.0,27044.83
31/12/24,UPI,UPI-MR DIGLESHA VINODKU-Q629080500@YBL- YESB0YBLUPI-473286800695-UPI,0000473286800695,0.0,75.0,26969.83
31/12/24,UPI,UPI-NORTHERN ARC-NORTHERNARC495902.RZP@A XISBANK-UTIB0000100-383257853664-POWERED BY SMARTCO,0000383257853664,0.0,7134.54,19835.29
31/12/24,NEFT,NEFT CR-ICIC0099999-ANGEL ONE LIMITED CL IENT AC-MUKKERLA MADHU YADAV-ICIN2366037,ICIN236603707018,9666.04,0.0,29501.33
01/01/25,,INTEREST PAID TILL 31-DEC-2024,000000000000000,175.0,0.0,29676.33
01/01/25,UPI,UPI-JURRU RAHUL YADAV-Q758292524@YBL-YE SB0YBLUPI-500189205097-UPI YBLUPI-551617731987-UPI,0000500189205097,0.0,150.0,29526.33
01/01/25,UPI,UPI-ZERODHA BROKING LTD-ZERODHABROKING@H DFCBANK-HDFC0000523-536719510977-9662107 394501435 Z,0000536719510977,0.0,10000.0,19526.33
01/01/25,UPI,UPI-SHANTANU SUNIL MAHAJ-SHANTANUMAHAJAN 36@OKSBI-KKBK0000726-500124906695-JAN RE NT,0000500124906695,2575.0,0.0,22101.33
01/01/25,,ANGEL ONE LIMI-231891197,0000501019762580,333.96,0.0,22435.29
01/01/25,UPI,UPI-MUNTHA RAMESH YADAV-RAMEESHM6666@YBL -BKID0008604-685133615806-PAYMENT FROM P HONE,0000685133615806,0.0,4000.0,18435.29
01/01/25,UPI,UPI-MAHENDAR KUMAR BAHET-MAHENDAR.BAHETI @OKICICI-ICIC0000040-536701732553-DEC,0000536701732553,3000.0,0.0,21435.29
01/01/25,UPI,UPI-CHEERY IOCL PRANEETH-Q022347379@YBL- YESB0YBLUPI-500152245981-UPI,0000500152245981,0.0,350.0,21085.29
01/01/25,UPI,UPI-AIRTEL RECHARGE-AIRTELPREDIRECT2@YBL -YESB0YBLUPI-162717744622-PAYMENT FROM P HONE,0000162717744622,0.0,582.0,20503.29
01/01/25,UPI,UPI-MUKKERLA GEETA SUDHA-GEETHAMUKKERLA- 1@OKAXIS-KKBK0007463-536713734668-UPI,0000536713734668,0.0,5000.0,15503.29
01/01/25,UPI,UPI-LIBERTYSRIHARIOKICIC-LIBERTYSRIHARI@ OKICICI-BKID0008627-500199642377-UPI,0000500199642377,0.0,1300.0,14203.29
01/01/25,UPI,UPI-M MADHU YADAV-9985065404-2@YBL-SBIN 0006645-328876929335-PAYMENT FROM PHONE,0000328876929335,12500.0,0.0,26703.29
01/01/25,UPI,UPI-REDDY MALLIKARJUN C-PAYTMQR5XXMNP@PT YS-YESB0PTMUPI-536795561091-UPI,0000536795561091,0.0,60.0,26643.29
01/01/25,NEFT,NEFT CR-ICIC0099999-ANGEL ONE LIMITED CL IENT AC-MUKKERLA MADHU YADAV-ICIN2001048,ICIN200104882907,10000.0,0.0,36643.29
02/01/25,UPI,UPI-JURRU RAHUL YADAV-Q758292524@YBL-YE SB0YBLUPI-500224970453-UPI,0000500224970453,0.0,150.0,36493.29
02/01/25,UPI,UPI-SYEDA NASREEN SULTAN-AFREENSYEDA-1@O KICICI-ICIC0003867-536887770314-UPI,0000536887770314,2880.0,0.0,39373.29
02/01/25,UPI,UPI-BHAGWAN DAS MARDA-7816018341@AXL-KVB L0001443-976313360815-PAYMENT FROM PHONE,0000976313360815,305.0,0.0,39678.29
02/01/25,UPI,UPI-PANYAM MANJULA-MANJUPANYAM@OKSBI-SB IN0007641-500283348951-MILK BILL,0000500283348951,2500.0,0.0,42178.29
02/01/25,POS,CASH DEPOSIT-416021XXXXXX2657-BARKATPURA,0000000000001133,8000.0,0.0,50178.29
02/01/25,UPI,UPI-ANGEL ONE LIMITED-ANGELONENSE@ICICI- ICIC0DC0099-500259581035-PAYINGANGELONE,0000500259581035,0.0,1200.0,48978.29
02/01/25,,BAJAJFIN_BF-1286306_106917592,000000000000000,0.0,9101.0,39877.29
02/01/25,,BAJAJFIN_BF-1286306_106922792,000000000000000,0.0,9503.0,30374.29
02/01/25,UPI,UPI-MARGAM VANI-9392657723@YBL-SBIN0021 100-617052434246-PAYMENT FROM PHONE,0000617052434246,0.0,9000.0,21374.29
02/01/25,UPI,UPI-KREDITBEE-KREDITBEE.PAYMENTS22@ICICI -ICIC0DC0099-536832088580-UPI,0000536832088580,0.0,5951.0,15423.29
02/01/25,UPI,UPI-LIBERTYSRIHARIOKICIC-LIBERTYSRIHARI@ OKICICI-BKID0008627-500246186412-UPI,0000500246186412,0.0,1300.0,14123.29
02/01/25,UPI,UPI-LAKSHMI APPALA-LAKSHME1202@OKSBI-SB IN0005895-500206997902-UPI PHONE,0000500206997902,1000.0,0.0,15123.29
02/01/25,UPI,UPI-G PRASHANTH-7702920675@AXL-UTIB00008 81-683541020829-PAYMENT FROM PHONE,0000683541020829,20000.0,0.0,35123.29
02/01/25,UPI,UPI-JIO RECHARGE-JIOINAPPDIRECT@YBL-YESB 0YBLUPI-929999753887-PAYMENT FROM PHONE,0000929999753887,0.0,19.0,35104.29
02/01/25,UPI,UPI-LIQUILOANS-CF.LIQUILOANS@ICICI-ICIC0 DC0099-500211522826-UPI,0000500211522826,0.0,21485.29,13619.0
03/01/25,UPI,UPI-MADIGALANARESH123OKI-MADIGALANARESH1 23@OKICICI-KKBK0007463-500361733214-UPI,0000500361733214,0.0,162.0,13457.0
03/01/25,UPI,UPI-JURRU RAHUL YADAV-Q758292524@YBL-YE SB0YBLUPI-536919627340-UPI,0000536919627340,0.0,150.0,13307.0
03/01/25,UPI,UPI-MANE NAVNEETHA-PAYTMQR5X7M3L@PTYS-YE SB0PTMUPI-536992135052-UPI,0000536992135052,0.0,30.0,13277.0
03/01/25,UPI,UPI-MR VIKAS DAYAMA-Q819158497@YBL-YES B0YBLUPI-500323233801-UPI,0000500323233801,0.0,20.0,13257.0
03/01/25,UPI,UPI-PURUSHOTTAM ADHIKARI-PURUSHOTTAMADHI KARI1@AXL-HDFC0004757-370479012484-PAYME NT FROM PHONE,0000370479012484,3255.0,0.0,16512.0
03/01/25,UPI,UPI-M MADHU YADAV-9985065404-2@YBL-SBIN 0006645-521591274849-PAYMENT FROM PHONE,0000521591274849,8000.0,0.0,24512.0
03/01/25,UPI,UPI-DADIGA SHIVA KUMAR-DADIGASHIVA86@OK AXIS-SBIN0005895-536972931513-UPI,0000536972931513,0.0,200.0,24312.0
03/01/25,UPI,UPI-M MADHU YADAV-9985065404-2@YBL-SBIN 0006645-038086420225-PAYMENT FROM PHONE,0000038086420225,800.0,0.0,25112.0
03/01/25,UPI,UPI-AKSHAY CHINTALA-9849868607@AXISB-CNR B0000033-536970395979-PAID VIA CRED AND,0000536970395979,395.0,0.0,25507.0
03/01/25,UPI,UPI-SUHAS MADHUKAR H-HARDEEPKOUR24@OKICICI-HSBC050 0002-515345699190-UPI,0000500305705641,1980.0,0.0,27487.0
03/01/25,UPI,UPI-RITESH JAIN MUTHA-GREEVA.ELECTRICALS @OKAXIS-BARB0WARANG-500325777474-UPI,0000500325777474,3200.0,0.0,30687.0
03/01/25,UPI,UPI-BHARGAVI BUDUMURU-6303219486@YBL-SB IN0020784-813211337344-PAYMENT FROM PHON E,0000813211337344,670.0,0.0,31357.0
03/01/25,UPI,UPI-LIBERTYSRIHARIOKICIC-LIBERTYSRIHARI@ OKICICI-BKID0008627-500348449269-UPI,0000500348449269,0.0,1300.0,30057.0
03/01/25,UPI,UPI-RONAK NEELESH RUPARA-KUMARRONAK7@OKA XIS-HDFC0000545-500303195502-MILK BILL,0000500303195502,780.0,0.0,30837.0
03/01/25,NEFT,NEFT CR-YESB0000001-ZERODHA BROKING LTD- DSCNB A/C-MUKKERLA MADHU YADAV-YESF35003,YESF350033918023,5500.0,0.0,36337.0
03/01/25,UPI,UPI-DUDIKIKAR SHAILAJA-8367261624@AXL- KKBK0007472-195912958563-PAYMENT FROM PH ONE,0000195912958563,500.0,0.0,36837.0
03/01/25,UPI,UPI-MOHD AHMED ALI-AQUA.AHMED98@YBL-UTIB 0001808-428370977629-PAYMENT FROM PHONE,0000428370977629,270.0,0.0,37107.0
03/01/25,UPI,UPI-BHARATH SUKAWALA-PAYTMQR5WP8U9@PTYS- YESB0PTMUPI-500342087205-UPI,0000500342087205,0.0,205.0,36902.0
04/01/25,UPI,NEFT CR-YESB0000001-ZERODHA BROKING LTD- DSCNB A/C-MUKKERLA MADHU YADAV-YESF35004 B0YBLUPI-814290870462-PAYMENT FROM PHONE,YESF350043328507,172.47,0.0,37074.47
04/01/25,,ANGEL ONE LIMI-1041394267,0000501045884838,360.94,0.0,37435.41
04/01/25,UPI,UPI-JURRU RAHUL YADAV-Q758292524@YBL-YE SB0YBLUPI-537082878242-UPI,0000537082878242,0.0,150.0,37285.41
04/01/25,UPI,UPI-BILLA S-9700452204-2@YBL-HSBC0500002 -461630923898-PAYMENT FROM PHONE,0000461630923898,990.0,0.0,38275.41
04/01/25,UPI,UPI-MUKKERLA GEETA SUDHA-GEETHAMUKKERLA- 1@OKAXIS-KKBK0007463-537049877582-UPI,0000537049877582,0.0,1300.0,36975.41
04/01/25,UPI,UPI-MR MARYPEDDY YADAIAH-PAYTMQR1QEBB0LQ 0U@PAYTM-YESB0PTMUPI-498764604680-PAYMEN T FROM PHONE,0000498764604680,0.0,30.0,36945.41
04/01/25,UPI,UPI-GOGA ELECTRONICS-9849436607@AXL-APMC 0000006-388662008851-PAYMENT FROM PHONE,0000388662008851,1.0,0.0,36946.41
04/01/25,POS,CASH DEPOSIT-416021XXXXXX2657-HIMAYATNAG AR,0000000000007353,19300.0,0.0,56246.41
04/01/25,UPI,UPI-RAPARTI SRIHARI-9493207195@YBL-BKID0 008627-954694150524-PAYMENT FROM PHONE,0000954694150524,0.0,10000.0,46246.41
04/01/25,,ACH D- PROTIUM FINANCE LIMI-NIBMKJTIHKBA,0000002973548032,0.0,28475.0,17771.41
04/01/25,UPI,UPI-VIVRITI CAPITAL-VIVRITICAPITAL.ESBZ@ KOTAK-KKBK0000958-500498085995-PAY,0000500498085995,0.0,7539.0,10232.41
04/01/25,UPI,UPI-LIBERTYSRIHARIOKICIC-LIBERTYSRIHARI@ OKICICI-BKID0008627-500464101425-UPI,0000500464101425,0.0,1300.0,8932.41
04/01/25,UPI,UPI-MAHAVIR SETHI-9392489604@YBL-SBIN00 05895-940586525715-PAYMENT FROM PHONE,0000940586525715,1520.0,0.0,10452.41
04/01/25,,ATW-416021XXXXXX2657-P3ENTS55-HYDERABAD,0000000000005720,0.0,1500.0,8952.41
04/01/25,UPI,UPI-SASHIKALA BHANDARI-9032117972@AXL-S FROM PHONE,0000674066681040,1115.0,0.0,10067.41
04/01/25,UPI,UPI-M MADHU YADAV-M.MADHUYADAV261@YBL-KK BK0007463-962084449809-PAYMENT FROM PHON E,0000962084449809,0.0,8000.0,2067.41
04/01/25,UPI,UPI-SYED OMER ALI FAISAL-SYED.1876-9@WAH DFCBANK-KKBK0008351-500466056224-MIRCHI LIGHT GSK,0000500466056224,1500.0,0.0,3567.41
04/01/25,UPI,UPI-GOGA ELECTRONICS-9849436607@YBL-APMC 0000006-022644961969-PAYMENT FROM PHONE,0000022644961969,2000.0,0.0,5567.41
04/01/25,UPI,UPI-GOGA ELECTRONICS-9849436607@AXL-APMC 0000006-583583059263-PAYMENT FROM PHONE,0000583583059263,2000.0,0.0,7567.41
04/01/25,UPI,UPI-GOGA ELECTRONICS-9849436607@YBL-APMC 0000006-508256928997-PAYMENT FROM PHONE,0000508256928997,1040.0,0.0,8607.41
05/01/25,UPI,UPI-NARESH M-MADIGALANARESH123@OKICICI-K KBK0007463-157208489206-PAYMENT FROM PHO NE,0000157208489206,0.0,224.0,8383.41
05/01/25,UPI,UPI-JURRU RAHUL YADAV-Q758292524@YBL-YE SB0YBLUPI-644275415659-PAYMENT FROM PHON E,0000644275415659,0.0,150.0,8233.41
05/01/25,UPI,UPI-SHAIK RAZIA BEGUM-BHARATPE.900604871 52@FBPE-FDRL0001382-998600823805-PAY TO BHARATPE ME,0000998600823805,0.0,50.0,8183.41
05/01/25,UPI,UPI-DAMODAR NAYAK-PAYTMQR60NRMT@PTYS-YES DFC0MERUPI-552031749698-PAYINGANGELONE,0000705045268003,0.0,190.0,7993.41
05/01/25,UPI,UPI-DAMODAR NAYAK-PAYTMQR60NRMT@PTYS-YES B0PTMUPI-383910591811-PAYMENT FROM PHONE,0000383910591811,0.0,30.0,7963.41
05/01/25,UPI,UPI-M MADHU YADAV-M.MADHUYADAV261@YBL-KK BK0007463-075014507292-PAYMENT FROM PHON E,0000075014507292,0.0,7500.0,463.41
05/01/25,UPI,UPI-JIO RECHARGE-JIOINAPPDIRECT@YBL-YESB 0YBLUPI-412162349497-PAYMENT FROM PHONE,0000412162349497,0.0,19.0,444.41
05/01/25,UPI,UPI-M MADHU YADAV-M.MADHUYADAV261@YBL-KK BK0007463-241362863194-PAYMENT FROM PHON E,0000241362863194,30000.0,0.0,30444.41
05/01/25,,IB BILLPAY DR-HDFC92-434155XXXXXX1025,MB05212552674T39,0.0,10271.0,20173.41
05/01/25,UPI,UPI-ANGEL ONE LIMITED-ANGELONENSE@ICICI- ICIC0DC0099-537168884077-PAYINGANGELONE,0000537168884077,0.0,9000.0,11173.41
06/01/25,UPI,UPI-ANGEL ONE LIMITED-ANGELONENSE@ICICI- ICIC0DC0099-500639396861-PAYINGANGELONE,0000500639396861,0.0,5000.0,6173.41
06/01/25,UPI,UPI-ANGEL ONE LIMITED-ANGELONENSE@ICICI- ICIC0DC0099-500699505550-PAYINGANGELONE,0000500699505550,0.0,2000.0,4173.41
06/01/25,UPI,UPI-ANGEL ONE LIMITED-ANGELONENSE@ICICI- ICIC0DC0099-500672913055-PAYINGANGELONE,0000500672913055,0.0,1500.0,2673.41
06/01/25,UPI,UPI-SHAKTI KARAN SINGH-BHARATPE907279002 GHODKE-MADHUSUDHANGHOD KE@YBL-SBIN0005895-121703575867-PAYMENT FROM PHONE,0000500633331994,0.0,50.0,2623.41
06/01/25,UPI,UPI-MUTHYALA SRIKANTH-Q195519515@YBL-YE SB0YBLUPI-500650537989-UPI,0000500650537989,0.0,170.0,2453.41
06/01/25,UPI,UPI-NAGRAJ-MUKKERLANAGRAJ@OKHDFCBANK-UBI N0803219-500627045392-UPI,0000500627045392,0.0,800.0,1653.41
07/01/25,UPI,UPI-MADIGALANARESH123OKI-MADIGALANARESH1 23@OKICICI-KKBK0007463-537355740450-UPI,0000537355740450,0.0,189.0,1464.41
07/01/25,UPI,UPI-JURRU RAHUL YADAV-Q758292524@YBL-YE SB0YBLUPI-537347147447-UPI,0000537347147447,0.0,180.0,1284.41
07/01/25,UPI,UPI-TIRIVISETTY SATYANA-SATHISHREDDY648 61@AXL-SBIN0002731-537380344729-UPI,0000537380344729,0.0,30.0,1254.41
07/01/25,UPI,UPI-ANGEL ONE LIMITED-ANGELONENSE@ICICI- ICIC0DC0099-537316156709-PAYINGANGELONE,0000537316156709,0.0,1000.0,254.41
07/01/25,UPI,UPI-SUNIL POOJA-GPAY-11241787003@OKBIZAX IS-UTIB0000553-537376451866-UPI,0000537376451866,0.0,56.0,198.41
07/01/25,UPI,UPI-M MADHU YADAV-M.MADHUYADAV261@YBL-KK BK0007463-089507913932-PAYMENT FROM PHON E,0000089507913932,7500.0,0.0,7698.41
07/01/25,IMPS,IMPS-500713304292-KRAZYBEE SERVICES PVT LTD DISBURSEMENT-YESB-XXXXXXXXXXX0061-DI SBURSALKB250107ZCKKMG3E,0000500713304292,8444.0,0.0,16142.41
07/01/25,UPI,UPI-LIBERTYSRIHARIOKICIC-LIBERTYSRIHARI@ OKICICI-BKID0008627-500763484568-UPI,0000500763484568,0.0,1300.0,14842.41
07/01/25,UPI,UPI-SRI LAKSHMI NARASIMH-Q088461560@YBL- YESB0YBLUPI-500724889960-UPI LTD- DSCNB A/C-MUKKERLA MADHU YADAV-YESBN1202 788941 5060401788941,0000500724889960,0.0,500.0,14342.41
08/01/25,UPI,UPI-MADIGALANARESH123OKI-MADIGALANARESH1 23@OKICICI-KKBK0007463-537428291243-UPI,0000537428291243,0.0,216.0,14126.41
08/01/25,UPI,UPI-NAGRAJ-MUKKERLANAGRAJ@OKAXIS-UBIN080 3219-500859413607-UPI,0000500859413607,3000.0,0.0,17126.41
08/01/25,UPI,UPI-JURRU RAHUL YADAV-Q758292524@YBL-YE SB0YBLUPI-500837804056-UPI,0000500837804056,0.0,180.0,16946.41
08/01/25,UPI,UPI-M ARVIND RAJ-ARVINDRAJ57964-1@OKHDFC BANK-HDFC0000512-500830705460-UPI,0000500830705460,1650.0,0.0,18596.41
08/01/25,UPI,UPI-MANE NAVNEETHA-PAYTMQR5X7M3L@PTYS-YE SB0PTMUPI-500843102416-UPI,0000500843102416,0.0,30.0,18566.41
08/01/25,,ACH D- HERO FINCORP LTD-62405711,0000003190448240,0.0,10855.0,7711.41
08/01/25,UPI,UPI-BHARATHI BHARATHI-BHARTHI9573@YBL-S BIN0020701-537452911648-UPI,0000537452911648,0.0,6000.0,1711.41
08/01/25,IMPS,IMPS-500814862223-DIGIOTECH SOLUTIONS PR IVATE LIMITED-YESB-XXXXXXXXXXX6178-MUTHO OT FINCORP BANK ACCOUNT VERIFICATION PEN,0000500814862223,1.0,0.0,1712.41
08/01/25,RTGS,RTGS CR-UTIB0000082-MUTHOOT FINCORP LTD- M MADHU YADAV-UTIBR72025010800001501,UTIBR72025010800,299000.0,0.0,300712.41
08/01/25,UPI,UPI-K S CONSTRUCTIONS-ASHWINYADAV85-1@OK SBI-AUBL0002591-537434629485-UPI,0000537434629485,0.0,90000.0,210712.41
08/01/25,UPI,UPI-TRUE CREDITS PVT LTD-TRUECREDITS.PAY U@ICICI-ICIC0DC0099-537458324845-UPIINTE NT,0000537458324845,0.0,4736.0,205976.41
08/01/25,UPI,UPI-PHONEPE-BBPSBP@YBL-YESB0YBLUPI-89097 7036669-PAYMENT FROM PHONE,0000890977036669,0.0,1512.28,204464.13
08/01/25,IMPS,IMPS-500818391485-M MADHU YADAV-KKBK-XXX XXX7813-CASH,0000500818391485,0.0,10000.0,194464.13
08/01/25,UPI,UPI-JONNA KANTI SRIKANTH-PAYTMQR28100505 01011BHTBXXSE9UQ@PAYTM-YESB0PTMUPI-50084 2851224-UPI,0000500842851224,0.0,185.0,194279.13
08/01/25,IMPS,IMPS-500819332788-M MADHU YADAV-KKBK-XXX XXX7813-CASH,0000500819332788,0.0,20000.0,174279.13
08/01/25,UPI,UPI-RAJESH C PATEL-CNKRAJESHPATEL@OKAXIS -KKBK0008052-500869983591-UPI,0000500869983591,3000.0,0.0,177279.13
09/01/25,UPI,UPI-MADIGALANARESH123OKI-MADIGALANARESH1 23@OKICICI-KKBK0007463-537599463683-UPI,0000537599463683,0.0,162.0,177117.13
09/01/25,UPI,UPI-JURRU RAHUL YADAV-Q758292524@YBL-YE SB0YBLUPI-537577263391-UPI,0000537577263391,0.0,180.0,176937.13
09/01/25,UPI,UPI-JURRU RAHUL YADAV-Q758292524@YBL-YE SB0YBLUPI-537543556090-UPI,0000537543556090,0.0,200.0,176737.13
09/01/25,UPI,UPI-ANGEL ONE LIMITED-ANGELONENSE@ICICI- ICIC0DC0099-537506360756-PAYINGANGELONE,0000537506360756,0.0,20000.0,156737.13
09/01/25,UPI,UPI-SRI BALAJI BAKERY-PAYTMQR62NJU8@PTYS -YESB0PTMUPI-537516165162-UPI,0000537516165162,0.0,48.0,156689.13
09/01/25,UPI,UPI-M MADHU YADAV-M.MADHUYADAV261@YBL-KK BK0007463-758042073555-PAYMENT FROM PHON E,0000758042073555,0.0,3000.0,153689.13
09/01/25,PAYMENT,IB BILLPAY DR-HDFC92-434155XXXXXX1025 81-661625630241-PAYMENT FROM PHONE,MB09085640254T14,0.0,2500.0,151189.13
09/01/25,,NWD-416021XXXXXX2657-20650002-MUSHEERABA D,0000500911001168,0.0,1000.0,150189.13
09/01/25,UPI,UPI-MADHU SUDHAN GHODKE-MADHUSUDHANGHOD KE@YBL-SBIN0005895-284233527270-PAYMENT FROM PHONE,0000284233527270,0.0,2150.0,148039.13
09/01/25,UPI,UPI-ANUP KUMAR GUPTA-Q776132778@YBL-YES B0YBLUPI-500947979202-UPI,0000500947979202,0.0,700.0,147339.13
09/01/25,UPI,UPI-LIBERTYSRIHARIOKICIC-LIBERTYSRIHARI@ OKICICI-BKID0008627-537552699662-UPI,0000537552699662,0.0,1300.0,146039.13
10/01/25,UPI,UPI-DSRINIVAS GOUD-BHARATPE90726392805@Y ESBANKLTD-YESB0YESUPI-501066822990-PAY T O BHARATPE ME,0000501066822990,0.0,60.0,145979.13
10/01/25,UPI,UPI-MADIGALANARESH123OKI-MADIGALANARESH1 23@OKICICI-KKBK0007463-501002016958-UPI,0000501002016958,0.0,196.0,145783.13
10/01/25,UPI,UPI-JURRU RAHUL YADAV-Q758292524@YBL-YE SB0YBLUPI-501079316999-UPI,0000501079316999,0.0,180.0,145603.13
10/01/25,,ATW-416021XXXXXX2657-S1ANHD25-HYDERABAD,0000000000001537,0.0,20000.0,125603.13
10/01/25,,ATW-416021XXXXXX2657-S1ANHD25-HYDERABAD,0000000000001538,0.0,20000.0,105603.13
10/01/25,,ATW-416021XXXXXX2657-S1ANHD25-HYDERABAD,0000000000001539,0.0,10000.0,95603.13
10/01/25,UPI,UPI-POLAGOWNI VIJAYKUMAR-PAYTMQR5CYQ24@P TYS-YESB0PTMUPI-537676028715-UPI,0000537676028715,0.0,55.0,95548.13
10/01/25,UPI,UPI-BHARATHI BHARATHI-BHARTHI9573@YBL-S BIN0020701-501088537800-UPI,0000501088537800,0.0,6000.0,89548.13
10/01/25,UPI,UPI-MR RAMINI LAXMAN-BHARATPE.90064262 153@FBPE-FDRL0001382-501071632362-PAY TO BHARATPE ME,0000501071632362,0.0,10.0,89538.13
10/01/25,UPI,UPI-MR DIGLESHA VINODKU-Q629080500@YBL- YESB0YBLUPI-537646568395-UPI,0000537646568395,0.0,210.0,89328.13
10/01/25,UPI,UPI-KALIVALA KOMAL-Q797610708@YBL-YESB0Y BLUPI-537610552256-UPI,0000537610552256,0.0,130.0,89198.13
10/01/25,UPI,UPI-LIBERTYSRIHARIOKICIC-LIBERTYSRIHARI@ OKICICI-BKID0008627-501031467764-UPI,0000501031467764,0.0,1300.0,87898.13
10/01/25,NEFT,NEFT CR-ICIC0099999-ANGEL ONE LIMITED CL IENT AC-MUKKERLA MADHU YADAV-ICIN2010199,ICIN201019927877,900.0,0.0,88798.13
11/01/25,UPI,UPI-JURRU RAHUL YADAV-Q758292524@YBL-YE SB0YBLUPI-537787868166-UPI,0000537787868166,0.0,180.0,88618.13
11/01/25,UPI,UPI-VELDUR SAMANTAKA MU-SHAMANTHAKAMURT HYVELDUR-2@OKSBI-SBIN0010106-50112667862 1-UPI,0000501126678621,0.0,19065.0,69553.13
11/01/25,UPI,UPI-MANE NAVNEETHA-PAYTMQR5X7M3L@PTYS-YE SB0PTMUPI-537713685222-UPI,0000537713685222,0.0,30.0,69523.13
11/01/25,,NWD-416021XXXXXX2657-00916173-HYDERABAD,0000501109018043,0.0,10000.0,59523.13
11/01/25,UPI,UPI-PAKANATI NITISH-NITISHPAKANATI125@OK SBI-PUNB0363200-501130692069-UPI,0000501130692069,0.0,3000.0,56523.13
11/01/25,UPI,UPI-M ANIL YADAV-ANILYADAV63473-1@OKSBI- UBIN0803219-537744392654-UPI,0000537744392654,0.0,7500.0,49023.13
11/01/25,UPI,UPI-SOMALWAR SHRINIVAS-SOMALWAR73@OKSBI -SBIN0010356-501170894083-UPI,0000501170894083,0.0,10000.0,39023.13
11/01/25,UPI,UPI-B LLKACHIGUDA0008@YBL-YESB0YBLUPI-55239825 8781-UPI,0000501178878501,1085.0,0.0,40108.13
11/01/25,UPI,UPI-SOMALWAR SHRINIVAS-SOMALWAR73@OKSBI -SBIN0010356-501120086703-UPI,0000501120086703,1360.0,0.0,41468.13
11/01/25,UPI,UPI-PANUGOTHU RAVINAIK-PANUGOTHUNAIK2@Y BL-SBIN0005895-537715396661-UPI,0000537715396661,0.0,560.0,40908.13
11/01/25,UPI,UPI-M ANIL YADAV-ANILYADAV63473-1@OKSBI- UBIN0803219-501152800088-UPI,0000501152800088,0.0,1000.0,39908.13
11/01/25,UPI,UPI-KALIVALA KOMAL-Q797610708@YBL-YESB0Y BLUPI-537702120189-UPI,0000537702120189,0.0,140.0,39768.13
11/01/25,UPI,UPI-LIBERTYSRIHARIOKICIC-LIBERTYSRIHARI@ OKICICI-BKID0008627-537719821570-UPI,0000537719821570,0.0,1300.0,38468.13
11/01/25,UPI,UPI-SRIKANTH MANSABDAR-Q060033466@YBL-YE SB0YBLUPI-537742608016-UPI,0000537742608016,0.0,99.0,38369.13
12/01/25,UPI,UPI-MADIGALANARESH123OKI-MADIGALANARESH1 23@OKICICI-KKBK0007463-537801430290-UPI,0000537801430290,0.0,168.0,38201.13
12/01/25,UPI,UPI-JURRU RAHUL YADAV-Q758292524@YBL-YE SB0YBLUPI-501285737286-UPI,0000501285737286,0.0,180.0,38021.13
12/01/25,UPI,UPI-BURRA AJAY-PAYTMQRISP9M8A22Y@PAYTM-Y ESB0PTMUPI-501242730154-UPI,0000501242730154,0.0,35.0,37986.13
12/01/25,UPI,UPI-M PRABHAKAR-Q435661641@YBL-YESB0YBLU PI-537868237200-UPI,0000537868237200,0.0,300.0,37686.13
12/01/25,UPI,UPI-SRI LAKSHMI NARASIMH-GPAY-1125633011 7@OKBIZAXIS-UTIB0000553-501245536836-UPI 204-YAHOO.CO.IN-1@OKAXIS-UTIB0000048-552 410898026-UPI,0000501245536836,0.0,100.0,37586.13
12/01/25,UPI,UPI-MOHD FAREED-PAYTMQR60LAHS@PTYS-YESB0 PTMUPI-501266947195-UPI,0000501266947195,0.0,20.0,37566.13
12/01/25,UPI,UPI-JANARDHAN FILL POINT-BPCLJANARDHANFI LLKACHIGUDA0008@YBL-YESB0YBLUPI-53780596 2169-PAYMENT FOR GTZ447,0000537805962169,0.0,550.0,37016.13
12/01/25,UPI,UPI-LIBERTYSRIHARIOKICIC-LIBERTYSRIHARI@ OKICICI-BKID0008627-537818862756-UPI,0000537818862756,0.0,1300.0,35716.13
12/01/25,UPI,UPI-ANGEL ONE LIMITED-ANGELONENSE@ICICI- ICIC0DC0099-537893653048-PAYINGANGELONE,0000537893653048,0.0,15000.0,20716.13
12/01/25,,NWD-416021XXXXXX2657-PSEC3310-BARKATPURA,0000501216023900,0.0,5500.0,15216.13
12/01/25,UPI,UPI-MOHD AHMED ALI-AQUA.AHMED98@AXL-UTIB 0001808-276993799687-PAYMENT FROM PHONE,0000276993799687,120.0,0.0,15336.13
12/01/25,UPI,UPI-MUKKERLA RAJESH YADA-MRYADAV3235@OKA XIS-KKBK0007473-501203501182-UPI,0000501203501182,1000.0,0.0,16336.13
12/01/25,UPI,UPI-JIO RECHARGE-JIOINAPPDIRECT1@YBL-YES B0YBLUPI-251964785909-PAYMENT FROM PHONE,0000251964785909,0.0,19.0,16317.13
13/01/25,UPI,UPI-MADIGALANARESH123OKI-MADIGALANARESH1 23@OKICICI-KKBK0007463-501328896571-UPI,0000501328896571,0.0,165.0,16152.13
13/01/25,UPI,UPI-JURRU RAHUL YADAV-Q758292524@YBL-YE SB0YBLUPI-501383403755-UPI,0000501383403755,0.0,180.0,15972.13
13/01/25,UPI,UPI-MURALIKRISHNA VEGETA-GPAY-1124438713 1@OKBIZAXIS-UTIB0000553-501397992884-UPI,0000501397992884,0.0,370.0,15602.13
13/01/25,UPI,UPI-GADDAM,0000537931186079,0.0,105.0,15497.13
13/01/25,UPI,UPI-MAADEVI-Q552508687@YBL-YESB0YBLUPI-5 01354896144-UPI,0000501354896144,0.0,40.0,15457.13
13/01/25,UPI,UPI-SANJAY SAGAR-8595942809@AXL-UTIB0003 156-845450256199-PAYMENT FROM PHONE,0000845450256199,500.0,0.0,15957.13
13/01/25,UPI,UPI-KATALASATTAVVAOKICIC-KATALASATTAVVA@ OKICICI-MAHB0000019-537925996507-UPI,0000537925996507,0.0,1000.0,14957.13
13/01/25,UPI,UPI-P NAND KISHOR-BHARATPE.90069295183@F BPE-FDRL0001382-501333598251-PAY TO BHAR ATPE ME,0000501333598251,0.0,70.0,14887.13
13/01/25,UPI,UPI-AMIT CHARAN-PAYTMQR5WXXDD@PTYS-YESB0 PTMUPI-501364202433-UPI,0000501364202433,0.0,40.0,14847.13
13/01/25,UPI,UPI-AVULA DEEPIKA-9390042802-2@YBL-UTIB0 005151-082054097608-PAYMENT FROM PHONE,0000082054097608,0.0,500.0,14347.13
13/01/25,UPI,UPI-ANGEL ONE LIMITED-ANGELONENSE@ICICI- ICIC0DC0099-537986923344-PAYINGANGELONE,0000537986923344,0.0,1200.0,13147.13
13/01/25,UPI,UPI-LIFE STYLE INTERNATI-LANDMARKMAXRETA IL@YBL-YESB0YBLUPI-537983817809-PAYMENT FOR 501537,0000537983817809,0.0,2410.5,10736.63
13/01/25,UPI,UPI-KALIEMLA MOHAN-Q733847887@YBL-CNRB00 00033-537916224176-UPI,0000537916224176,0.0,50.0,10686.63
13/01/25,UPI,UPI-SRIRAGHAVENDRATIFFIN-PAYTMQR17U07CIZ 21@PAYTM-YESB0PTMUPI-537928826830-UPI,0000537928826830,0.0,12.0,10674.63
14/01/25,UPI,UPI-RAJA RAO NARAMBALLY-Q534710380@YBL- YESB0YBLUPI-538081761520-UPI,0000538081761520,0.0,40.0,10634.63
14/01/25,UPI,UPI-14067 APOLLO,0000538022847959,0.0,54.72,10579.91
14/01/25,UPI,UPI-MUKELRA VANI-VANIRAJESHYADAV@OKAXIS- BARB0MALKAJ-501490498637-UPI,0000501490498637,2000.0,0.0,12579.91
14/01/25,,IB BILLPAY DR-HDFC92-434155XXXXXX1025,MB14082631558T22,0.0,1500.0,11079.91
14/01/25,UPI,UPI-PUTTA RAMESH REDDY-9440362817-3@YBL- IDFB0040101-538000855815-UPI,0000538000855815,0.0,2000.0,9079.91
14/01/25,UPI,UPI-VADICHERLA LAKSHMI-PAYTMQR613714@PTY S-YESB0PTMUPI-501435467460-UPI,0000501435467460,0.0,200.0,8879.91
14/01/25,UPI,UPI-ANGEL LTD NSE-ANGELONENSE@HDFCBANK-H DFC0000001-501459980812-PAYINGANGELONE,0000501459980812,0.0,350.0,8529.91
14/01/25,UPI,UPI-MANCHANA KAVITHA-Q220455212@YBL-YESB 0YBLUPI-721582974017-PAYMENT FROM PHONE,0000721582974017,0.0,130.0,8399.91
14/01/25,UPI,UPI-GOVINDA RAJAN JANAKI-Q233694053@YBL- YESB0YBLUPI-501424583849-UPI,0000501424583849,0.0,30.0,8369.91
14/01/25,UPI,UPI-GOVINDA RAJAN JANAKI-Q233694053@YBL- YESB0YBLUPI-538095183099-UPI,0000538095183099,0.0,130.0,8239.91
14/01/25,UPI,UPI-BANDARI GANESH KUMAR-GANESH281220@AX L-UTIB0004055-804013183445-PAYMENT FROM PHONE,0000804013183445,31760.0,0.0,39999.91
14/01/25,UPI,UPI-GOOGLE INDIA SERVICE-GPAYTOLL@ICICI- ICIC0DC0099-538029194113-UPI,0000538029194113,0.0,230.0,39769.91
15/01/25,UPI,UPI-JURRU RAHUL YADAV-Q758292524@YBL-YE SB0YBLUPI-538165906928-UPI,0000538165906928,0.0,120.0,39649.91
15/01/25,UPI,UPI-MR RAFEEQ MOHAMMED-MDRAFEEQQURAAHIM,0000538193494827,0.0,800.0,38849.91
15/01/25,,ACH D- LIC OF INDIA-6577926590125,0000008029899015,0.0,2488.0,36361.91
15/01/25,UPI,UPI-RAPARTI SRIHARI-9493207195@YBL-BKID0 008627-148933322155-PAYMENT FROM PHONE,0000148933322155,0.0,13000.0,23361.91
15/01/25,UPI,UPI-LIBERTYSRIHARIOKICIC-LIBERTYSRIHARI@ OKICICI-BKID0008627-538154811090-UPI,0000538154811090,0.0,1300.0,22061.91
15/01/25,UPI,UPI-KATALASATTAVVAOKICIC-KATALASATTAVVA@ OKICICI-MAHB0000019-538163607509-UPI,0000538163607509,0.0,1000.0,21061.91
15/01/25,UPI,UPI-SRI BALAJI WINES-PAYTMQR11PZPHQ2DI@P AYTM-YESB0PTMUPI-501531024211-UPI,0000501531024211,0.0,180.0,20881.91
15/01/25,UPI,UPI-KATALASATTAVVAOKICIC-KATALASATTAVVA@ OKICICI-MAHB0000019-538194345982-UPI,0000538194345982,0.0,160.0,20721.91
15/01/25,UPI,UPI-M ANIL YADAV-ANILYADAV63473-1@OKSBI- UBIN0803219-501533235799-UPI,0000501533235799,0.0,600.0,20121.91
16/01/25,UPI,UPI-MOHAMMED AFSAR-MDAFSARZAKI-1@OKHDFC BANK-UBIN0803219-538210651899-UPI,0000538210651899,0.0,500.0,19621.91
16/01/25,UPI,UPI-JURRU RAHUL YADAV-Q758292524@YBL-YE SB0YBLUPI-538280356487-UPI,0000538280356487,0.0,180.0,19441.91
16/01/25,UPI,UPI-JIO RECHARGE-JIOINAPPDIRECT@YBL-YESB 0YBLUPI-092706209240-PAYMENT FROM PHONE,0000092706209240,0.0,352.0,19089.91
16/01/25,UPI,UPI-M ANIL YADAV-ANILYADAV63473-1@OKSBI- UBIN0803219-538270056281-POST OFFICE,0000538270056281,0.0,2000.0,17089.91
16/01/25,UPI,UPI-AIRTEL RECHARGE-AIRTELPREDIRECT2@YBL -YESB0YBLUPI-292295341949-PAYMENT FROM P,0000292295341949,0.0,302.0,16787.91
16/01/25,UPI,UPI-K NARESH-KURIL.NARESH-3@OKHDFCBANK-H DFC0003937-538205067094-UPI,0000538205067094,0.0,100.0,16687.91
16/01/25,UPI,UPI-SHAIK HABEEBUDDIN-7989814974@AXISB-I CIC0000558-501612656140-CHITTI,0000501612656140,5000.0,0.0,21687.91
16/01/25,UPI,UPI-SHAIK HABEEBUDDIN-7989814974@AXISB-I CIC0000558-501612658976-CHITTI,0000501612658976,5000.0,0.0,26687.91
16/01/25,UPI,UPI-SHAIK HABEEBUDDIN-7989814974@AXISB-I CIC0000558-501612660694-CHITTI,0000501612660694,1960.0,0.0,28647.91
16/01/25,UPI,UPI-B VINOD KUMAR-BALERAOVINOD077@OKSBI- CNRB0000033-501681575854-UPI,0000501681575854,0.0,5000.0,23647.91
16/01/25,UPI,UPI-ANIL KUMAR BARLA-9989308410@YBL-SBI N0020256-270472200252-PAYMENT FROM PHONE,0000270472200252,10000.0,0.0,33647.91
16/01/25,UPI,UPI-GUDLA PUSHPAVATHI-NAIDUPUSHPA095@OK SBI-SBIN0007641-538294492826-UPI,0000538294492826,0.0,1000.0,32647.91
16/01/25,UPI,UPI-DEEP SHIKHA GUPTA-AKG03071965@OKSBI- BARB0HIMHYD-501635200370-UPI,0000501635200370,0.0,1450.0,31197.91
16/01/25,UPI,UPI-MARGAM VANI-9392657723@YBL-SBIN0021 100-356023849454-PAYMENT FROM PHONE,0000356023849454,0.0,13000.0,18197.91
17/01/25,UPI,UPI-MADIGALANARESH123OKI-MADIGALANARESH1 23@OKICICI-KKBK0007463-538305796005-UPI,0000538305796005,0.0,140.0,18057.91
17/01/25,UPI,UPI-JURRU RAHUL YADAV-Q758292524@YBL-YE SB0YBLUPI-538360510406-UPI,0000538360510406,0.0,180.0,17877.91
17/01/25,UPI,UPI-MANE NAVNEETHA-PAYTMQR5X7M3L@PTYS-YE SB0PTMUPI-501754815624-UPI,0000501754815624,0.0,30.0,17847.91
17/01/25,UPI,UPI-PHONEPE-BBPSBP@YBL-YESB0YBLUPI-35958 7842947-PAYMENT FROM PHONE 000042-106284062421-MILK AMT,0000359587842947,0.0,855.0,16992.91
17/01/25,UPI,UPI-PHONEPE-BBPSBP@YBL-YESB0YBLUPI-16305 1141260-PAYMENT FROM PHONE,0000163051141260,0.0,190.0,16802.91
17/01/25,UPI,UPI-BIRADHAR ANITHA-BHARATPE9072680291 5@YESBANKLTD-YESB0YESUPI-538360613801-PA Y TO BHARATPE ME,0000538360613801,0.0,35.0,16767.91
17/01/25,UPI,UPI-LIBERTYSRIHARIOKICIC-LIBERTYSRIHARI@ OKICICI-BKID0008627-501736532722-UPI,0000501736532722,0.0,1300.0,15467.91
17/01/25,UPI,UPI-M ARVIND-ARVINDYADAV69552@OKAXIS-K KBK0007473-501773329745-RAILWAY AMOUNT,0000501773329745,0.0,1500.0,13967.91
17/01/25,UPI,UPI-NAYAKOTI SHEKAR-MAHESH.SHEKER09-1@OK AXIS-TSAB0000103-538369354056-UPI,0000538369354056,0.0,600.0,13367.91
17/01/25,UPI,UPI-SRI LAKSHMI NARASIMH-Q293602272@YBL- YESB0YBLUPI-501731059258-UPI,0000501731059258,0.0,1000.0,12367.91
17/01/25,UPI,UPI-JIO RECHARGE-JIOINAPPDIRECT@YBL-YESB 0YBLUPI-214046473929-PAYMENT FROM PHONE,0000214046473929,0.0,19.0,12348.91
18/01/25,UPI,UPI-MADIGALANARESH123OKI-MADIGALANARESH1 23@OKICICI-KKBK0007463-501883273283-UPI,0000501883273283,0.0,140.0,12208.91
18/01/25,UPI,UPI-JURRU RAHUL YADAV-Q758292524@YBL-YE SB0YBLUPI-538467768006-UPI,0000538467768006,0.0,120.0,12088.91
18/01/25,UPI,UPI-MR MARYPEDDY YADAIAH-PAYTMQR1QEBB0LQ 0U@PAYTM-YESB0PTMUPI-501859674306-UPI,0000501859674306,0.0,35.0,12053.91
18/01/25,UPI,UPI-M ARVIND-ARVINDYADAV69552@OKAXIS-K KBK0007473-501806579129-UPI,0000501806579129,0.0,375.0,11678.91
18/01/25,UPI,UPI-LIBERTYSRIHARIOKICIC-LIBERTYSRIHARI@ OKICICI-BKID0008627-501839575338-UPI,0000501839575338,0.0,1300.0,10378.91
18/01/25,UPI,UPI-BHARATHI YADAV-KKBK-XXX XXX7813-CASH,0000501895668959,0.0,6000.0,4378.91
18/01/25,UPI,UPI-ALLI ASHWINIKUMAR-ASHWINYADAV85@YBL- INDB0000839-271738608466-PAYMENT FROM PH ONE,0000271738608466,500.0,0.0,4878.91
18/01/25,UPI,UPI-PANUGOTHU RAVINAIK-PANUGOTHUNAIK2@Y BL-SBIN0005895-538430097869-UPI,0000538430097869,0.0,1100.0,3778.91
18/01/25,UPI,UPI-M ANIL YADAV-ANILYADAV63473-1@OKSBI- UBIN0803219-501896909986-UPI,0000501896909986,0.0,100.0,3678.91
19/01/25,UPI,UPI-NARESH MADIGELA-MADIGALANARESH123-1 @OKSBI-SBIN0005895-501950928280-UPI,0000501950928280,0.0,168.0,3510.91
19/01/25,UPI,UPI-SRIRAGHAVENDRATIFFIN-PAYTMQR17U07CIZ 21@PAYTM-YESB0PTMUPI-538567642373-UPI,0000538567642373,0.0,12.0,3498.91
19/01/25,UPI,UPI-LIBERTYSRIHARIOKICIC-LIBERTYSRIHARI@ OKICICI-BKID0008627-538536044352-UPI,0000538536044352,0.0,1300.0,2198.91
19/01/25,UPI,UPI-B RAJESHWARI-RAJESHWARIYADAV147@OKAX IS-SBIN0RRDCGB-538551306573-UPI,0000538551306573,49000.0,0.0,51198.91
19/01/25,UPI,UPI-ANENKI VIJAY KUMAR-8639679360@YBL-SB IN0002769-372026202181-PAYMENT FROM PHON E,0000372026202181,0.0,20690.0,30508.91
19/01/25,UPI,UPI-M ANIL YADAV-ANILYADAV63473-1@OKSBI- UBIN0803219-501965757335-UPI,0000501965757335,0.0,5000.0,25508.91
19/01/25,UPI,UPI-MASQATI SUPER MARKET-PINELABS.100554 12@MAIRTEL-AIRP0000001-538509065522-GENE RATING DYNAMIC,0000538509065522,0.0,220.0,25288.91
19/01/25,UPI,UPI-KOLLAPURAM UBIN0800619-501547990874-PAYMENT FROM PH ONE,0000538573667629,0.0,200.0,25088.91
19/01/25,UPI,UPI-ANGEL ONE LIMITED-ANGELONENSE@ICICI- ICIC0DC0099-501941067563-PAYINGANGELONE,0000501941067563,0.0,10000.0,15088.91
19/01/25,UPI,UPI-P VINOD KUMAR-Q801724639@YBL-YESB0YB LUPI-538540155430-UPI,0000538540155430,0.0,100.0,14988.91
19/01/25,UPI,UPI-P VINOD KUMAR-Q801724639@YBL-YESB0YB LUPI-538552064738-UPI,0000538552064738,0.0,100.0,14888.91
20/01/25,UPI,UPI-NARESH MADIGELA-MADIGALANARESH123-1 @OKSBI-SBIN0005895-538606664133-UPI,0000538606664133,0.0,162.0,14726.91
20/01/25,UPI,UPI-JURRU RAHUL YADAV-Q758292524@YBL-YE SB0YBLUPI-502054384991-UPI,0000502054384991,0.0,180.0,14546.91
20/01/25,UPI,UPI-M MADHU YADAV-9985065404-2@YBL-SBIN 0006645-256721858566-PAYMENT FROM PHONE,0000256721858566,80000.0,0.0,94546.91
20/01/25,IMPS,IMPS-502008303213-SRIDEVI JT1-ICIC-XXXXX XXX3198-CASH,0000502008303213,0.0,14000.0,80546.91
20/01/25,UPI,UPI-ANGEL ONE LIMITED-ANGELONENSE@ICICI- ICIC0DC0099-502011684653-PAYINGANGELONE,0000502011684653,0.0,20000.0,60546.91
20/01/25,UPI,UPI-ASHOK YADAV TALASANI-TALASANIASHOKYA DAV@OKSBI-SBIN0020256-502090241641-UPI,0000502090241641,19334.0,0.0,79880.91
20/01/25,UPI,UPI-ZERODHA BROKING LTD-ZERODHABROKING@H DFCBANK-HDFC0000523-502056094606-0383314 473812798 Z,0000502056094606,0.0,15000.0,64880.91
20/01/25,UPI,UPI-JIO GHODKE-MADHUSUDHANGHOD KE@AXL-SBIN0005895-516452327907-UPI,0000692577695185,0.0,302.0,64578.91
20/01/25,UPI,UPI-ZERODHA BROKING LTD-ZERODHABROKING@H DFCBANK-HDFC0000523-502094880550-2319925 709258275 Z,0000502094880550,0.0,1500.0,63078.91
20/01/25,UPI,UPI-M MADHU YADAV-9985065404-2@YBL-SBIN 0006645-020986750023-PAYMENT FROM PHONE,0000020986750023,16900.0,0.0,79978.91
20/01/25,UPI,UPI-ANGEL ONE LIMITED-ANGELONENSE@ICICI- ICIC0DC0099-538672777877-PAYINGANGELONE,0000538672777877,0.0,1000.0,78978.91
20/01/25,UPI,UPI-K S CONSTRUCTIONS-ASHWINYADAV85-1@OK SBI-AUBL0002591-502067391727-UPI,0000502067391727,0.0,5000.0,73978.91
20/01/25,UPI,UPI-PRASANTH KUMAR T-PRASHANTH8639@AXL-B ARB0VJPUBL-013136335215-PAYMENT FROM PHO NE,0000013136335215,20000.0,0.0,93978.91
20/01/25,UPI,UPI-MWYN TECH PRIVATE LI-MWYNTECHPRIVATE 893267.RZP@RXAIRTEL-AIRP0000011-53864989 3779-MWYNTECHPRIVATELIM,0000538649893779,0.0,1166.02,92812.89
20/01/25,UPI,UPI-PHONEPE-BBPSBP@YBL-YESB0YBLUPI-75617 9288719-PAYMENT FROM PHONE,0000756179288719,0.0,4764.68,88048.21
20/01/25,UPI,UPI-LIBERTYSRIHARIOKICIC-LIBERTYSRIHARI@ OKICICI-BKID0008627-502081993614-UPI,0000502081993614,0.0,1300.0,86748.21
20/01/25,UPI,UPI-K RADHIKA-RADHIKAYADAVKUKUTLA8-1@OKI CICI-UBIN0814253-538618498036-UPI,0000538618498036,20334.0,0.0,107082.21
20/01/25,UPI,UPI-B VINOD,0000538604820909,0.0,830.0,106252.21
20/01/25,UPI,UPI-JURRU RAHUL YADAV-Q758292524@YBL-YE SB0YBLUPI-502002417774-UPI,0000502002417774,0.0,60.0,106192.21
20/01/25,UPI,UPI-MOHD AHMED ALI-AQUA.AHMED98@AXL-UTIB 0001808-215571272745-PAYMENT FROM PHONE,0000215571272745,140.0,0.0,106332.21
20/01/25,UPI,UPI-MOHD AHMED ALI-AQUA.AHMED98@YBL-UTIB 0001808-094923339955-PAYMENT FROM PHONE,0000094923339955,0.0,50000.0,56332.21
20/01/25,UPI,UPI-MOHAMMED FAHEEM KHAN-KOMAL.DIGITAL16 0@OKHDFCBANK-HDFC0000562-502019971140-MI LK,0000502019971140,200.0,0.0,56532.21
20/01/25,UPI,UPI-NAYAKOTI SHEKAR-MAHESH.SHEKER09-1@OK AXIS-TSAB0000103-502060116108-UPI,0000502060116108,0.0,600.0,55932.21
20/01/25,UPI,UPI-MASQATI SUPER MARKET-PINELABS.103002 99@HDFCBANK-HDFC0000481-502065715514-GEN ERATING DYNAMIC,0000502065715514,0.0,251.0,55681.21
20/01/25,UPI,UPI-KOLLAPURAM MALLIKARJ-MALLIKARJUNKOLA PURAM@OKSBI-HDFC0000218-538610905715-UPI,0000538610905715,0.0,200.0,55481.21
20/01/25,UPI,UPI-SAMARJIT DAS-8016265252@IBL-SBIN004 0462-540450061005-PAYMENT FROM PHONE,0000540450061005,10167.0,0.0,65648.21
21/01/25,UPI,UPI-MUSHTI BHASKAR YADA-M.BHASKARYADAV. 3540@OKSBI-SBIN0005895-538702931965-UPI,0000538702931965,0.0,168.0,65480.21
21/01/25,UPI,UPI-JURRU RAHUL YADAV-Q758292524@YBL-YE SB0YBLUPI-502130633020-UPI BLUPI-516525869972-UPI,0000502130633020,0.0,90.0,65390.21
21/01/25,UPI,UPI-JAI DEV KUMAR JAI DE-9949906165@YBL- SBIN0005895-659415542203-PAYMENT FROM PH ONE,0000659415542203,0.0,1500.0,63890.21
21/01/25,UPI,UPI-MURALIKRISHNA VEGETA-GPAY-1124438713 1@OKBIZAXIS-UTIB0000553-502168734244-UPI,0000502168734244,0.0,520.0,63370.21
21/01/25,UPI,UPI-MANE NAVNEETHA-PAYTMQR66FHIY@PTYS-YE SB0PTMUPI-538727936667-UPI,0000538727936667,0.0,30.0,63340.21
21/01/25,UPI,UPI-YS3373519OKICICI-YS3373519@OKICICI-I DIB000K334-502148519837-UPI,0000502148519837,0.0,2000.0,61340.21
21/01/25,UPI,UPI-ZERODHA BROKING LTD-ZERODHABROKING@H DFCBANK-HDFC0000523-538755531714-2061396 241791288 Z,0000538755531714,0.0,3000.0,58340.21
21/01/25,UPI,UPI-ZERODHA BROKING LTD-ZERODHABROKING@H DFCBANK-HDFC0000523-538720625557-8779133 983415416 Z,0000538720625557,0.0,1500.0,56840.21
21/01/25,UPI,UPI-ANGEL ONE LIMITED-ANGELONENSE@ICICI- ICIC0DC0099-538762120547-PAYINGANGELONE,0000538762120547,0.0,25000.0,31840.21
21/01/25,UPI,UPI-ZERODHA BROKING LTD-ZERODHABROKING@H DFCBANK-HDFC0000523-538727136576-9946238 007812616 Z,0000538727136576,0.0,2000.0,29840.21
21/01/25,UPI,UPI-M MADHU YADAV-9985065404-2@YBL-SBIN 0006645-695766981059-PAYMENT FROM PHONE,0000695766981059,41000.0,0.0,70840.21
21/01/25,UPI,UPI-MARGAM VANI-9392657723@YBL-SBIN0021 100-983379785257-PAYMENT FROM PHONE,0000983379785257,0.0,13000.0,57840.21
21/01/25,UPI,UPI-ARVOG-ARVOG.ESBZ@KOTAK-KKBK0000958-5 02159633551-PAY BLUPI-553272728374-UPI,0000502159633551,0.0,20721.12,37119.09
21/01/25,IMPS,IMPS-502110343992-M MADHU YADAV-KKBK-XXX XXX7813-CASH,0000502110343992,0.0,25000.0,12119.09
21/01/25,IMPS,IMPS-502114347232-M MADHU YADAV-KKBK-XXX XXX7813-CASH,0000502114347232,0.0,5000.0,7119.09
21/01/25,UPI,UPI-MOHD AHMED ALI-AQUA.AHMED98@AXL-UTIB 0001808-667482781593-PAYMENT FROM PHONE,0000667482781593,90.0,0.0,7209.09
22/01/25,NEFT,NEFT CR-YESB0000001-ZERODHA BROKING LTD- DSCNB A/C-MUKKERLA MADHU YADAV-YESBN1202,YESBN12025012200,700.0,0.0,7909.09
22/01/25,UPI,UPI-NARESH MADIGELA-MADIGALANARESH123-1 @OKSBI-SBIN0005895-502206075040-UPI,0000502206075040,0.0,216.0,7693.09
22/01/25,UPI,UPI-JURRU RAHUL YADAV-Q758292524@YBL-YE SB0YBLUPI-538834682130-UPI,0000538834682130,0.0,90.0,7603.09
22/01/25,,ANGEL ONE LIMI-235371513,0000501226420750,800.0,0.0,8403.09
22/01/25,POS,CASH DEPOSIT-416021XXXXXX2657-RTC X ROAD S,0000000000001516,9000.0,0.0,17403.09
22/01/25,UPI,UPI-MUNTHA RAMESH YADAV-RAMEESHM6666@YBL -BKID0008604-476831511453-PAYMENT FROM P HONE,0000476831511453,0.0,8000.0,9403.09
22/01/25,UPI,UPI-RAMESH GUPTA-PAYTMQR5AFMC4@PAYTM-YES B0PTMUPI-502212804421-UPI,0000502212804421,0.0,99.0,9304.09
22/01/25,UPI,UPI-NAYAKOTI IN0007641-124232274425-PAYMENT FROM PHON E,0000502244407591,0.0,1000.0,8304.09
22/01/25,UPI,UPI-LIBERTYSRIHARIOKICIC-LIBERTYSRIHARI@ OKICICI-BKID0008627-538801009973-UPI,0000538801009973,0.0,1300.0,7004.09
22/01/25,UPI,UPI-M ANIL YADAV-ANILYADAV63473-1@OKSBI- UBIN0803219-538837716139-UPI,0000538837716139,0.0,2500.0,4504.09
22/01/25,UPI,UPI-MASQATI SUPER MARKET-PINELABS.103002 99@HDFCBANK-HDFC0000481-538881025829-GEN ERATING DYNAMIC,0000538881025829,0.0,226.0,4278.09
22/01/25,NEFT,NEFT CR-ICIC0099999-ANGEL ONE LIMITED CL IENT AC-MUKKERLA MADHU YADAV-ICICN22025,ICICN22025012228,20000.0,0.0,24278.09
22/01/25,IMPS,IMPS-502221375051-M MADHU YADAV-KKBK-XXX XXX7813-CASH,0000502221375051,0.0,24000.0,278.09
22/01/25,IMPS,IMPS-502225507846-SHADVAL PAY PRIVATE LI MITED-RATN-XXXXXXXX1978-BILL,0000502225507846,19600.0,0.0,19878.09
22/01/25,UPI,UPI-GANTA SUJATHA-SUJATHAGANAT13@OKSBI- SBIN0005895-502290947823-UPI,0000502290947823,1050.0,0.0,20928.09
23/01/25,NEFT,NEFT CR-YESB0000001-ZERODHA BROKING LTD- DSCNB A/C-MUKKERLA MADHU YADAV-YESBN1202,YESBN12025012300,10000.0,0.0,30928.09
23/01/25,UPI,UPI-PHONEPE-BBPSBP@YBL-YESB0YBLUPI-67670 1556210-PAYMENT FROM PHONE,0000676701556210,0.0,24144.15,6783.94
23/01/25,UPI,UPI-NARESH MADIGELA-MADIGALANARESH123-1 @OKSBI-SBIN0005895-538938731774-UPI,0000538938731774,0.0,224.0,6559.94
23/01/25,UPI,UPI-JURRU RAHUL YADAV-Q758292524@YBL-YE SB0YBLUPI-502336240460-UPI,0000502336240460,0.0,90.0,6469.94
23/01/25,UPI,UPI-MR MANE RAMADAS-BHARATPE.900693345 31@FBPE-FDRL0001382-502362641588-PAY TO LAXMI CHAT,0000502362641588,0.0,30.0,6439.94
23/01/25,IMPS,IMPS-502326090067-SHADVAL PAY PRIVATE LI MITED-RATN-XXXXXXXX1978-BILL,0000502326090067,20000.0,0.0,26439.94
23/01/25,,NET PI TO HSL SEC A/C 4114733-0060234002,0000000603528978,0.0,24.0,26415.94
23/01/25,UPI,UPI-LIBERTYSRIHARIOKICIC-LIBERTYSRIHARI@ OKICICI-BKID0008627-538909964138-UPI,0000538909964138,0.0,1300.0,25115.94
23/01/25,UPI,UPI-M ANIL YADAV-ANILYADAV63473-1@OKSBI- UBIN0803219-538989962582-UPI,0000538989962582,0.0,600.0,24515.94
23/01/25,UPI,UPI-KOLLAPURAM MALLIKARJ-MALLIKARJUNKOLA PURAM@OKSBI-HDFC0000218-502332373676-UPI,0000502332373676,0.0,220.0,24295.94
24/01/25,UPI,UPI-NARESH MADIGELA-MADIGALANARESH123-1 @OKSBI-SBIN0005895-502448198982-UPI,0000502448198982,0.0,162.0,24133.94
24/01/25,UPI,UPI-JURRU RAHUL YADAV-Q758292524@YBL-YE SB0YBLUPI-539041994482-UPI,0000539041994482,0.0,180.0,23953.94
24/01/25,UPI,UPI-ANGEL ONE LIMITED-ANGELONENSE@ICICI- ICIC0DC0099-539016702376-PAYINGANGELONE,0000539016702376,0.0,9000.0,14953.94
24/01/25,NEFT,NEFT CR-YESB0000001-FINKURVE FINANCIAL S ERVICES LIMITED-M MADHU YADAV-YESBN52025,YESBN52025012404,17168.0,0.0,32121.94
24/01/25,UPI,UPI-ARRALO RANI-8309617327@PTYES-FDRL000 OKHDFCBANK-HDFC0000562-106602947085-UPI,0000502427940545,0.0,1000.0,31121.94
24/01/25,UPI,UPI-LIBERTYSRIHARIOKICIC-LIBERTYSRIHARI@ OKICICI-BKID0008627-502408736860-UPI,0000502408736860,0.0,1300.0,29821.94
25/01/25,UPI,UPI-N SATHISH KUMAR-PAYTMQR5WRL4X@PTYS-Y ESB0PTMUPI-539106738739-UPI,0000539106738739,0.0,10.0,29811.94
25/01/25,UPI,UPI-JURRU RAHUL YADAV-Q758292524@YBL-YE SB0YBLUPI-502523535623-UPI,0000502523535623,0.0,120.0,29691.94
25/01/25,UPI,UPI-RAPARTI SRIHARI-9493207195@YBL-BKID0 008627-546544007743-PAYMENT FROM PHONE,0000546544007743,0.0,13000.0,16691.94
25/01/25,UPI,UPI-B VINOD KUMAR-BALERAOVINOD077@OKSBI- CNRB0000033-539105156531-UPI,0000539105156531,0.0,860.0,15831.94
25/01/25,UPI,UPI-GUDISHE SAILAJA-SHAILUSHAILU1263@YBL -INDB0001689-856281553817-PAYMENT FROM P HONE,0000856281553817,0.0,3000.0,12831.94
25/01/25,UPI,UPI-LIBERTYSRIHARIOKICIC-LIBERTYSRIHARI@ OKICICI-BKID0008627-539143090514-UPI,0000539143090514,0.0,1300.0,11531.94
26/01/25,UPI,UPI-JURRU RAHUL YADAV-Q758292524@YBL-YE SB0YBLUPI-539289904715-UPI,0000539289904715,0.0,180.0,11351.94
26/01/25,UPI,UPI-SRIRAGHAVENDRATIFFIN-PAYTMQR17U07CIZ 21@PAYTM-YESB0PTMUPI-539284825904-UPI,0000539284825904,0.0,12.0,11339.94
26/01/25,UPI,UPI-MOHD AHMED ALI-AQUA.AHMED98@AXL-UTIB 0001808-158123895717-PAYMENT FROM PHONE,0000158123895717,360.0,0.0,11699.94
26/01/25,UPI,UPI-K S CONSTRUCTIONS-ASHWINYADAV85-1@OK SBI-AUBL0002591-502653544796-UPI,0000502653544796,0.0,5000.0,6699.94
26/01/25,UPI,UPI-JIO ALI-AQUA.AHMED98@AXL-UTIB 0001808-845369339575-PAYMENT FROM PHONE,0000313000254053,0.0,302.0,6397.94
27/01/25,UPI,UPI-POOJA DEVI-BHOLAGUJJAR63029@OKAXIS-A IRP0000001-539311149968-UPI,0000539311149968,0.0,200.0,6197.94
27/01/25,UPI,UPI-JURRU RAHUL YADAV-Q758292524@YBL-YE SB0YBLUPI-502755657113-UPI,0000502755657113,0.0,180.0,6017.94
27/01/25,,ANGEL ONE LIMI-236103733,0000501272096816,9000.0,0.0,15017.94
27/01/25,UPI,UPI-MANE NAVNEETHA-PAYTMQR66FHIY@PTYS-YE SB0PTMUPI-502766146544-UPI,0000502766146544,0.0,30.0,14987.94
27/01/25,UPI,UPI-JAI SANTHOSHI MATHA-GPAY-11256386643 @OKBIZAXIS-UTIB0000553-502745066897-UPI,0000502745066897,0.0,200.0,14787.94
27/01/25,UPI,UPI-M MADHU YADAV-9985065404-2@YBL-SBIN 0006645-298389414891-PAYMENT FROM PHONE,0000298389414891,600.0,0.0,15387.94
27/01/25,UPI,UPI-JAI DEV KUMAR JAI DE-GUBBAJAIDEV42@O KSBI-SBIN0005895-539384466227-UPI,0000539384466227,0.0,162.0,15225.94
27/01/25,UPI,UPI-LIBERTYSRIHARIOKICIC-LIBERTYSRIHARI@ OKICICI-BKID0008627-539324071144-UPI,0000539324071144,0.0,1300.0,13925.94
27/01/25,UPI,UPI-M MADHU YADAV-9985065404-2@YBL-SBIN 0006645-622647439774-PAYMENT FROM PHONE,0000622647439774,5600.0,0.0,19525.94
27/01/25,UPI,UPI-MARGAM VANI-9392657723@YBL-SBIN0021 100-250036013340-PAYMENT FROM PHONE,0000250036013340,0.0,13000.0,6525.94
27/01/25,IMPS,IMPS-502728155900-TAPSTART CAPITAL PVT L TD-RATN-XXXXXXXX6589-WITHDRAWAL,0000502728155900,3450.81,0.0,9976.75
27/01/25,UPI,UPI-HP PETROL PUMP PETR-Q579416954@YBL- YESB0YBLUPI-539399489282-UPI,0000539399489282,0.0,350.0,9626.75
27/01/25,UPI,UPI-MAISHWARYA-Q311245648@YBL-YESB0YBLUP I-539376905350-UPI BY SMARTCO,0000539376905350,0.0,20.0,9606.75
28/01/25,UPI,UPI-JURRU RAHUL YADAV-Q758292524@YBL-YE SB0YBLUPI-539457211957-UPI,0000539457211957,0.0,120.0,9486.75
28/01/25,UPI,UPI-GANTA SUJATHA-SUJATHAGANAT13@OKHDFC BANK-SBIN0005895-502817304731-UPI,0000502817304731,0.0,5000.0,4486.75
28/01/25,UPI,UPI-MANE NAVNEETHA-PAYTMQR5X7M3L@PTYS-YE SB0PTMUPI-539447216136-UPI,0000539447216136,0.0,30.0,4456.75
28/01/25,,ANGEL ONE LIMI-W246QO6AFVE4XC,0000501284229645,16000.0,0.0,20456.75
28/01/25,UPI,UPI-MAHENDRA JALA-JALAMAHENDRA@OKAXIS-K KBK0007466-502844926299-UPI,0000502844926299,0.0,16000.0,4456.75
28/01/25,UPI,UPI-MR DIGLESHA VINODKU-Q361656464@YBL- YESB0YBLUPI-539406220791-UPI,0000539406220791,0.0,90.0,4366.75
28/01/25,UPI,UPI-SYED JAHANGIR-SYEDIBRAHIM9398605896 -1@OKSBI-SBIN0020061-502817727397-UPI,0000502817727397,0.0,80.0,4286.75
28/01/25,UPI,UPI-P DEEPAK-SYEDALI14314355@OKAXIS-YES B0000747-539404144315-UPI,0000539404144315,1600.0,0.0,5886.75
28/01/25,UPI,UPI-ARUKALA ANUSHA-BHARATPE.9Y0E0U7K2Y70 4482@FBPE-FDRL0001382-539493030487-PAY T O BHARATPE ME,0000539493030487,0.0,240.0,5646.75
28/01/25,UPI,UPI-VAMSHIMUNNA295OKICIC-VAMSHIMUNNA29-5 @OKICICI-HDFC0000045-539424334754-UPI,0000539424334754,0.0,1500.0,4146.75
28/01/25,UPI,UPI-MOHD ABDUL WASEEM-PAYTM.S14JLFV@PTY- YESB0MCHUPI-539425121300-UPI,0000539425121300,0.0,25.0,4121.75
28/01/25,UPI,UPI-ZIA MOHIUDDIN-770250301@YBL-CNRB0000 033-466559807648-PAYMENT FROM PHONE,0000466559807648,3100.0,0.0,7221.75
28/01/25,UPI,UPI-LIBERTYSRIHARIOKICIC-LIBERTYSRIHARI@ OKICICI-BKID0008627-502835532986-UPI,0000502835532986,0.0,1300.0,5921.75
28/01/25,UPI,UPI-JAI DEV KUMAR JAI DE-GUBBAJAIDEV42@O KSBI-SBIN0005895-502858635882-UPI,0000502858635882,0.0,162.0,5759.75
28/01/25,UPI,UPI-MAHADEV-Q573928695@YBL-YESB0YBLUPI-5 02875152545-UPI,0000502875152545,0.0,100.0,5659.75
28/01/25,UPI,UPI-M ANIL YADAV-ANILYADAV63473-1@OKSBI- UBIN0803219-539444050021-UPI,0000539444050021,0.0,100.0,5559.75
29/01/25,NEFT,NEFT CR-YESB0000001-ZERODHA BROKING LTD- DSCNB A/C-MUKKERLA MADHU YADAV-YESBN1202,YESBN12025012900,1000.0,0.0,6559.75
29/01/25,UPI,UPI-JURRU RAHUL YADAV-Q758292524@YBL-YE SB0YBLUPI-502968678323-UPI,0000502968678323,0.0,120.0,6439.75
29/01/25,UPI,UPI-NARLA SRIKANTH YADA-Q470718822@YBL- YESB0YBLUPI-539550853269-UPI,0000539550853269,0.0,35.0,6404.75
29/01/25,UPI,UPI-MANE NAVNEETHA-PAYTMQR5X7M3L@PTYS-YE SB0PTMUPI-502908964209-UPI,0000502908964209,0.0,30.0,6374.75
29/01/25,UPI,UPI-MR RAPATHI NARSING -Q084776718@YBL- YESB0YBLUPI-502947561370-UPI,0000502947561370,0.0,140.0,6234.75
29/01/25,UPI,UPI-V S NAARAYANA-PPR.00848.21042023.00 011302@CNRB-CNRB0000848-539554683314-PAY TO MERCHANT,0000539554683314,0.0,201.0,6033.75
29/01/25,UPI,UPI-GUDLA PUSHPAVATHI-NAIDUPUSHPA095@OK SBI-SBIN0007641-502997982024-UPI,0000502997982024,0.0,1000.0,5033.75
29/01/25,UPI,UPI-PARDI PENTAIAH-Q096079627@YBL-YESB0Y BLUPI-502949981597-UPI H@OKSBI-SBIN0020568-517180184895-UPI,0000502949981597,0.0,50.0,4983.75
29/01/25,,ATW-416021XXXXXX2657-P3ENTS55-HYDERABAD,0000000000000738,0.0,1000.0,3983.75
29/01/25,UPI,UPI-MOHD AHMED ALI-AQUA.AHMED98@AXL-UTIB 0001808-743992713835-PAYMENT FROM PHONE,0000743992713835,270.0,0.0,4253.75
29/01/25,UPI,UPI-LIBERTYSRIHARIOKICIC-LIBERTYSRIHARI@ OKICICI-BKID0008627-502960312565-UPI,0000502960312565,0.0,1300.0,2953.75
29/01/25,UPI,UPI-JAI DEV KUMAR JAI DE-GUBBAJAIDEV42@O KSBI-SBIN0005895-502909009095-UPI,0000502909009095,0.0,162.0,2791.75
29/01/25,UPI,UPI-PHONEPE-BBPSBP@YBL-YESB0YBLUPI-03355 3777808-PAYMENT FROM PHONE,0000033553777808,0.0,100.0,2691.75
30/01/25,UPI,UPI-JURRU RAHUL YADAV-Q758292524@YBL-YE SB0YBLUPI-503037815655-UPI,0000503037815655,0.0,150.0,2541.75
30/01/25,UPI,UPI-MANE NAVNEETHA-PAYTMQR5X7M3L@PTYS-YE SB0PTMUPI-503099313316-UPI,0000503099313316,0.0,30.0,2511.75
30/01/25,UPI,UPI-MR G SATISH-PAYTMQR5591SC@PAYTM-YESB 0PTMUPI-503044021631-UPI,0000503044021631,0.0,50.0,2461.75
30/01/25,POS,CASH DEPOSIT-XXXXXXXXXX1847-BARKATPURA,0000000000007893,23000.0,0.0,25461.75
30/01/25,POS,CASH DEPOSIT-XXXXXXXXXX1847-BARKATPURA,0000000000007896,25000.0,0.0,50461.75
30/01/25,UPI,UPI-SRI BALAJI BAKERY-PAYTMQR66O95U@PTYS -YESB0PTMUPI-539610131448-UPI,0000539610131448,0.0,20.0,50441.75
30/01/25,,ZHDFE0R0BTQBKN/BILLDKRATNAKARBANKLI,0000253074769728,0.0,15918.94,34522.81
30/01/25,,ZHDF1WF0BTSYFA/BILLDKRATNAKARBANKLI,0000253074771081,0.0,6857.0,27665.81
30/01/25,IMPS,IMPS-503013735799-INSTANTPAY-UTIB-XXXXXX XXXXX2361-NA,0000503013735799,1.0,0.0,27666.81
30/01/25,UPI,IMPS-503026082159-NTAR BIZZ PRIVATE LIMI -YESB0PTMUPI-553897319192-UPI,0000503026082159,9700.0,0.0,37366.81
30/01/25,UPI,UPI-MARGAM VANI-9392657723@YBL-SBIN0021 100-597775859270-PAYMENT FROM PHONE,0000597775859270,0.0,13000.0,24366.81
30/01/25,UPI,UPI-MUNTHA RAMESH YADAV-RAMEESHM6666@YBL -BKID0008604-940806844229-PAYMENT FROM P HONE,0000940806844229,0.0,6000.0,18366.81
30/01/25,UPI,UPI-MAHENDER SINGH RAWAT-PAYTMQR66FI8H@P TYS-YESB0PTMUPI-503028552261-UPI,0000503028552261,0.0,35.0,18331.81
30/01/25,UPI,UPI-LIBERTYSRIHARIOKICIC-LIBERTYSRIHARI@ OKICICI-BKID0008627-539638148915-UPI,0000539638148915,0.0,1300.0,17031.81
30/01/25,UPI,UPI-JAI DEV KUMAR JAI DE-GUBBAJAIDEV42@O KSBI-SBIN0005895-503090938779-UPI,0000503090938779,0.0,216.0,16815.81
30/01/25,UPI,UPI-BHAVESH GUPTA-PAYTMQR5C8BFA@PTYS-YES B0PTMUPI-503010342989-UPI,0000503010342989,0.0,160.0,16655.81
30/01/25,UPI,UPI-SARITHA SARITHA-Q843321365@YBL-YESB 0YBLUPI-539665955732-UPI,0000539665955732,0.0,150.0,16505.81
30/01/25,UPI,UPI-SRI BALAJI WINES-PAYTMQR11PZPHQ2DI@P AYTM-YESB0PTMUPI-503084164693-UPI,0000503084164693,0.0,210.0,16295.81
30/01/25,UPI,UPI-MR MADHU SUDHAN GHOD-MADHUSUDHANGHOD KE-2@OKHDFCBANK-MAHB0000383-503082850568 -UPI,0000503082850568,100.0,0.0,16395.81
31/01/25,UPI,UPI-JURRU RAHUL YADAV-Q758292524@YBL-YE SB0YBLUPI-503125066621-UPI,0000503125066621,0.0,120.0,16275.81
31/01/25,UPI,UPI-SRI BALAJI,0000539710959256,0.0,73.0,16202.81
31/01/25,UPI,UPI-MANE NAVNEETHA-PAYTMQR66FHIY@PTYS-YE SB0PTMUPI-539723368215-UPI,0000539723368215,0.0,30.0,16172.81
31/01/25,UPI,UPI-HP PETROL PUMP PETR-Q808953223@YBL- YESB0YBLUPI-503113975169-UPI,0000503113975169,0.0,220.0,15952.81
31/01/25,UPI,UPI-MOHD AHMED ALI-AQUA.AHMED98@AXL-UTIB 0001808-705376249644-PAYMENT FROM PHONE,0000705376249644,180.0,0.0,16132.81
31/01/25,UPI,UPI-PARDI PENTAIAH-Q977140919@YBL-YESB0Y BLUPI-539797909199-UPI,0000539797909199,0.0,50.0,16082.81
31/01/25,UPI,UPI-LIBERTYSRIHARIOKICIC-LIBERTYSRIHARI@ OKICICI-BKID0008627-503176015358-UPI,0000503176015358,0.0,1300.0,14782.81
31/01/25,UPI,UPI-AKSHAY CHINTALA-9849868607@AXISB-CNR B0000033-503151424785-PAID VIA CRED AND,0000503151424785,1395.0,0.0,16177.81
31/01/25,UPI,UPI-MILLENNIUM REST BAR-Q796341052@YBL- YESB0YBLUPI-539716117765-UPI,0000539716117765,0.0,445.0,15732.81
01/02/25,UPI,UPI-JURRU RAHUL YADAV-Q758292524@YBL-YE SB0YBLUPI-503281027489-UPI,0000503281027489,0.0,120.0,15612.81
01/02/25,UPI,UPI-M ANIL YADAV-ANILYADAV63473-1@OKSBI- UBIN0803219-539840024097-UPI,0000539840024097,0.0,600.0,15012.81
01/02/25,UPI,UPI-ABSIPURAM KARUNAKAR-9000103377@YBL- SBIN0020083-231925864296-PAYMENT FROM PH ONE,0000231925864296,3760.0,0.0,18772.81
01/02/25,UPI,UPI-NORTHERN ARC-NORTHERNARC692717.RZP@R XAIRTEL-AIRP0000011-503207592650-NORTHER,0000503207592650,0.0,7134.54,11638.27
01/02/25,UPI,UPI-M MADHU YADAV-9985065404-2@YBL-SBIN 0006645-650850445107-PAYMENT FROM PHONE,0000650850445107,4000.0,0.0,15638.27
01/02/25,UPI,UPI-MR MARYPEDDY YADAIAH-PAYTMQR1QEBB0LQ 0U@PAYTM-YESB0PTMUPI-503275033964-UPI,0000503275033964,0.0,35.0,15603.27
01/02/25,UPI,UPI-JAI SANTHOSHI MATHA-GPAY-11256386643 @OKBIZAXIS-UTIB0000553-503265527769-UPI,0000503265527769,0.0,48.0,15555.27
01/02/25,UPI,UPI-PANYAM MANJULA-MANJUPANYAM@OKSBI-SB IN0007641-503284440252-MILK BILL,0000503284440252,4520.0,0.0,20075.27
01/02/25,UPI,UPI-UDUPI AAHARS WOOD S-Q983423069@YBL-Y ESB0YBLUPI-539894945854-UPI,0000539894945854,0.0,460.0,19615.27
01/02/25,UPI,UPI-SHANTANU SUNIL MAHAJ-SHANTANUMAHAJAN 36@OKSBI-KKBK0000726-503202055433-FEB RE NT,0000503202055433,2575.0,0.0,22190.27
01/02/25,UPI,UPI-M MADHU YADAV-M.MADHUYADAV261@YBL-KK BK0007463-898726229761-PAYMENT FROM PHON E,0000898726229761,0.0,2500.0,19690.27
01/02/25,UPI,UPI-ENDRAVATH GANESH-BHARATPE2S0I0Y0Q4S7 6587@UNITYPE-UNBA000BHPE-539831146643-PA Y TO ENDRAVATH G,0000539831146643,0.0,50.0,19640.27
01/02/25,UPI,UPI-KOUR H-HARDEEPKOUR24@OKSBI-HSBC05000 02-503209361446-UPI,0000503209361446,1040.0,0.0,20680.27
01/02/25,UPI,UPI-LIBERTYSRIHARIOKICIC-LIBERTYSRIHARI@ OKICICI-BKID0008627-539872570036-UPI,0000539872570036,0.0,1300.0,19380.27
01/02/25,UPI,UPI-JIO BPE-FDRL0001382-517443767087-PAY TO BHAR ATPE ME,0000305881469602,0.0,19.0,19361.27
02/02/25,UPI,UPI-JURRU RAHUL YADAV-Q758292524@YBL-YE SB0YBLUPI-503342099144-UPI,0000503342099144,0.0,180.0,19181.27
02/02/25,UPI,UPI-MURALIKRISHNA VEGETA-GPAY-1124438713 1@OKBIZAXIS-UTIB0000553-503357189239-UPI,0000503357189239,0.0,260.0,18921.27
02/02/25,UPI,UPI-KEERTHI NEELI-SAI.TAANYA26@OKAXIS-BA RB0BARKAT-503369195018-UPI,0000503369195018,1660.0,0.0,20581.27
02/02/25,UPI,UPI-BUDUMURU BHARGAVI-6303219486-3@YBL- CNRB0000033-518802044597-PAYMENT FROM PH ONE,0000518802044597,1120.0,0.0,21701.27
02/02/25,UPI,UPI-APPALA GURUPRASAD-GURUATNIC.IN@AXL- SBIN0004159-599498962341-MONTHLY MILK EX P,0000599498962341,1500.0,0.0,23201.27
02/02/25,UPI,UPI-MADHURI MARAM-LIPIKAMARAM@OKICICI-IC IC0000008-503396424615-UPI,0000503396424615,4185.0,0.0,27386.27
03/02/25,UPI,UPI-JURRU RAHUL YADAV-Q758292524@YBL-YE SB0YBLUPI-503476628017-UPI,0000503476628017,0.0,120.0,27266.27
03/02/25,UPI,UPI-PURUSHOTTAM ADHIKAR-9005457070@YBL- SBIN0012223-545287659754-PAYMENT FROM PH ONE,0000545287659754,3255.0,0.0,30521.27
03/02/25,UPI,UPI-SRI LAXMI RATAN KIRA-LATHASINGH1201- 1@OKSBI-SBIN0005895-503436546828-UPI,0000503436546828,0.0,48.0,30473.27
03/02/25,UPI,UPI-LIQUI XXX7813-CASH,0000540063248023,0.0,1534.66,28938.61
03/02/25,UPI,UPI-RITHIK MITTAL-RITHIKMITTAL2606-1@OKH DFCBANK-HDFC0000081-503457982932-UPI,0000503457982932,1237.0,0.0,30175.61
03/02/25,UPI,UPI-RAPARTI SRIHARI-9493207195@YBL-BKID0 008627-144899231859-PAYMENT FROM PHONE,0000144899231859,0.0,10000.0,20175.61
03/02/25,UPI,UPI-M MADHU YADAV-9985065404-2@YBL-SBIN 0006645-540379870073-PAYMENT FROM PHONE,0000540379870073,9500.0,0.0,29675.61
03/02/25,,BAJAJFIN_BF-1286306_111024596,000000000000000,0.0,9101.0,20574.61
03/02/25,,BAJAJFIN_BF-1286306_111024744,000000000000000,0.0,9503.0,11071.61
03/02/25,UPI,UPI-SYED SABIR PAN SHOP -ASIANFLOWERMERC HANT91@OKHDFCBANK-UBIN0545619-5400230737 95-UPI,0000540023073795,0.0,30.0,11041.61
03/02/25,UPI,UPI-SRI BALAJI BAKERY-PAYTMQR66O95U@PTYS -YESB0PTMUPI-540021961617-UPI,0000540021961617,0.0,10.0,11031.61
03/02/25,UPI,UPI-SAMUDHRALA MANASA-MANASA31961@YBL-SB IN0RRDCGB-534002823345-PAYMENT FROM PHON E,0000534002823345,2070.0,0.0,13101.61
03/02/25,UPI,UPI-SASHIKALA BHANDARI-9032117972@YBL-S BIN0005895-025807227221-PAYMENT FROM PHO NE,0000025807227221,2550.0,0.0,15651.61
03/02/25,UPI,UPI-PREMLATA MARDA-8639436017@AXL-PUNB00 20700-147788156826-PAYMENT FROM PHONE,0000147788156826,1395.0,0.0,17046.61
03/02/25,POS,CASH DEPOSIT-XXXXXXXXXX1847-BARKATPURA,0000000000009130,15500.0,0.0,32546.61
03/02/25,UPI,UPI-MOHD AHMED ALI-AQUA.AHMED98@YBL-UTIB,0000865994771708,270.0,0.0,32816.61
03/02/25,UPI,UPI-LIBERTYSRIHARIOKICIC-LIBERTYSRIHARI@ OKICICI-BKID0008627-540080181984-UPI,0000540080181984,0.0,1300.0,31516.61
03/02/25,UPI,UPI-PAWAN KUMAR BASANT-9903315499@AXISB- IDFB0040101-503460974712-PAID VIA CRED,0000503460974712,190.0,0.0,31706.61
03/02/25,UPI,UPI-GOGA ELECTRONICS-9849436607@YBL-APMC 0000006-556470830400-PAYMENT FROM PHONE,0000556470830400,2000.0,0.0,33706.61
03/02/25,UPI,UPI-MS GOGA ELECTRONICS-9849436607@IBL-A PMC0000006-345406748460-PAYMENT FROM PHO NE,0000345406748460,2000.0,0.0,35706.61
04/02/25,UPI,UPI-JURRU RAHUL YADAV-Q758292524@YBL-YE SB0YBLUPI-503582510406-UPI,0000503582510406,0.0,120.0,35586.61
04/02/25,UPI,UPI-TIRIVISETTY SATYANAR-Q628175389@YBL- YESB0YBLUPI-540158699989-UPI,0000540158699989,0.0,30.0,35556.61
04/02/25,UPI,UPI-MANE NAVNEETHA-PAYTMQR5X7M3L@PTYS-YE SB0PTMUPI-540132300614-UPI,0000540132300614,0.0,30.0,35526.61
04/02/25,UPI,UPI-MUKKERLA GEETA SUDHA-GEETHAMUKKERLA- 1@OKAXIS-KKBK0007463-503562799504-UPI,0000503562799504,0.0,2200.0,33326.61
04/02/25,UPI,UPI-MR SUHAS MADHUKAR CH-DRSUHAS2003@OKI CICI-IDIB000M238-540159814709-UPI,0000540159814709,2250.0,0.0,35576.61
04/02/25,UPI,UPI-MUKKERLA GEETA SUDHA-6302856696@YBL- KKBK0007463-605004478417-PAYMENT FROM PH ONE,0000605004478417,0.0,5260.0,30316.61
04/02/25,UPI,UPI-JIO RECHARGE-JIOINAPPDIRECT@YBL-YESB,0000050235506749,0.0,302.0,30014.61
04/02/25,POS,CASH DEPOSIT-416021XXXXXX2657-BARKATPURA,0000000000009345,13500.0,0.0,43514.61
04/02/25,UPI,UPI-RAPARTI SRIHARI-9493207195@YBL-BKID0 008627-015951576839-PAYMENT FROM PHONE,0000015951576839,0.0,10000.0,33514.61
04/02/25,,ACH D- PROTIUM FINANCE LIMI-9RFMAU2MNBJQ,0000004025083095,0.0,28475.0,5039.61
04/02/25,UPI,UPI-VODAFONE IDEA ANDHR-VIINAPPAP@YBL-Y ESB0YBLUPI-689297941139-PAYMENT FROM PHO NE,0000689297941139,0.0,201.0,4838.61
04/02/25,,ACH D- PROTIUM FINANCE LIMI-GS001BL02442,0000004039255078,0.0,28475.0,-23636.39
04/02/25,,ACH D- PROTIUM FINANCE LIMI-GS001BL02442,0000004039255078,28475.0,0.0,4838.61
04/02/25,UPI,UPI-MOHD SHAKEEL-SHAKEELBOSS407@OKAXIS-U BIN0534765-540195705535-UPI,0000540195705535,6600.0,0.0,11438.61
05/02/25,UPI,UPI-M ANIL YADAV-ANILYADAV63473-1@OKHDFC BANK-UBIN0803219-503650252126-NAGARAJ AM T,0000503650252126,20000.0,0.0,31438.61
05/02/25,,ATW-416021XXXXXX2657-P3ENTS55-HYDERABAD,0000000000002150,0.0,20000.0,11438.61
05/02/25,UPI,UPI-M MADHU YADAV-M.MADHUYADAV261@YBL-KK BK0007463-619753450220-PAYMENT FROM PHON E,0000619753450220,0.0,1500.0,9938.61
05/02/25,UPI,UPI-M MADHU YADAV-9985065404-2@YBL-SBIN 0006645-760640091447-PAYMENT FROM PHONE,0000760640091447,3000.0,0.0,12938.61
05/02/25,,IB BILLPAY DR-HDFC92-434155XXXXXX1025,MB05145341216T10,0.0,10281.0,2657.61
05/02/25,,IB BILLPAY DR-HDFC92-434155XXXXXX1025,MB05145448558T21,0.0,200.0,2457.61
05/02/25,UPI,UPI-JURRU RAHUL YADAV-Q758292524@YBL-YE SB0YBLUPI-540265209982-UPI 4323247-PAYMENT FROM PHONE,0000540265209982,0.0,70.0,2387.61
05/02/25,UPI,UPI-SRI BALAJI WINES KAC-GPAY-1125640798 6@OKBIZAXIS-UTIB0000553-503648599009-UPI,0000503648599009,0.0,210.0,2177.61
05/02/25,UPI,UPI-LIBERTYSRIHARIOKICIC-LIBERTYSRIHARI@ OKICICI-BKID0008627-540219010054-UPI,0000540219010054,0.0,1300.0,877.61
05/02/25,UPI,UPI-B RAYUDU-RAYUDU10-1@OKHDFCBANK-HDFC0 000042-503684773580-MILK AMT,0000503684773580,1085.0,0.0,1962.61
05/02/25,UPI,UPI-BSUDHAKAR-SUDHAKARBIRADAR007@OKSBI-U BIN0534773-503638413886-UPI,0000503638413886,0.0,500.0,1462.61
05/02/25,UPI,UPI-JIO RECHARGE-JIOINAPPDIRECT1@YBL-YES B0YBLUPI-166319212003-PAYMENT FROM PHONE,0000166319212003,0.0,19.0,1443.61
06/02/25,UPI,UPI-JURRU RAHUL YADAV-Q758292524@YBL-YE SB0YBLUPI-503726723314-UPI,0000503726723314,0.0,90.0,1353.61
06/02/25,UPI,UPI-MANE NAVNEETHA-PAYTMQR5X7M3L@PTYS-YE SB0PTMUPI-503756727924-UPI,0000503756727924,0.0,30.0,1323.61
06/02/25,UPI,UPI-M MADHU YADAV-M.MADHUYADAV261@YBL-KK BK0007463-841110059750-PAYMENT FROM PHON E,0000841110059750,1200.0,0.0,2523.61
06/02/25,UPI,UPI-RAPARTI SRIHARI-9493207195@YBL-BKID0 008627-261297547839-PAYMENT FROM PHONE,0000261297547839,28500.0,0.0,31023.61
06/02/25,UPI,UPI-ARVOG-ARVOG.ESBZ@KOTAK-KKBK0000958-5 40376621175-PAY,0000540376621175,0.0,20412.86,10610.75
06/02/25,UPI,UPI-BHARATHI BHARATHI-BHARTHI9573@YBL-S BIN0020701-540326342343-UPI,0000540326342343,0.0,6000.0,4610.75
06/02/25,UPI,UPI-SURESH BIND-SURESHKUMARSK066@OKHDF 0YBLUPI-989482154284-PAYMENT FROM PHONE,0000503709707863,2280.0,0.0,6890.75
06/02/25,NEFT,NEFT CR-YESB0000001-FINKURVE FINANCIAL S ERVICES LIMITED-M MADHU YADAV-YESBN52025,YESBN52025020609,17168.0,0.0,24058.75
06/02/25,UPI,UPI-B VINOD KUMAR-BALERAOVINOD077@OKSBI- CNRB0000033-503725757408-UPI,0000503725757408,0.0,1500.0,22558.75
06/02/25,UPI,UPI-MOSHIN LAXMAIAH BR-Q254435223@YBL- YESB0YBLUPI-540366657852-UPI,0000540366657852,0.0,250.0,22308.75
06/02/25,UPI,UPI-SUPRABATH TIFFINS-PAYTMQR5CYPRP@PTYS -YESB0PTMUPI-540373865411-UPI,0000540373865411,0.0,12.0,22296.75
06/02/25,UPI,UPI-MOHD AHMED ALI-AQUA.AHMED98@AXL-UTIB 0001808-945169190222-PAYMENT FROM PHONE,0000945169190222,270.0,0.0,22566.75
06/02/25,UPI,UPI-KANDADI MADHUSUDHAN -MADHUSUDHANSMIL EY8161@YBL-HDFC0008851-105357885461-PAYM ENT FROM PHONE,0000105357885461,840.0,0.0,23406.75
06/02/25,UPI,UPI-MOHIT SETHIA-MOHITSJ.1995@OKICICI- KKBK0007452-503717779757-UPI,0000503717779757,2000.0,0.0,25406.75
06/02/25,UPI,UPI-LIBERTYSRIHARIOKICIC-LIBERTYSRIHARI@ OKICICI-BKID0008627-503712665423-UPI,0000503712665423,0.0,1300.0,24106.75
07/02/25,UPI,UPI-JURRU RAHUL YADAV-Q758292524@YBL-YE SB0YBLUPI-540491773940-UPI,0000540491773940,0.0,200.0,23906.75
07/02/25,UPI,UPI-MANE NAVNEETHA-PAYTMQR5X7M3L@PTYS-YE SB0PTMUPI-540481288107-UPI,0000540481288107,0.0,60.0,23846.75
07/02/25,UPI,UPI-MUKKERLA GEETA SUDHA-GEETHAMUKKERLA- HONE,0000503880490021,0.0,1000.0,22846.75
07/02/25,UPI,UPI-MUKKERLA GEETA SUDHA-GEETHAMUKKERLA- 1@OKAXIS-KKBK0007463-540439800214-UPI,0000540439800214,0.0,800.0,22046.75
07/02/25,UPI,UPI-DEEP SHIKHA GUPTA-AKG03071965@OKSBI- BARB0HIMHYD-503850284865-UPI,0000503850284865,0.0,1450.0,20596.75
07/02/25,UPI,UPI-M ARVIND RAJ-ARVINDRAJ57964-1@OKHDFC BANK-HDFC0000512-503881054716-UPI,0000503881054716,1650.0,0.0,22246.75
07/02/25,UPI,UPI-LIBERTYSRIHARIOKICIC-LIBERTYSRIHARI@ OKICICI-BKID0008627-503886922878-UPI,0000503886922878,0.0,1300.0,20946.75
07/02/25,UPI,UPI-SRI BALAJI BAKERY-PAYTMQR66O95U@PTYS -YESB0PTMUPI-503883818718-UPI,0000503883818718,0.0,40.0,20906.75
08/02/25,UPI,UPI-JURRU RAHUL YADAV-Q758292524@YBL-YE SB0YBLUPI-540559134130-UPI,0000540559134130,0.0,45.0,20861.75
08/02/25,UPI,UPI-SANJAY SAGAR-8595942809@AXL-UTIB0003 156-982939204392-PAYMENT FROM PHONE,0000982939204392,500.0,0.0,21361.75
08/02/25,UPI,UPI-MR MARYPEDDY YADAIAH-PAYTMQR1QEBB0LQ 0U@PAYTM-YESB0PTMUPI-540566236993-UPI,0000540566236993,0.0,30.0,21331.75
08/02/25,UPI,UPI-AVULA DEEPIKA-9390042802-2@YBL-UTIB0 005151-366043378056-PAYMENT FROM PHONE,0000366043378056,1000.0,0.0,22331.75
08/02/25,UPI,UPI-MD SYED ALI-Q561821737@YBL-YESB0YBL UPI-540545441049-UPI,0000540545441049,0.0,80.0,22251.75
08/02/25,,ACH D- HERO FINCORP LTD-62405711,0000004245751465,0.0,10855.0,11396.75
08/02/25,UPI,UPI-B VINOD KUMAR-BALERAOVINOD077@OKSBI- CNRB0000033-540580935230-UPI,0000540580935230,0.0,1000.0,10396.75
08/02/25,UPI,UPI-YERUKULA ANDALU-7893726105@AXL-SBIN LUPI-554507863954-UPI,0000503967343698,0.0,300.0,10096.75
08/02/25,UPI,UPI-BHARATHI BHARATHI-BHARTHI9573@YBL-S BIN0020701-503989045574-UPI,0000503989045574,0.0,6000.0,4096.75
08/02/25,UPI,UPI-LIBERTYSRIHARIOKICIC-LIBERTYSRIHARI@ OKICICI-BKID0008627-540513754631-UPI,0000540513754631,0.0,1300.0,2796.75
08/02/25,UPI,UPI-JURRU RAHUL YADAV-Q758292524@YBL-YE SB0YBLUPI-540509270447-UPI,0000540509270447,0.0,30.0,2766.75
08/02/25,UPI,UPI-B SUMAN GOUD-9553484848@YBL-KKBK000 7451-015578842255-PAYMENT FROM PHONE,0000015578842255,80000.0,0.0,82766.75
08/02/25,UPI,UPI-ORUGANTI SRINIVAS RE-OSRINIVAS555@OK ICICI-UTIB0000426-540524482847-UPI,0000540524482847,160.0,0.0,82926.75
08/02/25,UPI,UPI-MOHAMMAD ABED ALI-PAYTMQR5F5DH2@PTYS -YESB0PTMUPI-540587383863-UPI,0000540587383863,0.0,200.0,82726.75
08/02/25,UPI,UPI-SHAIK SAMI UDDIN-BHARATPE.9F0B0H7O2N 796571@FBPE-FDRL0001382-540575079340-PAY TO BHARATPE ME,0000540575079340,0.0,250.0,82476.75
08/02/25,UPI,UPI-JONNA KANTI SRIKANTH-PAYTMQR64J7OF@P TYS-YESB0PTMUPI-540522578919-UPI,0000540522578919,0.0,130.0,82346.75
08/02/25,UPI,UPI-TRUE CREDITS-TRUECREDITS.RZP@AXISBAN K-UTIB0000100-503988778739-PAYVIARAZORPA Y,0000503988778739,0.0,4736.0,77610.75
08/02/25,UPI,UPI-NORTHERN ARC-NORTHERNARC495902.RZP@A XISBANK-UTIB0000100-650965540395-POWERED BY SMARTCO BAKERY-PAYTMQR6EC847@PTYS -YESB0PTMUPI-518078527938-UPI,0000650965540395,0.0,21396.54,56214.21
09/02/25,UPI,UPI-JURRU RAHUL YADAV-Q758292524@YBL-YE SB0YBLUPI-540603793281-UPI,0000540603793281,0.0,45.0,56169.21
09/02/25,UPI,UPI-SOMALWAR SHRINIVAS-SOMALWAR73@OKSBI -SBIN0010356-504022648788-UPI,0000504022648788,1240.0,0.0,57409.21
09/02/25,UPI,UPI-MURALIKRISHNA VEGETA-GPAY-1124611311 2@OKBIZAXIS-UTIB0000553-540645784673-UPI,0000540645784673,0.0,320.0,57089.21
09/02/25,UPI,UPI-DAMODAR NAYAK-PAYTMQR60NRMT@PTYS-YES B0PTMUPI-540632496477-UPI,0000540632496477,0.0,180.0,56909.21
09/02/25,UPI,UPI-GANTA SUJATHA-SUJATHAGANAT13@OKHDFC BANK-SBIN0005895-540646993122-UPI,0000540646993122,0.0,6000.0,50909.21
09/02/25,UPI,UPI-TALAKHIREANIL2OKICIC-TALAKHIREANIL-2 @OKICICI-HDFC0CTGCUB-504006698955-UPI,0000504006698955,0.0,600.0,50309.21
09/02/25,UPI,UPI-FRESH FLOWERS-GPAY-11245168920@OKBIZ AXIS-UTIB0000553-540618402328-UPI,0000540618402328,0.0,300.0,50009.21
09/02/25,UPI,UPI-AIRTEL RECHARGE-AIRTELPREDIRECT1@YBL -YESB0YBLUPI-138246297303-PAYMENT FROM P HONE,0000138246297303,0.0,492.0,49517.21
09/02/25,UPI,UPI-T NAVEEN-NAVEENTADAKALA653@OKAXIS-K KBK0007473-540635516886-UPI,0000540635516886,0.0,250.0,49267.21
09/02/25,UPI,UPI-LIBERTYSRIHARIOKICIC-LIBERTYSRIHARI@ OKICICI-BKID0008627-540655136624-UPI,0000540655136624,0.0,1300.0,47967.21
10/02/25,UPI,UPI-JURRU RAHUL YADAV-Q758292524@YBL-YE SB0YBLUPI-504175641030-UPI,0000504175641030,0.0,45.0,47922.21
10/02/25,,ATW-416021XXXXXX2657-S1ANHD25-HYDERABAD,0000000000004261,0.0,20000.0,27922.21
10/02/25,,ATW-416021XXXXXX2657-S1ANHD25-HYDERABAD,0000000000004262,0.0,20000.0,7922.21
10/02/25,,ATW-416021XXXXXX2657-S1ANHD25-HYDERABAD,0000000000004262,0.0,-20000.0,27922.21
10/02/25,,ATW-416021XXXXXX2657-COHYD021-HYDERABAD,0000000000009773,0.0,10000.0,17922.21
10/02/25,,ATW-416021XXXXXX2657-COHYD021-HYDERABAD,0000000000009774,0.0,10000.0,7922.21
10/02/25,UPI,UPI-M ANIL YADAV-ANILYADAV63473-1@OKSBI- UBIN0803219-504170251485-UPI,0000504170251485,0.0,600.0,7322.21
10/02/25,UPI,UPI-NAGRAJ-MUKKERLANAGRAJ@OKAXIS-UBIN080 3219-540793828169-UPI,0000540793828169,5000.0,0.0,12322.21
10/02/25,IMPS,IMPS-504125109961-APIBANKING-RATN-XXXXXX XXXXXX0168-ACCOUNTVALIDATION,0000504125109961,1.0,0.0,12323.21
10/02/25,IMPS,IMPS-504111818625-UPMOVE CAPITAL PVT. -I CIC-XXXXXXXX1163-6995747LOANSETTLEMENT,0000504111818625,41873.0,0.0,54196.21
10/02/25,UPI,UPI-VINITA JAIN -VSEHLOTH@OKSBI-SBIN000 2769-504196018104-UPI,0000504196018104,680.0,0.0,54876.21
10/02/25,UPI,UPI-BHARATHI BHARATHI-BHARTHI9573@YBL-S BIN0020701-540756150695-UPI,0000540756150695,0.0,6000.0,48876.21
10/02/25,,ATW-416021XXXXXX2657-P3ENTS55-HYDERABAD,0000000000003278,0.0,4000.0,44876.21
10/02/25,UPI,UPI-LIBERTYSRIHARIOKICIC-LIBERTYSRIHARI@ OKICICI-BKID0008627-504142672505-UPI,0000504142672505,0.0,1300.0,43576.21
10/02/25,UPI,UPI-NAYAKOTI SHEKAR-MAHESH.SHEKER09-1@OK AXIS-TSAB0000103-540779185433-UPI,0000540779185433,0.0,300.0,43276.21
10/02/25,UPI,UPI-KOLLAPURAM MALLIKARJ-MALLIKARJUNKOLA PURAM@OKSBI-HDFC0000218-540726997529-UPI,0000540726997529,0.0,210.0,43066.21
11/02/25,UPI,UPI-NAGRAJ-MUKKERLANAGRAJ@OKAXIS-UBIN080 3219-504281710648-UPI,0000504281710648,0.0,1200.0,41866.21
11/02/25,UPI,UPI-JURRU RAHUL YADAV-Q758292524@YBL-YE FROM PHONE,0000540879507263,0.0,45.0,41821.21
11/02/25,UPI,UPI-ARRALO RANI-8309617327@AXL-FDRL00013 32-046263854651-PAYMENT FROM PHONE,0000046263854651,500.0,0.0,42321.21
11/02/25,UPI,UPI-LIBERTYSRIHARIOKICIC-LIBERTYSRIHARI@ OKICICI-BKID0008627-504217947660-UPI,0000504217947660,0.0,1300.0,41021.21
12/02/25,UPI,UPI-JURRU RAHUL YADAV-Q758292524@YBL-YE SB0YBLUPI-504307964837-UPI,0000504307964837,0.0,45.0,40976.21
12/02/25,UPI,UPI-TIRIVISETTY SATYANAR-Q628175389@YBL- YESB0YBLUPI-540978277709-UPI,0000540978277709,0.0,60.0,40916.21
12/02/25,UPI,UPI-MANE NAVNEETHA-PAYTMQR66FHIY@PTYS-YE SB0PTMUPI-504322355817-UPI,0000504322355817,0.0,40.0,40876.21
12/02/25,POS,POS 416021XXXXXX2657 AVENUE SUPERMART,0000000000017244,0.0,5187.51,35688.7
12/02/25,UPI,UPI-HP PETROL PUMP PETR-Q561100586@YBL- YESB0YBLUPI-540999403660-UPI,0000540999403660,0.0,250.0,35438.7
12/02/25,UPI,UPI-NAYAKOTI SHEKAR-MAHESH.SHEKER09-1@OK AXIS-TSAB0000103-540909103582-UPI,0000540909103582,0.0,500.0,34938.7
12/02/25,UPI,UPI-KOLLAPURAM MALLIKARJ-MALLIKARJUNKOLA PURAM@OKSBI-HDFC0000218-504381594250-UPI,0000504381594250,0.0,100.0,34838.7
12/02/25,UPI,UPI-LIBERTYSRIHARIOKICIC-LIBERTYSRIHARI@ OKICICI-BKID0008627-504343613376-UPI,0000504343613376,0.0,1300.0,33538.7
13/02/25,UPI,UPI-JURRU RAHUL YADAV-Q758292524@YBL-YE SB0YBLUPI-504449319327-UPI,0000504449319327,0.0,45.0,33493.7
13/02/25,UPI,UPI-MANE NAVNEETHA-PAYTMQR66FHIY@PTYS-YE SB0PTMUPI-504488125070-UPI,0000504488125070,0.0,30.0,33463.7
13/02/25,UPI,UPI-JIO RECHARGE-JIOINAPPDIRECT1@YBL-YES,0000729777049952,0.0,352.0,33111.7
13/02/25,UPI,UPI-AIRTEL RECHARGE-AIRTELPREDIRECT2@YBL -YESB0YBLUPI-619467595366-PAYMENT FROM P HONE,0000619467595366,0.0,302.0,32809.7
13/02/25,UPI,UPI-MISS NEELA SHAILAJA-NSHAILAJA30@OKA XIS-CBIN0283299-541026942506-UPI,0000541026942506,0.0,300.0,32509.7
13/02/25,UPI,UPI-JONNA KANTI SRIKANTH-PAYTMQR28100505 01011BHTBXXSE9UQ@PAYTM-YESB0PTMUPI-54101 9334604-UPI,0000541019334604,0.0,155.0,32354.7
13/02/25,UPI,UPI-RAMESH GUPTA-PAYTMQR60K6AE@PTYS-YESB 0PTMUPI-504435058297-UPI,0000504435058297,0.0,99.0,32255.7
13/02/25,UPI,UPI-DUDIKIKAR SHAILAJA-8367261624@AXL- KKBK0007472-008886823107-PAYMENT FROM PH ONE,0000008886823107,300.0,0.0,32555.7
13/02/25,UPI,UPI-RATNADEEP SUPERMARKE-PAYTM-64471141@ PTYS-YESB0PTMUPI-504493760286-UPI,0000504493760286,0.0,297.0,32258.7
13/02/25,UPI,UPI-VISHAL VISHAL-9794915093@AXL-SBIN00 03512-541077965891-UPI,0000541077965891,0.0,40.0,32218.7
13/02/25,UPI,UPI-LIBERTYSRIHARIOKICIC-LIBERTYSRIHARI@ OKICICI-BKID0008627-541024769726-UPI,0000541024769726,0.0,1300.0,30918.7
14/02/25,UPI,UPI-JURRU RAHUL YADAV-Q758292524@YBL-YE SB0YBLUPI-504535681469-UPI,0000504535681469,0.0,195.0,30723.7
14/02/25,UPI,UPI-MARGAM VANI-VANIMARGAM510@OKSBI-SBI N0021100-504552248929-UPI,0000504552248929,40000.0,0.0,70723.7
14/02/25,UPI,UPI-MR G SATISH-PAYTMQRQVKQF4ABSV@PAYTM- YESB0PTMUPI-391439967687-PAYMENT FROM PH ONE,0000391439967687,0.0,250.0,70473.7
14/02/25,UPI,UPI-POTHKANI SWAPNA-PAYTMQR64SEC6@PTYS-Y ESB0PTMUPI-541152691720-UPI,0000541152691720,0.0,25.0,70448.7
14/02/25,UPI,UPI-PHONEPE-BBPSBP@YBL-YESB0YBLUPI-95537 9793062-PAYMENT FROM PHONE,0000955379793062,0.0,855.0,69593.7
14/02/25,UPI,UPI-NANDAGIRI ANURADHA-9700640491@YBL-SB IN0002769-530330334668-PAYMENT FROM PHON E,0000530330334668,0.0,16830.0,52763.7
14/02/25,UPI,UPI-GAYATHRI FAST FOOD-GPAY-11244304146@ OKBIZAXIS-UTIB0000553-504550314485-UPI,0000504550314485,0.0,120.0,52643.7
14/02/25,UPI,UPI-SURESH NLAXMAIAH BR-Q995279325@YBL- YESB0YBLUPI-504502509213-UPI,0000504502509213,0.0,250.0,52393.7
14/02/25,UPI,UPI-JURRU RAHUL YADAV-Q758292524@YBL-YE SB0YBLUPI-504522410777-UPI,0000504522410777,0.0,160.0,52233.7
14/02/25,UPI,UPI-MR DIGLESHA VINODKU-Q629080500@YBL- YESB0YBLUPI-541169247661-UPI,0000541169247661,0.0,140.0,52093.7
14/02/25,UPI,UPI-NAGRAJ-MUKKERLANAGRAJ@OKAXIS-UBIN080 3219-541119836210-UPI,0000541119836210,0.0,2000.0,50093.7
14/02/25,UPI,UPI-LIBERTYSRIHARIOKICIC-LIBERTYSRIHARI@ OKICICI-BKID0008627-504593235112-UPI,0000504593235112,0.0,1300.0,48793.7
15/02/25,UPI,UPI-JURRU RAHUL YADAV-Q758292524@YBL-YE SB0YBLUPI-504682043726-UPI,0000504682043726,0.0,195.0,48598.7
15/02/25,UPI,UPI-M ANIL YADAV-ANILYADAV63473-1@OKSBI- UBIN0803219-541295946556-UPI,0000541295946556,0.0,600.0,47998.7
15/02/25,UPI,UPI-TIRIVISETTY SATYANAR-Q628175389@YBL- YESB0YBLUPI-504613441960-UPI,0000504613441960,0.0,30.0,47968.7
15/02/25,UPI,UPI-PANYAM MANJULA-MANJUPANYAM@OKSBI-SB IN0007641-504691422498-UPI,0000504691422498,500.0,0.0,48468.7
15/02/25,UPI,UPI-RAPARTI SRIHARI-9493207195@YBL-BKID0 008627-644512758981-PAYMENT FROM PHONE,0000644512758981,0.0,13000.0,35468.7
15/02/25,,ACH D- LIC OF INDIA-6577926590225,0000008029197046,0.0,2488.0,32980.7
15/02/25,UPI,UPI-ABSIPURAM PRASOONA-9948434877@YBL-S BIN0020083-844478123540-ADVANCE,0000844478123540,1500.0,0.0,34480.7
15/02/25,UPI,UPI-MR RAPATHI NARSING -Q084776718@YBL- YESB0YBLUPI-504661443337-UPI,0000504661443337,0.0,120.0,34360.7
15/02/25,,ATW-416021XXXXXX2657-S1ANHD25-HYDERABAD,0000000000004649,0.0,20000.0,14360.7
15/02/25,,ATW-416021XXXXXX2657-S1ANHD25-HYDERABAD,0000000000004650,0.0,10000.0,4360.7
15/02/25,,ATW-416021XXXXXX2657-S1AWHY59-HYDERABAD,0000000000009591,0.0,3000.0,1360.7
15/02/25,UPI,UPI-PURUSHOTTAM ADHIKAR-9005457070@AXL- SBIN0012223-689901896066-PAYMENT FROM PH ONE,0000689901896066,525.0,0.0,1885.7
15/02/25,UPI,UPI-KEERTHI NEELI-SAI.TAANYA26@OKAXIS-BA RB0BARKAT-541295052556-UPI,0000541295052556,1000.0,0.0,2885.7
15/02/25,UPI,UPI-SASHIKALA BHANDARI-9032117972@IBL-S BIN0005895-500304044194-PAYMENT FROM PHO NE,0000500304044194,2000.0,0.0,4885.7
15/02/25,UPI,UPI-MOHD AHMED ALI-AQUA.AHMED98@AXL-UTIB 0001808-196878584115-PAYMENT FROM PHONE,0000196878584115,270.0,0.0,5155.7
15/02/25,UPI,UPI-LIBERTYSRIHARIOKICIC-LIBERTYSRIHARI@ OKICICI-BKID0008627-504603999805-UPI,0000504603999805,0.0,1300.0,3855.7
15/02/25,UPI,UPI-A NARESH KUMAR-Q749466560@YBL-YESB0Y BLUPI-541241286095-UPI,0000541241286095,0.0,12.0,3843.7
16/02/25,UPI,UPI-JURRU RAHUL YADAV-Q758292524@YBL-YE SB0YBLUPI-541360299346-UPI,0000541360299346,0.0,195.0,3648.7
16/02/25,UPI,UPI-DAMODAR NAYAK-PAYTMQR60NRMT@PTYS-YES B0PTMUPI-541374214496-UPI,0000541374214496,0.0,30.0,3618.7
16/02/25,UPI,UPI-14067 APOLLO PHARMAC-PAYTM-83521556@ PTYS-YESB0PTMUPI-504702104663-UPI,0000504702104663,0.0,229.0,3389.7
16/02/25,UPI,UPI-BILLA S-9700452204-2@YBL-HSBC0500002 -390535098341-PAYMENT FROM PHONE,0000390535098341,1240.0,0.0,4629.7
16/02/25,UPI,UPI-SRIRAGHAVENDRATIFFIN-PAYTMQR17U07CIZ 21@PAYTM-YESB0PTMUPI-504748332085-UPI,0000504748332085,0.0,12.0,4617.7
16/02/25,UPI,UPI-JIO RECHARGE-JIOINAPPDIRECT1@YBL-YES B0YBLUPI-321412951507-PAYMENT FROM PHONE,0000321412951507,0.0,29.0,4588.7
16/02/25,UPI,UPI-JURRU RAHUL YADAV-Q758292524@YBL-YE SB0YBLUPI-504783248214-UPI,0000504783248214,0.0,160.0,4428.7
16/02/25,UPI,UPI-LIBERTYSRIHARIOKICIC-LIBERTYSRIHARI@ OKICICI-BKID0008627-504735538699-UPI,0000504735538699,0.0,1300.0,3128.7
16/02/25,UPI,UPI-B VINOD KUMAR-BALERAOVINOD077@OKSBI- CNRB0000033-504700439590-UPI,0000504700439590,0.0,3000.0,128.7
16/02/25,UPI,UPI-LAKSHMI APPALA-LAKSHME1202@OKSBI-SB IN0005895-504770579604-UPI,0000504770579604,1500.0,0.0,1628.7
16/02/25,UPI,UPI-VARTHYAVATH THIRUPAT-THIRUPATHI1981N AIK@YBL-ANDB0001424-940371615082-PAYMENT FROM PHONE,0000940371615082,1000.0,0.0,2628.7
17/02/25,UPI,UPI-M ARVIND-ARVINDYADAV69552@OKAXIS-K KBK0007473-541432354253-UPI,0000541432354253,0.0,1500.0,1128.7
17/02/25,UPI,UPI-MOHD FAREED-PAYTMQR66O0Y1@PTYS-YESB0 PTMUPI-541420253600-UPI,0000541420253600,0.0,20.0,1108.7
17/02/25,UPI,UPI-SRI BALAJI BAKERY-PAYTMQR66O95U@PTYS -YESB0PTMUPI-541429659649-UPI,0000541429659649,0.0,40.0,1068.7
17/02/25,UPI,UPI-KUMBUM VIJAYA LAKSHM-LAKSHMIVIJAYA85 60@OKHDFCBANK-HDFC0000081-100159746353-1 LITRE,0000100159746353,45.0,0.0,1113.7
17/02/25,UPI,UPI-JIO RECHARGE-JIOINAPPDIRECT1@YBL-YES B0YBLUPI-255016159488-PAYMENT FROM PHONE,0000255016159488,0.0,302.0,811.7
17/02/25,,NET PI TO HSL SEC A/C 4114733-0060234002,0000000611334880,0.0,24.0,787.7
17/02/25,UPI,UPI-JURRU RAHUL YADAV-Q758292524@YBL-YE SB0YBLUPI-541452994890-UPI,0000541452994890,0.0,80.0,707.7
18/02/25,UPI,UPI-JURRU RAHUL YADAV-Q758292524@YBL-YE SB0YBLUPI-504929206990-UPI,0000504929206990,0.0,165.0,542.7
18/02/25,UPI,UPI-MANE NAVNEETHA-PAYTMQR5X7M3L@PTYS-YE SB0PTMUPI-541516012993-UPI,0000541516012993,0.0,30.0,512.7
18/02/25,UPI,UPI-NEELAM SETHI-NEELAMSETHI741@OKAXIS-U BIN0534773-541530889985-UPI,0000541530889985,1000.0,0.0,1512.7
18/02/25,UPI,UPI-AKSHAY CHINTALA-9849868607@AXISB-CNR B0000033-504992291952-PAID VIA CRED AND,0000504992291952,1000.0,0.0,2512.7
18/02/25,UPI,UPI-M MADHU YADAV-9985065404-2@YBL-SBIN 0006645-524930407168-PAYMENT FROM PHONE,0000524930407168,2300.0,0.0,4812.7
18/02/25,UPI,UPI-M MADHU YADAV-9985065404-2@YBL-SBIN 0006645-777455068313-PAYMENT FROM PHONE,0000777455068313,1900.0,0.0,6712.7
18/02/25,UPI,UPI-BHARATHI BHARATHI-BHARTHI9573@YBL-S BIN0020701-541552738813-UPI,0000541552738813,0.0,6000.0,712.7
18/02/25,UPI,UPI-MR MADHU SUDHAN GHOD-MADHUSUDHANGHOD KE-2@OKHDFCBANK-MAHB0000383-100231424744 -UPI,0000100231424744,2000.0,0.0,2712.7
18/02/25,UPI,UPI-LIBERTYSRIHARIOKICIC-LIBERTYSRIHARI@ OKICICI-BKID0008627-504917343309-UPI,0000504917343309,0.0,1300.0,1412.7
18/02/25,,NET PI TO HSL SEC A/C 4114733-0060234002,0000000611825985,0.0,71.0,1341.7
18/02/25,UPI,UPI-MADHURI MARAM-LIPIKAMARAM@OKICICI-IC IC0000008-504961268030-UPI,0000504961268030,1000.0,0.0,2341.7
19/02/25,UPI,UPI-A NARESH KUMAR-Q749466560@YBL-YESB0Y BLUPI-505083575856-UPI,0000505083575856,0.0,25.0,2316.7
19/02/25,UPI,UPI-MARGAM VANI-VANIMARGAM510@OKSBI-SBI N0021100-505032277085-UPI,0000505032277085,50000.0,0.0,52316.7
19/02/25,UPI,UPI-MOSALI RAJITHA-8328510142@YBL-CNRB0 000033-942495364945-PAYMENT FROM PHONE,0000942495364945,0.0,18000.0,34316.7
19/02/25,UPI,UPI-G PRASHANTH-7702920675@AXL-UTIB00008 81-190301122206-PAYMENT FROM PHONE,0000190301122206,0.0,1375.0,32941.7
19/02/25,IMPS,IMPS-505012751888-MUTHOOTFINCORPLTD-UTIB -XXXXXXXXXXX2057-TREASURYDISBURSAL,0000505012751888,48390.0,0.0,81331.7
19/02/25,UPI,UPI-SATHANI MAMATHA-SMAMMU2908@OKSBI-SB IN0012916-519558234613-PAYMENT FROM PHON E,0000519558234613,0.0,390.0,80941.7
19/02/25,UPI,UPI-PANDRI KRISHNAVENI-BHARATPE09914465 228@YESBANKLTD-YESB0YESUPI-541665204144- PAY TO PANDRI KRI,0000541665204144,0.0,200.0,80741.7
19/02/25,UPI,UPI-AMBICA AUTOMATIC XER-PPR.13014.30082 023.00131368@CNRB-CNRB0013014-5416240936 68-UPI,0000541624093668,0.0,350.0,80391.7
19/02/25,UPI,UPI-SAMBA SARITHA-8555955685@YBL-KKBK00 07463-620715550817-PAYMENT FROM PHONE,0000620715550817,0.0,32502.0,47889.7
19/02/25,UPI,UPI-IRFAN MOHAMMED-BHARATPE.90072223140 @FBPE-FDRL0001382-505065407972-PAY TO BH ARATPE ME,0000505065407972,0.0,40.0,47849.7
19/02/25,UPI,UPI-JURRU RAHUL YADAV-Q758292524@YBL-YE SB0YBLUPI-541626810361-UPI,0000541626810361,0.0,80.0,47769.7
19/02/25,UPI,UPI-NAYAKOTI SHEKAR-MAHESH.SHEKER09-1@OK AXIS-TSAB0000103-541631021850-UPI,0000541631021850,0.0,500.0,47269.7
19/02/25,UPI,UPI-LIBERTYSRIHARIOKICIC-LIBERTYSRIHARI@ OKICICI-BKID0008627-505066627011-UPI,0000505066627011,0.0,1300.0,45969.7
19/02/25,UPI,UPI-ABDUL SAYEED KHAN-SAYEEDK6176@OKHDFC BANK-BARB0ADAHYD-505086325284-UPI,0000505086325284,0.0,140.0,45829.7
19/02/25,UPI,UPI-NAGRAJ-MUKKERLANAGRAJ@OKAXIS-UBIN080 3219-541642025613-UPI,0000541642025613,2000.0,0.0,47829.7
19/02/25,UPI,UPI-NAGRAJ-MUKKERLANAGRAJ@OKAXIS-UBIN080 3219-541680520944-UPI,0000541680520944,18000.0,0.0,65829.7
19/02/25,UPI,UPI-SAMBA SARITHA-8555955685@YBL-KKBK00 07463-633236906356-PAYMENT FROM PHONE,0000633236906356,0.0,15000.0,50829.7
19/02/25,UPI,UPI-SRI BALAJI BAKERY-PAYTMQR66O95U@PTYS -YESB0PTMUPI-505078026106-UPI,0000505078026106,0.0,140.0,50689.7
20/02/25,UPI,UPI-JURRU RAHUL YADAV-Q758292524@YBL-YE SB0YBLUPI-541717333830-UPI,0000541717333830,0.0,270.0,50419.7
20/02/25,UPI,UPI-IKF HOME FINANCE LIM-IKFHOMEFINANCEL 60.RZP@ICICI-ICIC0DC0099-916763725851-PX RPJHYZZXOTHH,0000916763725851,0.0,26555.9,23863.8
20/02/25,,NWD-416021XXXXXX2657-12947623-QUTUBULLAP UR,0000505112023487,0.0,3500.0,20363.8
20/02/25,UPI,UPI-HP PETROL PUMP PETR-Q066015777@YBL- YESB0YBLUPI-541743769926-UPI,0000541743769926,0.0,250.0,20113.8
20/02/25,UPI,UPI-SAMBA SARITHA-8555955685@YBL-KKBK00 07463-313941540228-PAYMENT FROM PHONE,0000313941540228,0.0,15000.0,5113.8
20/02/25,UPI,UPI-LIBERTYSRIHARIOKICIC-LIBERTYSRIHARI@ OKICICI-BKID0008627-541708192851-UPI,0000541708192851,0.0,1300.0,3813.8
20/02/25,UPI,UPI-KATALA SRIKANTH-KATALASRIKANTH-2@OKS BI-BKID0005647-541718890251-UPI,0000541718890251,0.0,1000.0,2813.8
21/02/25,UPI,UPI-JURRU RAHUL YADAV-Q758292524@YBL-YE SB0YBLUPI-541855103383-UPI,0000541855103383,0.0,105.0,2708.8
21/02/25,UPI,UPI-MOHD FAREED-PAYTMQR66O0Y1@PTYS-YESB0 PTMUPI-505243287838-UPI,0000505243287838,0.0,20.0,2688.8
21/02/25,UPI,UPI-MOHD ABDUL WASEEM-PAYTM.S14JLFV@PTY- YESB0MCHUPI-505210002058-UPI,0000505210002058,0.0,50.0,2638.8
21/02/25,UPI,UPI-LAXMI NARSHIMA SWAMY-GPAY-1124082018 5@OKBIZAXIS-UTIB0000553-505273906474-UPI,0000505273906474,0.0,10.0,2628.8
21/02/25,,.ACH DEBIT RETURN CHARGES 040225 040225- MIR2505085200474,MIR2505085200474,0.0,531.0,2097.8
21/02/25,UPI,UPI-M ANIL YADAV-ANILYADAV63473-1@OKHDFC BANK-UBIN0803219-100362578266-CASH,0000100362578266,10000.0,0.0,12097.8
21/02/25,UPI,UPI-SRI BALAJI BAKERY-PAYTMQR66O95U@PTYS -YESB0PTMUPI-541853995113-UPI,0000541853995113,0.0,10.0,12087.8
21/02/25,UPI,UPI-BASHAMONI YADAIAH-9848592935@YBL-SB IN0021115-505222094992-UPI,0000505222094992,0.0,800.0,11287.8
21/02/25,UPI,UPI-M ANIL YADAV-ANILYADAV63473-1@OKHDFC BANK-UBIN0803219-100364802177-CASH,0000100364802177,3000.0,0.0,14287.8
21/02/25,,Transaction,9915346935425/SBIEPYREGSTAMSDEPTTE,0.0,13961.8,326.0
21/02/25,UPI,UPI-BASHAMONI YADAIAH-9848592935@YBL-SB IN0021115-364453521427-PAYMENT FROM PHON E,0000364453521427,0.0,130.0,196.0
21/02/25,UPI,UPI-JURRU RAHUL YADAV-Q758292524@YBL-YE SB0YBLUPI-541828129717-UPI,0000541828129717,0.0,120.0,76.0
21/02/25,UPI,UPI-MOHD AHMED ALI-AQUA.AHMED98@AXL-UTIB 0001808-624356885051-PAYMENT FROM PHONE,0000624356885051,450.0,0.0,526.0
21/02/25,POS,CASH DEPOSIT-XXXXXXXXXX1847-BARKATPURA,0000000000003392,12500.0,0.0,13026.0
21/02/25,UPI,UPI-LIBERTYSRIHARIOKICIC-LIBERTYSRIHARI@ OKICICI-BKID0008627-541828841139-UPI,0000541828841139,0.0,1300.0,11726.0
21/02/25,UPI,UPI-SRI BALAJI WINES KAC-GPAY-1125640798 6@OKBIZAXIS-UTIB0000553-505282040394-UPI,0000505282040394,0.0,210.0,11516.0
21/02/25,UPI,UPI-JIO RECHARGE-JIOINAPPDIRECT1@YBL-YES B0YBLUPI-871379215117-PAYMENT FROM PHONE,0000871379215117,0.0,29.0,11487.0
21/02/25,UPI,UPI-M LIKITHA-LIKITHAMARGAM93-1@OKICICI- HDFC0009182-505230453942-UPI,0000505230453942,33000.0,0.0,44487.0
22/02/25,UPI,UPI-JURRU RAHUL YADAV-Q758292524@YBL-YE SB0YBLUPI-541912250917-UPI,0000541912250917,0.0,165.0,44322.0
22/02/25,UPI,UPI-MAADEVI-Q552508687@YBL-YESB0YBLUPI-5 05367651884-UPI,0000505367651884,0.0,180.0,44142.0
22/02/25,UPI,UPI-MANE NAVNEETHA-PAYTMQR5X7M3L@PTYS-YE SB0PTMUPI-505366549909-UPI,0000505366549909,0.0,30.0,44112.0
22/02/25,UPI,UPI-MR MARYPEDDY YADAIAH-PAYTMQR1QEBB0LQ 0U@PAYTM-YESB0PTMUPI-505307855565-UPI,0000505307855565,0.0,45.0,44067.0
22/02/25,UPI,UPI-JAI SANTHOSHI MATHA-GPAY-11258716727 @OKBIZAXIS-UTIB0000553-505312754804-UPI,0000505312754804,0.0,10.0,44057.0
22/02/25,UPI,UPI-SIDDIQUA FATIMA-SIDDIQUAFATIMA6@OKS BI-SBIN0000847-505304066477-UPI,0000505304066477,0.0,50.0,44007.0
22/02/25,UPI,UPI-LIBERTYSRIHARIOKICIC-LIBERTYSRIHARI@ OKICICI-BKID0008627-541975586416-UPI,0000541975586416,0.0,1300.0,42707.0
22/02/25,UPI,UPI-MAHENDRA JALA-JALAMAHENDRA@OKAXIS-K KBK0007466-541905289620-UPI,0000541905289620,0.0,30000.0,12707.0
22/02/25,UPI,UPI-JURRU RAHUL YADAV-Q758292524@YBL-YE SB0YBLUPI-505319087329-UPI,0000505319087329,0.0,160.0,12547.0
22/02/25,UPI,UPI-BHARKATHPURA-BHARKATHPURA.60983458@H DFCBANK-HDFC0000001-505374203704-UPI,0000505374203704,0.0,254.0,12293.0
22/02/25,UPI,UPI-KACHIGUDA BAKERS-GPAY-11247416351@OK BIZAXIS-UTIB0000553-505368703716-UPI,0000505368703716,0.0,58.0,12235.0
23/02/25,UPI,UPI-JURRU RAHUL YADAV-Q758292524@YBL-YE SB0YBLUPI-542078406935-UPI,0000542078406935,0.0,165.0,12070.0
23/02/25,UPI,UPI-MOHAMMED MUSTAFA-7036435587@YBL-SBI N0020309-747368894784-PAYMENT FROM PHONE,0000747368894784,1.0,0.0,12071.0
23/02/25,UPI,UPI-MOHAMMED MUSTAFA-7036435587@YBL-SBI N0020309-524101443492-PAYMENT FROM PHONE,0000524101443492,30000.0,0.0,42071.0
23/02/25,UPI,UPI-MUNTHA RAMESH YADAV-RAMEESHM6666@YBL -BKID0008604-869325858594-PAYMENT FROM P HONE,0000869325858594,0.0,8000.0,34071.0
23/02/25,UPI,UPI-KEERTHI SWAPNA-Q784100836@YBL-YESB0Y BLUPI-505495711979-UPI,0000505495711979,0.0,50.0,34021.0
23/02/25,UPI,UPI-DAMODAR NAYAK-PAYTMQR3WBWCQEK4N@PAYT M-YESB0PTMUPI-505468101539-UPI,0000505468101539,0.0,170.0,33851.0
23/02/25,UPI,UPI-MANE NAVNEETHA-PAYTMQR5X7M3L@PTYS-YE SB0PTMUPI-505401612208-UPI,0000505401612208,0.0,30.0,33821.0
23/02/25,UPI,UPI-MOHD SARWAR KHAN-Q781060604@YBL-YESB 0YBLUPI-505475527525-UPI,0000505475527525,0.0,20.0,33801.0
23/02/25,UPI,UPI-RAPARTI SRIHARI-9493207195@YBL-BKID0 008627-748343195538-PAYMENT FROM PHONE,0000748343195538,0.0,10000.0,23801.0
23/02/25,UPI,UPI-SHAIK AKBER NLAXMAIA-Q093219408@YBL- YESB0YBLUPI-505421537070-UPI,0000505421537070,0.0,350.0,23451.0
23/02/25,UPI,UPI-PUNJAB WINES-Q837805642@YBL-YESB0YBL UPI-542082437530-UPI,0000542082437530,0.0,210.0,23241.0
23/02/25,UPI,UPI-MD SIRTAJ AHAMAD-Q970709978@YBL-YESB 0YBLUPI-505459839585-UPI,0000505459839585,0.0,30.0,23211.0
23/02/25,UPI,UPI-TALUKA SANDHYA RANI-BHARATPE.9007168 3232@FBPE-FDRL0001382-542087731097-PAY T O BHARATPE ME,0000542087731097,0.0,25.0,23186.0
23/02/25,UPI,UPI-LIBERTYSRIHARIOKICIC-LIBERTYSRIHARI@ OKICICI-BKID0008627-505475544999-UPI,0000505475544999,0.0,1300.0,21886.0
23/02/25,UPI,UPI-SREE BALAJI WINES-PAYTMQR5YDJY3@PTYS -YESB0PTMUPI-505417347568-UPI,0000505417347568,0.0,210.0,21676.0
23/02/25,UPI,UPI-HP PETROL PUMP PETR-Q139482159@YBL- YESB0YBLUPI-505414845104-UPI,0000505414845104,0.0,900.0,20776.0
23/02/25,UPI,UPI-GANTA SUJATHA-SUJATHAGANAT13@OKAXIS -SBIN0005895-505439144940-UPI,0000505439144940,1050.0,0.0,21826.0
23/02/25,UPI,UPI-DUDIKIKAR SHAILAJA-8367261624@AXL- KKBK0007472-717755011197-PAYMENT FROM PH ONE,0000717755011197,600.0,0.0,22426.0
24/02/25,UPI,UPI-M ANIL YADAV-ANILYADAV63473-1@OKSBI- UBIN0803219-505522663094-UPI,0000505522663094,0.0,600.0,21826.0
24/02/25,UPI,UPI-JURRU RAHUL YADAV-Q758292524@YBL-YE SB0YBLUPI-505518163010-UPI,0000505518163010,0.0,165.0,21661.0
24/02/25,UPI,UPI-TIRIVISETTY SATYANAR-Q628175389@YBL- YESB0YBLUPI-505592072251-UPI,0000505592072251,0.0,40.0,21621.0
24/02/25,UPI,UPI-P NAND KISHOR-BHARATPE.90069295183@F BPE-FDRL0001382-505599477677-PAY TO BHAR ATPE ME,0000505599477677,0.0,50.0,21571.0
24/02/25,UPI,UPI-PAKANATI NITISH-NITISHPAKANATI125@O KAXIS-TSAB0000114-542173164958-UPI,0000542173164958,0.0,1000.0,20571.0
24/02/25,UPI,UPI-TALARI SATHAIAH-Q342857875@YBL-YESB 0YBLUPI-505572773784-UPI,0000505572773784,0.0,20.0,20551.0
24/02/25,UPI,UPI-SANTHOSHA ARRA-SANTHU.SANTHOSHA2004 -1@OKAXIS-KKBK0007487-542117597100-UPI,0000542117597100,0.0,2500.0,18051.0
24/02/25,UPI,UPI-JURRU RAHUL YADAV-Q758292524@YBL-YE SB0YBLUPI-505505696810-UPI,0000505505696810,0.0,200.0,17851.0
24/02/25,UPI,UPI-MOHD AHMED ALI-AQUA.AHMED98@AXL-UTIB 0001808-624109844772-PAYMENT FROM PHONE,0000624109844772,270.0,0.0,18121.0
24/02/25,UPI,UPI-SANTHOSHA ARRA-SANTHU.SANTHOSHA2004 -1@OKAXIS-KKBK0007487-505590399862-UPI,0000505590399862,2500.0,0.0,20621.0
24/02/25,UPI,UPI-KOLLAPURAM MALLIKARJ-MALLIKARJUNKOLA PURAM@OKSBI-HDFC0000218-505581410399-UPI,0000505581410399,0.0,120.0,20501.0
24/02/25,UPI,UPI-LIBERTYSRIHARIOKICIC-LIBERTYSRIHARI@ OKICICI-BKID0008627-542169694812-UPI,0000542169694812,0.0,1300.0,19201.0
25/02/25,UPI,UPI-JURRU RAHUL YADAV-Q758292524@YBL-YE SB0YBLUPI-505659830725-UPI,0000505659830725,0.0,165.0,19036.0
25/02/25,UPI,UPI-MANE NAVNEETHA-PAYTMQR5X7M3L@PTYS-YE SB0PTMUPI-505665028022-UPI,0000505665028022,0.0,60.0,18976.0
25/02/25,UPI,UPI-M BIKSHAPATHI-PAYTMQR5YNFSD@PTYS-YES B0PTMUPI-505609231087-UPI,0000505609231087,0.0,100.0,18876.0
25/02/25,UPI,UPI-RAPARTI SRIHARI-9493207195@YBL-BKID0 008627-636131105850-PAYMENT FROM PHONE,0000636131105850,0.0,13000.0,5876.0
25/02/25,UPI,UPI-KURVA SHARATH KUMAR-Q920692112@YBL-Y ESB0YBLUPI-505615438823-UPI,0000505615438823,0.0,500.0,5376.0
25/02/25,UPI,UPI-NAGRAJ-MUKKERLANAGRAJ@OKAXIS-UBIN080 3219-542250376789-UPI,0000542250376789,240.0,0.0,5616.0
25/02/25,UPI,UPI-JURRU RAHUL YADAV-Q758292524@YBL-YE SB0YBLUPI-505614654102-UPI,0000505614654102,0.0,80.0,5536.0
25/02/25,,CHQ DEP - MICR CLG - WBO HYDERABAD: IKF HOME FINANCE LIMITED :FEDERAL BANK LTD,0000000000792588,1300000.0,0.0,1305536.0
25/02/25,UPI,UPI-JURRU RAHUL YADAV-9963019626@YBL-SB IN0007641-132072525946-PAYMENT FROM PHON E,0000132072525946,1000.0,0.0,1306536.0
25/02/25,UPI,UPI-M MADHU YADAV-M.MADHUYADAV261@YBL-KK BK0007463-812059487579-PAYMENT FROM PHON E,0000812059487579,0.0,6500.0,1300036.0
25/02/25,UPI,UPI-SUHAS MADHUKAR CHAUD-DRSUHAS2003@OKH DFCBANK-KKBK0001367-100584317405-UPI,0000100584317405,1000.0,0.0,1301036.0
25/02/25,UPI,UPI-M MADHU YADAV-M.MADHUYADAV261@YBL-KK BK0007463-372645630589-PAYMENT FROM PHON E,0000372645630589,0.0,1000.0,1300036.0
25/02/25,UPI,UPI-SUNLIGHTZ AGENCIES-ZUBAIROMAR@AXL-KK BK0007451-973329325208-PAYMENT FROM PHON E,0000973329325208,4000.0,0.0,1304036.0
25/02/25,UPI,UPI-M MADHU YADAV-M.MADHUYADAV261@YBL-KK BK0007463-386966688057-PAYMENT FROM PHON E,0000386966688057,0.0,1000.0,1303036.0
25/02/25,UPI,UPI-LIBERTYSRIHARIOKICIC-LIBERTYSRIHARI@ OKICICI-BKID0008627-505642364253-UPI,0000505642364253,0.0,1300.0,1301736.0
25/02/25,IMPS,IMPS-505620086542-INSTANTPAY-UTIB-XXXXXX XXXXX2361-NA,0000505620086542,1.0,0.0,1301737.0
25/02/25,IMPS,IMPS-505620965576-GIVIT INFOMATICS PRIVA TE LIMITED-YESB-XXXXXXXXXXX1232-16660 IS TRANSFERRED TO ACCOUNT WITH ID BENE29D7,0000505620965576,16660.0,0.0,1318397.0
25/02/25,UPI,UPI-PHONEPE-BBPSBP@YBL-YESB0YBLUPI-31243 3202750-PAYMENT FROM PHONE,0000312433202750,0.0,5975.42,1312421.58
26/02/25,UPI,UPI-JURRU RAHUL YADAV-Q758292524@YBL-YE SB0YBLUPI-505794571461-UPI,0000505794571461,0.0,145.0,1312276.58
26/02/25,UPI,UPI-GANTA SUJATHA-SUJATHAGANAT13@OKSBI- SBIN0005895-505790487761-UPI,0000505790487761,0.0,10000.0,1302276.58
26/02/25,NEFT,NEFT CR-ICIC0SF0002-FDPL FINANCE PRIVATE LIMITED-MMADHUYADAV-ICICN42025022655935,ICICN42025022655,6836.25,0.0,1309112.83
26/02/25,UPI,UPI-M LIKITHA-LIKITHAMARGAM93-1@OKICICI- HDFC0009182-542309005858-UPI,0000542309005858,12000.0,0.0,1321112.83
26/02/25,UPI,UPI-ARVOG-ARVOG.ESBZ@KOTAK-KKBK0000958-5 05772898418-PAY,0000505772898418,0.0,20500.93,1300611.9
26/02/25,UPI,UPI-SAMUDHRALA MANASA-MANASA31961@YBL-SB IN0RRDCGB-363707419100-PAYMENT FROM PHON E,0000363707419100,1000.0,0.0,1301611.9
26/02/25,UPI,UPI-JURRU RAHUL YADAV-Q758292524@YBL-YE SB0YBLUPI-542388024122-UPI,0000542388024122,0.0,80.0,1301531.9
26/02/25,UPI,UPI-MUKKERLA RAJESH YADA-MRYADAV3235@OKA XIS-KKBK0007473-505779763630-UPI,0000505779763630,100.0,0.0,1301631.9
27/02/25,UPI,UPI-LIBERTYSRIHARIOKICIC-LIBERTYSRIHARI@ OKICICI-BKID0008627-542474128001-UPI,0000542474128001,0.0,1300.0,1300331.9
27/02/25,UPI,UPI-JURRU RAHUL YADAV-Q758292524@YBL-YE SB0YBLUPI-542410833537-UPI,0000542410833537,0.0,120.0,1300211.9
27/02/25,UPI,UPI-JIO RECHARGE-JIOINAPPDIRECT@YBL-YESB 0YBLUPI-096612656391-PAYMENT FROM PHONE,0000096612656391,0.0,29.0,1300182.9
27/02/25,IMPS,IMPS-505819372206-M MADHU YADAV-KKBK-XXX XXX7813-CASH,0000505819372206,0.0,100000.0,1200182.9
27/02/25,IMPS,IMPS-505819371334-MUKKERLA MADHU-SBIN-XX XXXXX5940-CASH,0000505819371334,0.0,100000.0,1100182.9
27/02/25,UPI,UPI-PUNJAB WINES-Q239582492@YBL-YESB0YBL UPI-542480681431-UPI,0000542480681431,0.0,320.0,1099862.9
27/02/25,UPI,UPI-B RAJESHWARI-RAJESHWARIYADAV147-1@OK HDFCBANK-SBIN0RRDCGB-542427672021-UPI,0000542427672021,0.0,16140.0,1083722.9
27/02/25,UPI,UPI-M ANIL YADAV-ANILYADAV63473-1@OKSBI- UBIN0803219-542433081994-UPI,0000542433081994,0.0,17000.0,1066722.9
27/02/25,UPI,UPI-LIBERTYSRIHARIOKICIC-LIBERTYSRIHARI@ OKICICI-BKID0008627-542498978446-UPI,0000542498978446,0.0,1300.0,1065422.9
27/02/25,UPI,UPI-SOMALWAR SHRINIVAS-SOMALWAR73@OKSBI -SBIN0010356-542449079290-UPI,0000542449079290,0.0,10000.0,1055422.9
27/02/25,UPI,UPI-MAHENDRA JALA-JALAMAHENDRA@OKAXIS-K KBK0007466-542482172594-UPI,0000542482172594,0.0,32000.0,1023422.9
27/02/25,UPI,UPI-ANGEL LTD NSE-ANGELONENSE@HDFCBANK-H DFC0000001-542494391448-PAYINGANGELONE,0000542494391448,0.0,50000.0,973422.9
28/02/25,UPI,UPI-JURRU RAHUL YADAV-Q758292524@YBL-YE SB0YBLUPI-542598088124-UPI,0000542598088124,0.0,165.0,973257.9
28/02/25,IMPS,IMPS-505907376860-SRIDEVI JT1-ICIC-XXXXX XXX3198-CASH,0000505907376860,0.0,14000.0,959257.9
28/02/25,UPI,UPI-SURESH KUMAR HEERAKA-Q331650302@YBL- YESB0YBLUPI-542572296647-UPI,0000542572296647,0.0,800.0,958457.9
28/02/25,UPI,UPI-DAKSHINAMURTHY CH-9502007548@YBL-ICI C0000245-097802395126-PAYMENT FROM PHONE,0000097802395126,0.0,18200.0,940257.9
28/02/25,UPI,UPI-G PRASHANTH-7702920675@AXL-UTIB00008 81-964952587805-PAYMENT FROM PHONE,0000964952587805,0.0,2830.0,937427.9
28/02/25,UPI,UPI-MANE NAVNEETHA-PAYTMQR5X7M3L@PTYS-YE SB0PTMUPI-542501691795-UPI,0000542501691795,0.0,35.0,937392.9
28/02/25,UPI,UPI-SRI BALAJI BAKERY-PAYTMQR66O95U@PTYS -YESB0PTMUPI-505923904113-UPI,0000505923904113,0.0,50.0,937342.9
28/02/25,UPI,UPI-CHATAMONI RAJESHWARI-BHARATPE.900664 69721@FBPE-FDRL0001382-542572993344-PAY TO BHARATPE ME,0000542572993344,0.0,45.0,937297.9
28/02/25,NEFT,"NEFT DR-KKBK0007463-M MADHU YADAV-NETBAN K, MUM-HDFCN52025022884189672-CASH",HDFCN52025022884,0.0,150000.0,787297.9
28/02/25,,Transaction,50228703102117951489/PAYTMHEROFINCORP,0.0,238182.35,549115.55
28/02/25,,ZHDF7SC0E2E75M/BILLDKRATNAKARBANKLI,0000255977477129,0.0,6857.0,542258.55
28/02/25,UPI,UPI-PHONEPE-BBPSBP@YBL-YESB0YBLUPI-64404 7395192-PAYMENT FROM PHONE,0000644047395192,0.0,45585.3,496673.25
28/02/25,,Q13GPILUEVL8QD/RAZPRBLBANKCREDITCAR,0000255977464078,0.0,141408.0,355265.25
28/02/25,UPI,UPI-PHONEPE-BBPSBP@YBL-YESB0YBLUPI-56562 6910994-PAYMENT FROM PHONE,0000565626910994,0.0,9000.0,346265.25
28/02/25,,ATW-416021XXXXXX2657-P3ENTS55-HYDERABAD,0000000000006943,0.0,10000.0,336265.25
28/02/25,,ATW-416021XXXXXX2657-P3ENTS55-HYDERABAD,0000000000006944,0.0,10000.0,326265.25
28/02/25,IMPS,IMPS-505919388143-MUKKERLA MADHU-SBIN-XX XXXXX5940-CASH,0000505919388143,0.0,12000.0,314265.25
28/02/25,UPI,UPI-MARGAM VANI-VANIMARGAM510@OKSBI-SBI N0021100-505953625405-UPI,0000505953625405,18000.0,0.0,332265.25
28/02/25,NEFT,NEFT CR-ICIC0099999-ANGEL ONE LIMITED CL IENT AC-MUKKERLA MADHU YADAV-ICICN22025,ICICN22025022813,10000.0,0.0,342265.25
01/03/25,UPI,UPI-NARESH KUMAR YADAV-NARESHKUMARYADAV 59426@OKSBI-SBIN0016778-506048034146-UPI,0000506048034146,0.0,500.0,341765.25
01/03/25,UPI,UPI-MR MARYPEDDY YADAIAH-PAYTMQR1QEBB0LQ 0U@PAYTM-YESB0PTMUPI-506084655756-UPI,0000506084655756,0.0,45.0,341720.25
01/03/25,UPI,UPI-MAHENDARBAHETIOKICIC-MAHENDAR.BAHETI @OKICICI-ICIC0000040-506083151501-UPI,0000506083151501,0.0,3345.0,338375.25
01/03/25,UPI,UPI-SOMALWAR SHRINIVAS-SOMALWAR73@OKSBI -SBIN0010356-506080464294-UPI,0000506080464294,2520.0,0.0,340895.25
01/03/25,UPI,UPI-JAI SANTHOSHI MATHA-GPAY-11250766748 @OKBIZAXIS-UTIB0000553-506022560821-UPI,0000506022560821,0.0,10.0,340885.25
01/03/25,,ATW-416021XXXXXX2657-P3ENTS55-HYDERABAD,0000000000007123,0.0,10000.0,330885.25
01/03/25,,ATW-416021XXXXXX2657-P3ENTS55-HYDERABAD,0000000000007124,0.0,10000.0,320885.25
01/03/25,UPI,UPI-SHANTANU SUNIL MAHAJ-SHANTANUMAHAJAN 36@OKHDFCBANK-KKBK0000726-100763412571-M ARCH RENT,0000100763412571,2575.0,0.0,323460.25
01/03/25,UPI,UPI-MOHAMMED IRFAN-GPAY-11254060173@OKBI ZAXIS-UTIB0000553-506094675591-UPI,0000506094675591,0.0,50.0,323410.25
01/03/25,UPI,UPI-RITIKA MAHESWARI-MUNDADARITIKA8-1@O KHDFCBANK-CNRB0000033-506057072610-UPI,0000506057072610,0.0,360.0,323050.25
01/03/25,UPI,UPI-BUDUMURU BHARGAVI-6303219486-3@YBL- CNRB0000033-355619162471-PAYMENT FROM PH ONE,0000355619162471,1960.0,0.0,325010.25
01/03/25,UPI,UPI-MOHD AHMED ALI-AQUA.AHMED98@YBL-UTIB 0001808-876874645495-PAYMENT FROM PHONE,0000876874645495,0.0,50000.0,275010.25
01/03/25,UPI,UPI-SAFETY PACKAGING S-GPAY-1125633528 2@OKBIZAXIS-UTIB0000553-506064490917-UPI,0000506064490917,0.0,2200.0,272810.25
01/03/25,UPI,UPI-JONNA KANTI SRIKRIS-Q131493680@YBL- YESB0YBLUPI-542602801283-UPI,0000542602801283,0.0,90.0,272720.25
01/03/25,UPI,UPI-JIO RECHARGE-JIOINAPPDIRECT1@YBL-YES B0YBLUPI-326089209325-PAYMENT FROM PHONE,0000326089209325,0.0,29.0,272691.25
01/03/25,UPI,UPI-LIBERTYSRIHARIOKICIC-LIBERTYSRIHARI@ OKICICI-BKID0008627-506047195803-UPI,0000506047195803,0.0,1300.0,271391.25
01/03/25,UPI,UPI-GUBBA VENKATESH-GUBBAVENKATESH825@O KSBI-SBIN0007641-542624102902-UPI,0000542624102902,0.0,616.0,270775.25
01/03/25,UPI,UPI-BHAVESH GUPTA-PAYTMQR5C8BFA@PTYS-YES B0PTMUPI-506054899916-UPI,0000506054899916,0.0,100.0,270675.25
02/03/25,UPI,UPI-JURRU RAHUL YADAV-Q758292524@YBL-YE SB0YBLUPI-542720815738-UPI,0000542720815738,0.0,390.0,270285.25
02/03/25,UPI,UPI-MUNTHA RAMESH YADAV-RAMEESHM6666@YBL -BKID0008604-821831785550-PAYMENT FROM P HONE,0000821831785550,0.0,6000.0,264285.25
02/03/25,UPI,UPI-GADELA DHEERAJ KUMA-DHEERAJ7331@OKS BI-SBIN0007641-542722611841-UPI,0000542722611841,0.0,800.0,263485.25
02/03/25,UPI,UPI-MANE NAVNEETHA-PAYTMQR66O8TP@PTYS-YE SB0PTMUPI-542700923191-UPI,0000542700923191,0.0,60.0,263425.25
02/03/25,UPI,UPI-LAKSHMI APPALA-LAKSHME1202@OKSBI-SB IN0005895-506120957734-UPI,0000506120957734,1260.0,0.0,264685.25
02/03/25,UPI,UPI-KOUR H-HARDEEPKOUR24@OKSBI-HSBC05000 02-506122192370-UPI,0000506122192370,1260.0,0.0,265945.25
02/03/25,UPI,UPI-AKSHAY CHINTALA-9849868607@YESCRED- CNRB0000033-542711107781-PAID VIA CRED A ND,0000542711107781,350.0,0.0,266295.25
02/03/25,UPI,UPI-JANARDHAN FILL POINT-BPCLJANARDHANFI LLKACHIGUDA0008@YBL-YESB0YBLUPI-54279153 0972-PAYMENT FOR GTZ347,0000542791530972,0.0,250.0,266045.25
02/03/25,UPI,UPI-MUKKERLA GEETA SUDHA-GEETHAMUKKERLA- 1@OKAXIS-KKBK0007463-542706627277-UPI,0000542706627277,0.0,1500.0,264545.25
02/03/25,UPI,UPI-MAHENDRA JALA-JALAMAHENDRA@OKAXIS-K KBK0007466-542783246114-UPI,0000542783246114,0.0,12000.0,252545.25
02/03/25,UPI,UPI-LIBERTYSRIHARIOKICIC-LIBERTYSRIHARI@ OKICICI-BKID0008627-542776536112-UPI,0000542776536112,0.0,1300.0,251245.25
02/03/25,UPI,UPI-PANYAM MANJULA-MANJUPANYAM@OKSBI-SB IN0007641-506149093932-MILK,0000506149093932,1800.0,0.0,253045.25
02/03/25,UPI,UPI-NAYAKOTI SHEKAR-MAHESH.SHEKER09-1@OK AXIS-TSAB0000103-542714043113-UPI,0000542714043113,0.0,2000.0,251045.25
02/03/25,UPI,UPI-ZERODHA BROKING LTD-ZERODHABROKING@H DFCBANK-HDFC0000523-542712261695-9231295 706465979 Z,0000542712261695,0.0,10000.0,241045.25
03/03/25,UPI,UPI-JURRU RAHUL YADAV-Q758292524@YBL-YE SB0YBLUPI-542855087088-UPI,0000542855087088,0.0,225.0,240820.25
03/03/25,UPI,UPI-MANE NAVNEETHA-PAYTMQR66O8TP@PTYS-YE SB0PTMUPI-542868476740-UPI,0000542868476740,0.0,30.0,240790.25
03/03/25,UPI,UPI-MUKKAMI ANAND-ANAND.MUKKAMI-1@OKSBI -SBIN0000952-506267235607-FLAT 403 SREE KRIS,0000506267235607,620.0,0.0,241410.25
03/03/25,UPI,UPI-SRI BALAJI BAKERY-PAYTMQR66O95U@PTYS -YESB0PTMUPI-542894968184-UPI,0000542894968184,0.0,50.0,241360.25
03/03/25,UPI,UPI-RONAK NEELESH RUPARA-KUMARRONAK7@OKA XIS-HDFC0000545-542886170298-UPI,0000542886170298,877.5,0.0,242237.75
03/03/25,UPI,UPI-MADHURI MARAM-LIPIKAMARAM@OKICICI-IC IC0000008-542802276599-UPI,0000542802276599,1520.0,0.0,243757.75
03/03/25,UPI,UPI-ANGEL LTD NSE-ANGELONENSE@HDFCBANK-H DFC0000001-542853578292-PAYINGANGELONE,0000542853578292,0.0,7000.0,236757.75
03/03/25,UPI,UPI-ZERODHA BROKING LTD-ZERODHABROKING@H DFCBANK-HDFC0000523-542801861765-5610998 582794357 Z,0000542801861765,0.0,15000.0,221757.75
03/03/25,UPI,UPI-RAPARTI SRIHARI-9493207195@YBL-BKID0 008627-810757317606-PAYMENT FROM PHONE,0000810757317606,0.0,10000.0,211757.75
03/03/25,UPI,UPI-ANGEL LTD NSE-ANGELONENSE@HDFCBANK-H DFC0000001-542892581622-PAYINGANGELONE,0000542892581622,0.0,1000.0,210757.75
03/03/25,,BAJAJFIN_BF-1286306_115682200,000000000000000,0.0,9101.0,201656.75
03/03/25,,BAJAJFIN_BF-1286306_115677275,000000000000000,0.0,9503.0,192153.75
03/03/25,UPI,UPI-GOGA ELECTRONICS-9849436607@AXL-APMC 0000006-669717256235-PAYMENT FROM PHONE,0000669717256235,5750.0,0.0,197903.75
03/03/25,UPI,UPI-VARAKALLA SRINIVAS-9603496797@YBL-S BIN0002772-585304771690-PAYMENT FROM PHO NE,0000585304771690,0.0,10000.0,187903.75
03/03/25,UPI,UPI-NAGRAJ-MUKKERLANAGRAJ@OKAXIS-UBIN080 3219-506238309623-CASH,0000506238309623,270.0,0.0,188173.75
03/03/25,UPI,UPI-ANJALI BASANT-9903315499@IKWIK-UBIN0 825522-100102404873-NA,0000100102404873,880.0,0.0,189053.75
03/03/25,UPI,UPI-RAJESH C PATEL-CNKRAJESHPATEL@OKAXIS -KKBK0008052-506244112096-FEBRUARY MILK BILL,0000506244112096,1500.0,0.0,190553.75
03/03/25,UPI,UPI-KATEPALLY VINAY KUM-VINAYKUMARKATEP ALLY@OKSBI-SBIN0003086-506293868513-UPI,0000506293868513,480.0,0.0,191033.75
03/03/25,UPI,UPI-PREMLATA MARDA-8639436017@PNB-PUNB00 50201-506228828081-PAY REQUEST,0000506228828081,1210.0,0.0,192243.75
03/03/25,UPI,UPI-JAY PRAKASH SAH-JPKUMAR852135@OKSBI -SBIN0014334-506252812430-UPI,0000506252812430,0.0,3000.0,189243.75
03/03/25,UPI,UPI-KOLLAPURAM MALLIKARJ-MALLIKARJUNKOLA PURAM@OKSBI-HDFC0000218-506218209258-UPI,0000506218209258,0.0,400.0,188843.75
03/03/25,UPI,UPI-LIBERTYSRIHARIOKICIC-LIBERTYSRIHARI@ OKICICI-BKID0008627-506271822407-UPI,0000506271822407,0.0,35750.0,153093.75
03/03/25,NEFT,NEFT CR-ICIC0099999-ANGEL ONE LIMITED CL IENT AC-MUKKERLA MADHU YADAV-ICICN22025,ICICN22025030316,10000.0,0.0,163093.75
04/03/25,UPI,UPI-RITHIK MITTAL-RITHIKMITTAL2606-1@OKH DFCBANK-HDFC0000081-100905946077-UPI,0000100905946077,1050.0,0.0,164143.75
04/03/25,UPI,UPI-LIBERTYSRIHARIOKICIC-LIBERTYSRIHARI@ OKICICI-BKID0008627-506399032923-UPI,0000506399032923,0.0,1300.0,162843.75
04/03/25,UPI,UPI-MUNTHA RAMESH YADAV-RAMEESHM6666@YBL -BKID0008604-821662650162-PAYMENT FROM P HONE,0000821662650162,0.0,4000.0,158843.75
04/03/25,UPI,UPI-JURRU RAHUL YADAV-Q758292524@YBL-YE SB0YBLUPI-506320921236-UPI,0000506320921236,0.0,225.0,158618.75
04/03/25,UPI,UPI-MANE NAVNEETHA-PAYTMQR66O8TP@PTYS-YE SB0PTMUPI-506384931872-UPI,0000506384931872,0.0,30.0,158588.75
04/03/25,UPI,UPI-JIO RECHARGE-JIOINAPPDIRECT1@YBL-YES B0YBLUPI-976818136127-PAYMENT FROM PHONE,0000976818136127,0.0,352.0,158236.75
04/03/25,UPI,UPI-RAPARTI SRIHARI-LIBERTYSRIHARI@OKSBI -BKID0008627-506323345266-DAILY 1300 IN TO 1,0000506323345266,50000.0,0.0,208236.75
04/03/25,UPI,UPI-RAPARTI SRIHARI-LIBERTYSRIHARI@OKSBI -BKID0008627-506323516044-NEW 1 LAKH AM OUNT,0000506323516044,50000.0,0.0,258236.75
04/03/25,,ACH D- PROTIUM FINANCE LIMI-A3SYD81IV4HH,0000005363492523,0.0,28475.0,229761.75
04/03/25,UPI,UPI-MWYN TECH PRIVATE LI-MWYNTECHPRIVATE 893267.RZP@RXAIRTEL-AIRP0000011-50633563 7683-MWYNTECHPRIVATELIM,0000506335637683,0.0,2211.02,227550.73
04/03/25,UPI,UPI-RAPARTI SRIHARI-9493207195@YBL-BKID0 008627-082270876227-PAYMENT FROM PHONE,0000082270876227,0.0,10000.0,217550.73
04/03/25,NEFT,"NEFT DR-KKBK0007463-M MADHU YADAV-NETBAN K, MUM-HDFCN52025030493974645-CASH",HDFCN52025030493,0.0,100000.0,117550.73
04/03/25,UPI,UPI-MANGAMMA BHUKYA-Q302926727@YBL-YESB 0YBLUPI-506328655972-UPI,0000506328655972,0.0,340.0,117210.73
04/03/25,UPI,UPI-MARGAM VANI-VANIMARGAM510@OKAXIS-SB IN0021100-506374892340-UPI,0000506374892340,7000.0,0.0,124210.73
04/03/25,UPI,UPI-SUHAS MADHUKAR CHAUD-DRSUHAS2003@OKH DFCBANK-KKBK0001367-100942423689-UPI,0000100942423689,1160.0,0.0,125370.73
04/03/25,UPI,UPI-MOHD AHMED ALI-AQUA.AHMED98@AXL-UTIB 0001808-286140845118-PAYMENT FROM PHONE,0000286140845118,540.0,0.0,125910.73
04/03/25,UPI,UPI-BHAGWANDAS BAJAJ-BHAGWANBAJAJ71-1@OK AXIS-HDFC0001228-542900719149-UPI,0000542900719149,1220.0,0.0,127130.73
04/03/25,NEFT,NEFT CR-ICIC0099999-ANGEL ONE LIMITED-MU KKERLA MADHU YADAV-ICICN220250304169732,ICICN22025030416,2500.0,0.0,129630.73
04/03/25,UPI,UPI-MR MOHAMMED ZAHEER-MOHAMMEDZAHEER511 -1@OKICICI-IDIB000T601-506340863403-UPI,0000506340863403,700.0,0.0,130330.73
04/03/25,UPI,UPI-M ANIL YADAV-ANILYADAV63473-1@OKHDFC BANK-UBIN0803219-100951281044-UPI,0000100951281044,4500.0,0.0,134830.73
05/03/25,UPI,UPI-JURRU RAHUL YADAV-Q758292524@YBL-YE SB0YBLUPI-506437381407-UPI,0000506437381407,0.0,225.0,134605.73
05/03/25,UPI,UPI-PHONEPE-BBPSBP@YBL-YESB0YBLUPI-30806 2336175-PAYMENT FROM PHONE,0000308062336175,0.0,95000.0,39605.73
05/03/25,UPI,UPI-CHITRA APPLARAJU-GPAY-11254074892@OK BIZAXIS-UTIB0000553-506447076326-UPI,0000506447076326,0.0,30.0,39575.73
05/03/25,UPI,UPI-SAMUDHRALA MANASA-MANASA31961@YBL-SB IN0RRDCGB-025558590284-PAYMENT FROM PHON E,0000025558590284,1160.0,0.0,40735.73
05/03/25,UPI,UPI-LAXMI NARSHIMA SWAMY-GPAY-1124082018 5@OKBIZAXIS-UTIB0000553-506460794810-UPI,0000506460794810,0.0,10.0,40725.73
05/03/25,UPI,UPI-NAGRAJ-MUKKERLANAGRAJ@OKAXIS-UBIN080 3219-543024636627-UPI,0000543024636627,2400.0,0.0,43125.73
05/03/25,UPI,UPI-RAPARTI SRIHARI-9493207195@YBL-BKID0 008627-756146450507-PAYMENT FROM PHONE,0000756146450507,0.0,13000.0,30125.73
05/03/25,,ACH D- IKF HOME FINANCE LTD-050320250529,0000005427556401,0.0,10675.0,19450.73
05/03/25,UPI,UPI-SASHIKALA BHANDARI-9032117972@YBL-S BIN0005895-882176200118-PAYMENT FROM PHO NE,0000882176200118,2040.0,0.0,21490.73
05/03/25,UPI,UPI-SIRISHA BORULLU-7396420413-2@YBL-K KBK0RCUB01-636493785050-PAYMENT FROM PHO NE,0000636493785050,2100.0,0.0,23590.73
05/03/25,UPI,UPI-ANGEL LTD NSE-ANGELONENSE@HDFCBANK-H DFC0000001-543060201373-PAYINGANGELONE,0000543060201373,0.0,2400.0,21190.73
05/03/25,UPI,UPI-G SURESH BABU-Q972090519@YBL-YESB0YB LUPI-543072912343-UPI,0000543072912343,0.0,100.0,21090.73
05/03/25,UPI,UPI-M ANIL YADAV-ANILYADAV63473-1@OKSBI- UBIN0803219-543026032115-UPI,0000543026032115,0.0,600.0,20490.73
06/03/25,UPI,UPI-JURRU RAHUL YADAV-Q758292524@YBL-YE SB0YBLUPI-543130548942-UPI,0000543130548942,0.0,225.0,20265.73
06/03/25,UPI,UPI-MENDE MONMOHAN YADA-Q199398888@YBL- YESB0YBLUPI-543153145880-UPI,0000543153145880,0.0,35.0,20230.73
06/03/25,UPI,UPI-VIKAS CHAWAN-CHAWANVIKAS85-1@OKSBI- SBIN0018182-543141262005-UPI,0000543141262005,0.0,40.0,20190.73
06/03/25,UPI,UPI-RAPARTI SRIHARI-9493207195@YBL-BKID0 008627-218217887931-PAYMENT FROM PHONE,0000218217887931,0.0,1000.0,19190.73
06/03/25,UPI,UPI-RAPARTI SRIHARI-9493207195@YBL-BKID0 008627-313152530769-PAYMENT FROM PHONE,0000313152530769,0.0,500.0,18690.73
06/03/25,UPI,UPI-BALA KASHYAP-BALA.KASHYAP1@YBL-HDFC0 000126-683410939734-PAYMENT FROM PHONE,0000683410939734,910.0,0.0,19600.73
06/03/25,UPI,UPI-M MADHU YADAV-9985065404-2@YBL-SBIN 0006645-709784169228-PAYMENT FROM PHONE,0000709784169228,85000.0,0.0,104600.73
06/03/25,IMPS,IMPS-506527194926-SHADVAL PAY PRIVATE LI MITED-RATN-XXXXXXXX1978-BILL,0000506527194926,95000.0,0.0,199600.73
06/03/25,POS,CASH DEPOSIT-416021XXXXXX2657-BARKATPURA,0000000000006471,39500.0,0.0,239100.73
06/03/25,UPI,UPI-MR B DATTATREYA-Q191763611@YBL-YESB0 YBLUPI-543163870932-UPI,0000543163870932,0.0,35.0,239065.73
06/03/25,UPI,UPI-ORUGANTI SRINIVAS RE-OSRINIVAS555@OK AXIS-UTIB0000426-506590173684-UPI,0000506590173684,1000.0,0.0,240065.73
06/03/25,UPI,UPI-MAHAVIR SETHI-9392489604@YBL-SBIN00 05895-150486209030-PAYMENT FROM PHONE,0000150486209030,1440.0,0.0,241505.73
06/03/25,UPI,UPI-MOHD AHMED ALI-AQUA.AHMED98@AXL-UTIB 0001808-547827734485-PAYMENT FROM PHONE,0000547827734485,180.0,0.0,241685.73
06/03/25,UPI,UPI-LIBERTYSRIHARIOKICIC-LIBERTYSRIHARI@ OKICICI-BKID0008627-543177091398-UPI,0000543177091398,0.0,1300.0,240385.73
06/03/25,UPI,UPI-KONDRAPALLY RAJU-KONDRAPALLYRAJU@YB L-SBIN0021610-035987445811-PAYMENT FROM PHONE,0000035987445811,1700.0,0.0,242085.73
06/03/25,UPI,UPI-BAJAJ FINANCE LTD LO-BAJAJFINANCEIEP LQR@ICICI-ICIC0DC0099-543139591720-UPI T RANSACTION FO,0000543139591720,0.0,28484.0,213601.73
07/03/25,UPI,UPI-JURRU RAHUL YADAV-Q758292524@YBL-YE SB0YBLUPI-543228992629-UPI,0000543228992629,0.0,225.0,213376.73
07/03/25,UPI,UPI-RAPARTI SRIHARI-9493207195@YBL-BKID0 008627-564152543670-PAYMENT FROM PHONE,0000564152543670,0.0,52000.0,161376.73
07/03/25,UPI,UPI-RAPARTI SRIHARI-9493207195@YBL-BKID0 008627-632163433293-PAYMENT FROM PHONE,0000632163433293,50000.0,0.0,211376.73
07/03/25,UPI,UPI-MENDE MONMOHAN YADA-Q199398888@YBL- YESB0YBLUPI-506690408788-UPI,0000506690408788,0.0,35.0,211341.73
07/03/25,UPI,UPI-MOHD ABDUL WASEEM-BHARATPE.9N0Y0Z7O 3Z377745@FBPE-FDRL0001382-506640611563-P AY TO BHARATPE ME,0000506640611563,0.0,40.0,211301.73
07/03/25,UPI,UPI-MUKKERLA GEETA SUDHA-GEETHAMUKKERLA- 1@OKAXIS-KKBK0007463-543282719916-UPI,0000543282719916,15000.0,0.0,226301.73
07/03/25,,590922931/TECHBAJAJFINANCELTDL,0000256678257795,0.0,219300.0,7001.73
07/03/25,UPI,UPI-M MADHU YADAV-M.MADHUYADAV261@YBL-KK BK0007463-903192435941-PAYMENT FROM PHON E,0000903192435941,0.0,6000.0,1001.73
07/03/25,POS,CASH DEPOSIT-416021XXXXXX2657-BARKATPURA,0000000000006746,6500.0,0.0,7501.73
07/03/25,UPI,UPI-M MADHU YADAV-M.MADHUYADAV261@YBL-KK BK0007463-655835300209-PAYMENT FROM PHON E,0000655835300209,0.0,7500.0,1.73
07/03/25,POS,CASH DEPOSIT BY - M MADHU YADAV - BARKAT PURA,000000000000000,3500.0,0.0,3501.73
07/03/25,UPI,UPI-M MADHU YADAV-M.MADHUYADAV261@YBL-KK BK0007463-983019746328-PAYMENT FROM PHON E,0000983019746328,0.0,2000.0,1501.73
07/03/25,UPI,UPI-JURRU RAHUL YADAV-Q758292524@YBL-YE SB0YBLUPI-506681528418-UPI,0000506681528418,0.0,240.0,1261.73
07/03/25,UPI,UPI-DADIGA SHIVA KUMAR-9985003423@YBL-S BIN0005895-267717686376-PAYMENT FROM PHO NE,0000267717686376,0.0,100.0,1161.73
07/03/25,UPI,UPI-ARRALO RANI-8309617327@AXL-FDRL00013 32-489567385749-PAYMENT FROM PHONE,0000489567385749,500.0,0.0,1661.73
08/03/25,UPI,UPI-CHITTABOINA CHAITANY-Q132092499@YBL- YESB0YBLUPI-506734967527-UPI,0000506734967527,0.0,50.0,1611.73
08/03/25,UPI,UPI-MENDE MONMOHAN YADA-Q199398888@YBL- YESB0YBLUPI-506746574070-UPI,0000506746574070,0.0,35.0,1576.73
08/03/25,UPI,UPI-M MADHU YADAV-M.MADHUYADAV261@YBL-KK BK0007463-942631649744-PAYMENT FROM PHON E,0000942631649744,10000.0,0.0,11576.73
08/03/25,UPI,UPI-NAGRAJ-MUKKERLANAGRAJ@OKAXIS-UBIN080 3219-506714279700-UPI,0000506714279700,0.0,10000.0,1576.73
08/03/25,UPI,UPI-RAPARTI SRIHARI-9493207195@YBL-BKID0 008627-616820535882-PAYMENT FROM PHONE,0000616820535882,50000.0,0.0,51576.73
08/03/25,UPI,UPI-BHARATHI BHARATHI-BHARTHI9573@YBL-S BIN0020701-506794985762-UPI,0000506794985762,0.0,6000.0,45576.73
08/03/25,UPI,UPI-SRIRAGHAVENDRATIFFIN-PAYTMQR17U07CIZ 21@PAYTM-YESB0PTMUPI-543337212434-UPI,0000543337212434,0.0,12.0,45564.73
08/03/25,UPI,UPI-B VINOD KUMAR-BALERAOVINOD077@OKSBI- CNRB0000033-506770599792-UPI,0000506770599792,0.0,2000.0,43564.73
08/03/25,UPI,UPI-M NARESH YADAV-NARESHMMM65-1@OKHDFC BANK-HDFC0CTGCUB-543355108446-UPI,0000543355108446,0.0,230.0,43334.73
08/03/25,UPI,UPI-M ARVIND-ARVINDYADAV69552@OKAXIS-K KBK0007473-506774195924-UPI,0000506774195924,0.0,200.0,43134.73
08/03/25,UPI,UPI-LIBERTYSRIHARIOKICIC-LIBERTYSRIHARI@ OKICICI-BKID0008627-543374522502-UPI,0000543374522502,0.0,1300.0,41834.73
08/03/25,UPI,UPI-VINITA JAIN -VSEHLOTH@OKSBI-SBIN000 2769-506764353569-UPI,0000506764353569,440.0,0.0,42274.73
08/03/25,UPI,UPI-JIO RECHARGE-JIOINAPPDIRECT@YBL-YESB 0YBLUPI-944123016740-PAYMENT FROM PHONE,0000944123016740,0.0,19.0,42255.73
08/03/25,UPI,UPI-JIO RECHARGE-JIOINAPPDIRECT1@YBL-YES B0YBLUPI-951007286032-PAYMENT FROM PHONE,0000951007286032,0.0,29.0,42226.73
09/03/25,,IB BILLPAY DR-HDFC92-434155XXXXXX1025,MB09043451989T33,0.0,10431.0,31795.73
09/03/25,UPI,UPI-JURRU RAHUL YADAV-Q758292524@YBL-YE SB0YBLUPI-543436827939-UPI,0000543436827939,0.0,210.0,31585.73
09/03/25,UPI,UPI-CHITTABOINA CHAITANY-Q132092499@YBL- YESB0YBLUPI-543417025734-UPI,0000543417025734,0.0,50.0,31535.73
09/03/25,UPI,UPI-TRUE CREDITS-TRUECREDITS991413.RZP@R XAIRTEL-AIRP0000011-543450144332-TRUECRE DITS,0000543450144332,0.0,4736.0,26799.73
09/03/25,UPI,UPI-TRUE CREDITS-TRUECREDITS991413.RZP@R XAIRTEL-AIRP0000011-543464334632-TRUECRE DITS,0000543464334632,0.0,4883.0,21916.73
09/03/25,UPI,UPI-MARIYALA VENKATESH-MARIYALA.VENKATES H.87-1@OKAXIS-BKID0008626-543445327082-U PI,0000543445327082,0.0,300.0,21616.73
09/03/25,UPI,UPI-MAADEVI-Q552508687@YBL-YESB0YBLUPI-5 43491947524-UPI,0000543491947524,0.0,175.0,21441.73
09/03/25,IMPS,IMPS-506810843296-WHIZDM FINANCE PRIVA-I DFB-XXXXXXX6145-269030793860,0000506810843296,67850.0,0.0,89291.73
09/03/25,IMPS,IMPS-506810458764-TRUECREDITSPVTLT-UTIB- XXXXXXXXXXX0537-TRUECREDITS,0000506810458764,62000.0,0.0,151291.73
09/03/25,UPI,UPI-GANTA SUJATHA-SUJATHAGANAT13@OKSBI- SBIN0005895-543448439938-UPI,0000543448439938,0.0,6000.0,145291.73
09/03/25,UPI,UPI-UPMOVE CAPITAL PRIVA-UPMOVECAPITALPR 695125.RZP@RXAIRTEL-AIRP0000011-50681122 4743-UPMOVE CAPITAL PRI,0000506811224743,0.0,7134.54,138157.19
09/03/25,UPI,UPI-M MADHU YADAV-M.MADHUYADAV261@YBL-KK BK0007463-061675450233-PAYMENT FROM PHON E,0000061675450233,5000.0,0.0,143157.19
09/03/25,UPI,UPI-M ARVIND RAJ-ARVINDRAJ57964-1@OKHDFC BANK-HDFC0000512-101191091901-UPI,0000101191091901,1540.0,0.0,144697.19
09/03/25,UPI,UPI-KRISHNA REDDY KOMAT-9247351440@YBL- SBIN0020567-459226277794-PAYMENT FROM PH ONE,0000459226277794,1300.0,0.0,145997.19
10/03/25,UPI,UPI-JURRU RAHUL YADAV-Q758292524@YBL-YE SB0YBLUPI-543509694744-UPI,0000543509694744,0.0,105.0,145892.19
10/03/25,UPI,UPI-LIBERTYSRIHARIOKICIC-LIBERTYSRIHARI@ OKICICI-BKID0008627-543510578697-UPI,0000543510578697,0.0,1300.0,144592.19
10/03/25,UPI,UPI-B RAYUDU-RAYUDU10-1@OKHDFCBANK-HDFC0 000042-101231139184-MILK AMT,0000101231139184,980.0,0.0,145572.19
10/03/25,UPI,UPI-M ANIL YADAV-ANILYADAV63473-1@OKSBI- UBIN0803219-543507788651-UPI,0000543507788651,0.0,22000.0,123572.19
10/03/25,UPI,UPI-ANGEL ONE LIMITED-ANGELONENSE@ICICI- ICIC0DC0099-543538696026-PAYINGANGELONE,0000543538696026,0.0,49000.0,74572.19
10/03/25,UPI,UPI-KREDITBEE-KREDITBEE.PAYMENTS29@ICICI -ICIC0DC0099-506933806119-UPI,0000506933806119,0.0,6901.0,67671.19
10/03/25,UPI,UPI-NAGRAJ-MUKKERLANAGRAJ@OKAXIS-UBIN080 3219-543592686513-UPI,0000543592686513,1000.0,0.0,68671.19
10/03/25,UPI,UPI-B SUMAN GOUD-9553484848@YBL-KKBK000 7451-605035633778-PAYMENT FROM PHONE,0000605035633778,0.0,6000.0,62671.19
10/03/25,UPI,UPI-BHARATHI BHARATHI-BHARTHI9573@YBL-S BIN0020701-506934812433-UPI,0000506934812433,0.0,6000.0,56671.19
10/03/25,UPI,UPI-DEEP SHIKHA GUPTA-AKG03071965@OKSBI- BARB0HIMHYD-506908216108-UPI,0000506908216108,0.0,1500.0,55171.19
10/03/25,,ATW-416021XXXXXX2657-P3ENTS55-HYDERABAD,0000000000009362,0.0,20000.0,35171.19
10/03/25,,ATW-416021XXXXXX2657-P3ENTS55-HYDERABAD,0000000000009363,0.0,20000.0,15171.19
10/03/25,,ATW-416021XXXXXX2657-P3ENTS55-HYDERABAD,0000000000009364,0.0,1000.0,14171.19
10/03/25,UPI,UPI-JURRU RAHUL YADAV-Q758292524@YBL-YE SB0YBLUPI-506965629418-UPI,0000506965629418,0.0,160.0,14011.19
10/03/25,UPI,UPI-SHEKER NAIKOTI-Q749996981@YBL-YESB0 YBLUPI-506904550396-UPI,0000506904550396,0.0,500.0,13511.19
10/03/25,NEFT,NEFT CR-YESB0000001-FINKURVE FINANCIAL S ERVICES LIMITED-M MADHU YADAV-YESBN52025,YESBN52025031004,17168.0,0.0,30679.19
10/03/25,UPI,UPI-MALKAPURI VISHAL SIN-MALKAPURIVISHAL SINGH1991@OKHDFCBANK-CNRB0000033-5069650 47853-UPI,0000506965047853,0.0,160.0,30519.19
10/03/25,UPI,UPI-LIBERTYSRIHARIOKAXIS-LIBERTYSRIHARI@ OKAXIS-BKID0008627-506958152825-UPI,0000506958152825,0.0,1300.0,29219.19
11/03/25,UPI,UPI-SUDHAKARDAMARLAPALLY-SUDHAKARDAMARLA PALLY-1@OKICICI-IDIB000B052-507046640141 -UPI,0000507046640141,0.0,116.0,29103.19
11/03/25,UPI,UPI-JURRU RAHUL YADAV-Q758292524@YBL-YE SB0YBLUPI-507023134080-UPI,0000507023134080,0.0,165.0,28938.19
11/03/25,POS,POS 416021XXXXXX2657 AVENUE SUPERMART,0000000000030140,0.0,5292.99,23645.2
11/03/25,UPI,UPI-PENUG-Q379847902@YBL-YESB0YBLUPI-507 093435741-UPI,0000507093435741,0.0,150.0,23495.2
11/03/25,UPI,UPI-PADMAJA KAMAM-PAYTMQR10DYCJ@PAYTM-YE SB0PTMUPI-507049564367-UPI,0000507049564367,0.0,60.0,23435.2
11/03/25,UPI,UPI-G RAVINDER REDDY-SAFETYPACKAGING69@O KHDFCBANK-KKBK0007473-507040451105-UPI,0000507040451105,0.0,310.0,23125.2
11/03/25,,IB BILLPAY DR-HDFC92-434155XXXXXX1025,MB11133139686T50,0.0,2600.0,20525.2
11/03/25,UPI,UPI-A NARESH KUMAR-Q749466560@YBL-YESB0Y BLUPI-507045676272-UPI,0000507045676272,0.0,4.0,20521.2
11/03/25,UPI,UPI-SRI BALAJI BAKERY-PAYTMQR66O95U@PTYS -YESB0PTMUPI-507097667606-UPI,0000507097667606,0.0,30.0,20491.2
11/03/25,UPI,UPI-SOMANATH-Q494458152@YBL-YESB0YBLUPI- 507015981858-UPI,0000507015981858,0.0,20.0,20471.2
11/03/25,UPI,UPI-VEMPATI VEERA VENKAT-9866681335-2@YB L-UTIB0000075-992734131939-PAYMENT FROM PHONE,0000992734131939,0.0,19690.0,781.2
11/03/25,NEFT,NEFT CR-ICIC0099999-ANGEL ONE LIMITED-MU KKERLA MADHU YADAV-ICICN220250311266901,ICICN22025031126,30000.0,0.0,30781.2
11/03/25,UPI,UPI-M ANIL YADAV-ANILYADAV63473-1@OKSBI- UBIN0803219-507096298225-UPI,0000507096298225,0.0,7500.0,23281.2
11/03/25,UPI,UPI-M ANIL YADAV-ANILYADAV63473-1@OKSBI- UBIN0803219-507018191065-UPI,0000507018191065,0.0,7000.0,16281.2
11/03/25,UPI,UPI-LIBERTYSRIHARIOKICIC-LIBERTYSRIHARI@ OKICICI-BKID0008627-507041694737-UPI,0000507041694737,0.0,1300.0,14981.2
12/03/25,UPI,UPI-JURRU RAHUL YADAV-Q758292524@YBL-YE SB0YBLUPI-543730608361-UPI,0000543730608361,0.0,120.0,14861.2
12/03/25,UPI,UPI-Y SHAILAJA-9985744594@YBL-CNRB000003 3-543702204799-UPI,0000543702204799,0.0,35.0,14826.2
12/03/25,UPI,UPI-MANE NAVNEETHA-PAYTMQR66O8TP@PTYS-YE SB0PTMUPI-543780612878-UPI,0000543780612878,0.0,45.0,14781.2
12/03/25,,ATW-416021XXXXXX2657-P3ENTS55-HYDERABAD,0000000000009867,0.0,3500.0,11281.2
12/03/25,UPI,UPI-NEMALI KARUNAKAR-KARUNAKARNEMALI901 @OKSBI-SBIN0016294-543789810351-UPI,0000543789810351,0.0,3000.0,8281.2
12/03/25,UPI,UPI-KOLA RAMU-Q670893886@YBL-YESB0YBLUP I-543729821697-UPI,0000543729821697,0.0,120.0,8161.2
12/03/25,,ATW-416021XXXXXX2657-P3ENTS55-HYDERABAD,0000000000009937,0.0,4000.0,4161.2
12/03/25,NEFT,NEFT CR-ICIC0099999-ANGEL ONE LIMITED-MU KKERLA MADHU YADAV-ICICN220250312279490,ICICN22025031227,20000.0,0.0,24161.2
12/03/25,UPI,UPI-ABBUZAR KHAN-PAYTM.S18AN3I@PTY-YESB0 MCHUPI-543759065610-UPI,0000543759065610,0.0,580.0,23581.2
12/03/25,UPI,UPI-B VINOD KUMAR-BALERAOVINOD077@OKSBI- CNRB0000033-543772652332-UPI,0000543772652332,0.0,5000.0,18581.2
12/03/25,UPI,UPI-LIBERTYSRIHARIOKICIC-LIBERTYSRIHARI@ OKICICI-BKID0008627-543720066427-UPI,0000543720066427,0.0,1300.0,17281.2
13/03/25,UPI,UPI-JURRU RAHUL YADAV-Q758292524@YBL-YE SB0YBLUPI-543844177781-UPI,0000543844177781,0.0,105.0,17176.2
13/03/25,UPI,UPI-JURRU RAHUL YADAV-Q758292524@YBL-YE SB0YBLUPI-543817465278-UPI,0000543817465278,0.0,40.0,17136.2
13/03/25,UPI,UPI-MANE NAVNEETHA-PAYTMQR66O8TP@PTYS-YE SB0PTMUPI-543821283268-UPI,0000543821283268,0.0,50.0,17086.2
13/03/25,UPI,UPI-D GNANESWAR REDDY-Q532024465@YBL-YES B0YBLUPI-543877891138-UPI,0000543877891138,0.0,20.0,17066.2
13/03/25,UPI,UPI-M ANIL YADAV-ANILYADAV63473-1@OKSBI- UBIN0803219-507252006135-UPI,0000507252006135,0.0,600.0,16466.2
13/03/25,UPI,UPI-LIBERTYSRIHARIOKICIC-LIBERTYSRIHARI@ OKICICI-BKID0008627-507298603345-UPI,0000507298603345,0.0,1300.0,15166.2
13/03/25,UPI,UPI-GAJARLA NARSING-ENTERPRISESNARSING@O KSBI-UBIN0806048-507200917823-UPI,0000507200917823,0.0,760.0,14406.2
13/03/25,UPI,UPI-B VINOD KUMAR-BALERAOVINOD077@OKSBI- CNRB0000033-507283504888-UPI,0000507283504888,0.0,1500.0,12906.2
13/03/25,UPI,UPI-SWISS CASTLE BAKERY -SWISSCASTLEBAKE RYNAR.99974990@HDFCBANK-HDFC0MERUPI-5072 26809227-UPI,0000507226809227,0.0,230.0,12676.2
13/03/25,NEFT,NEFT CR-ICIC0099999-ANGEL ONE LIMITED-MU KKERLA MADHU YADAV-ICICN220250313290532,ICICN22025031329,28500.0,0.0,41176.2
13/03/25,UPI,UPI-JIO RECHARGE-JIOINAPPDIRECT1@YBL-YES B0YBLUPI-959110413649-PAYMENT FROM PHONE,0000959110413649,0.0,29.0,41147.2
13/03/25,UPI,UPI-JIO RECHARGE-JIOINAPPDIRECT@YBL-YESB 0YBLUPI-884603822395-PAYMENT FROM PHONE,0000884603822395,0.0,352.0,40795.2
13/03/25,UPI,UPI-AIRTEL RECHARGE-AIRTELPREDIRECT1@YBL -YESB0YBLUPI-620162842857-PAYMENT FROM P HONE,0000620162842857,0.0,302.0,40493.2
14/03/25,UPI,UPI-MANE NAVNEETHA-PAYTMQR66O8TP@PTYS-YE SB0PTMUPI-507367939338-UPI,0000507367939338,0.0,110.0,40383.2
14/03/25,UPI,UPI-M PAVAN KUMAR-PAYTMQR66P16P@PTYS-YES B0PTMUPI-507323146303-UPI,0000507323146303,0.0,120.0,40263.2
14/03/25,UPI,UPI-SWISS CASTLE BAKERY -SWISSCASTLEBAKE RYNAR.99974990@HDFCBANK-HDFC0MERUPI-5073 76368409-UPI,0000507376368409,0.0,153.0,40110.2
14/03/25,UPI,UPI-SANGIPOGU RAMANJANEY-SANGRAJU.SANGRA MU@OKAXIS-CNRB0000033-507333567007-UPI,0000507333567007,0.0,400.0,39710.2
14/03/25,UPI,UPI-LIBERTYSRIHARIOKICIC-LIBERTYSRIHARI@ OKICICI-BKID0008627-507383374188-UPI,0000507383374188,0.0,1300.0,38410.2
14/03/25,UPI,UPI-KOLLAPURAM MALLIKARJ-MALLIKARJUNKOLA PURAM@OKSBI-HDFC0000218-507389257563-UPI,0000507389257563,0.0,300.0,38110.2
15/03/25,UPI,UPI-JURRU RAHUL YADAV-Q758292524@YBL-YE SB0YBLUPI-507449882807-UPI,0000507449882807,0.0,105.0,38005.2
15/03/25,,ACH D- LIC OF INDIA-6577926590325,0000008125966074,0.0,2488.0,35517.2
15/03/25,,ATW-416021XXXXXX2657-P3ENTS55-HYDERABAD,0000000000000490,0.0,1000.0,34517.2
15/03/25,UPI,UPI-PENUG-Q379847902@YBL-YESB0YBLUPI-507 428774144-UPI,0000507428774144,0.0,50.0,34467.2
15/03/25,UPI,UPI-SOMANATH-Q494458152@YBL-YESB0YBLUPI- 544045916474-UPI,0000544045916474,0.0,20.0,34447.2
15/03/25,,CHQ DEP - MICR CLG - WBO HYDERABAD: IKF HOME FINANCE LIMITED :FEDERAL BANK LTD,0000000000792589,392707.0,0.0,427154.2
15/03/25,UPI,UPI-M ANIL YADAV-ANILYADAV63473-1@OKSBI- UBIN0803219-544038027268-UPI,0000544038027268,0.0,13000.0,414154.2
15/03/25,UPI,UPI-LIBERTYSRIHARIOKICIC-LIBERTYSRIHARI@ OKICICI-BKID0008627-544045428346-UPI,0000544045428346,0.0,1300.0,412854.2
16/03/25,UPI,UPI-MAADEVI-Q552508687@YBL-YESB0YBLUPI-5 44139135288-UPI,0000544139135288,0.0,190.0,412664.2
16/03/25,UPI,UPI-AZAM MOHIUDDIN-Q654287932@YBL-YESB0Y BLUPI-544122751612-UPI,0000544122751612,0.0,300.0,412364.2
16/03/25,UPI,UPI-T NAVEEN-NAVEENTADAKALA653@OKAXIS-K KBK0007473-544137090912-UPI,0000544137090912,0.0,20.0,412344.2
16/03/25,UPI,UPI-LIBERTYSRIHARIOKICIC-LIBERTYSRIHARI@ OKICICI-BKID0008627-544146883421-UPI,0000544146883421,0.0,1300.0,411044.2
17/03/25,UPI,UPI-RAPARTI SRIHARI-9493207195@YBL-BKID0 008627-166545567586-PAYMENT FROM PHONE,0000166545567586,0.0,13000.0,398044.2
17/03/25,UPI,UPI-NEMALI KARUNAKAR-KARUNAKARNEMALI901 @OKSBI-SBIN0016294-507646622479-UPI,0000507646622479,0.0,5000.0,393044.2
17/03/25,UPI,UPI-NEWSURESH LAXMAIAH -Q438494362@YBL- YESB0YBLUPI-507612818631-UPI,0000507612818631,0.0,250.0,392794.2
17/03/25,NEFT,NEFT CR-ICIC0099999-ANGEL ONE LIMITED-MU KKERLA MADHU YADAV-ICICN220250317312962,ICICN22025031731,9000.0,0.0,401794.2
17/03/25,UPI,UPI-LIBERTYSRIHARIOKICIC-LIBERTYSRIHARI@ OKICICI-BKID0008627-507657149368-UPI,0000507657149368,0.0,1300.0,400494.2
17/03/25,UPI,UPI-ANGEL LTD NSE-ANGELONENSE@HDFCBANK-H DFC0MERUPI-507682849695-PAYINGANGELONE,0000507682849695,0.0,40000.0,360494.2
18/03/25,UPI,UPI-M ANIL YADAV-ANILYADAV63473-1@OKSBI- UBIN0803219-507754270167-UPI,0000507754270167,0.0,2500.0,357994.2
18/03/25,UPI,UPI-NAGRAJ-MUKKERLANAGRAJ@OKAXIS-UBIN080 3219-507779451885-UPI,0000507779451885,0.0,1000.0,356994.2
18/03/25,IMPS,IMPS-507708399679-SRIDEVI JT1-ICIC-XXXXX XXX3198-CASH,0000507708399679,0.0,14000.0,342994.2
18/03/25,UPI,UPI-VINODKUMAR TERALA-PAYTMQR5WE22Q@PTY S-YESB0PTMUPI-507794857432-UPI,0000507794857432,0.0,70.0,342924.2
18/03/25,UPI,UPI-MANE NAVNEETHA-PAYTMQR66O8TP@PTYS-YE SB0PTMUPI-507701170211-UPI,0000507701170211,0.0,40.0,342884.2
18/03/25,UPI,UPI-MUKKERLA GEETA SUDHA-GEETHAMUKKERLA- 1@OKAXIS-KKBK0007463-507786061095-UPI,0000507786061095,0.0,40000.0,302884.2
18/03/25,UPI,UPI-ANGEL LTD NSE-ANGELONENSE@HDFCBANK-H DFC0MERUPI-507720159150-PAYINGANGELONE,0000507720159150,0.0,15000.0,287884.2
18/03/25,,NWD-416021XXXXXX2657-S1CPS376-HYDERABAD,0000507710003880,0.0,1000.0,286884.2
18/03/25,UPI,UPI-PENUG-Q379847902@YBL-YESB0YBLUPI-507 733459964-UPI,0000507733459964,0.0,150.0,286734.2
18/03/25,UPI,UPI-JAWEED FRUITS SHOP-GPAY-11251592366@ OKBIZAXIS-UTIB0000553-507703676232-UPI,0000507703676232,0.0,30.0,286704.2
18/03/25,UPI,UPI-BHARATHI BHARATHI-BHARTHI9573@YBL-S BIN0020701-507783988527-UPI,0000507783988527,0.0,6000.0,280704.2
18/03/25,UPI,UPI-MOHD AHMED ALI-AQUA.AHMED98@AXL-UTIB 0001808-390173449385-PAYMENT FROM PHONE,0000390173449385,600.0,0.0,281304.2
18/03/25,UPI,UPI-M ARVIND-ARVINDYADAV69552@OKAXIS-K KBK0007473-507760584088-UPI,0000507760584088,0.0,1500.0,279804.2
18/03/25,UPI,UPI-MASQATI SUPER MARKET-OMBK.AAFT325671 05MILQKREN@ICICI-ICIC0DC0099-54433810229 3-UPI,0000544338102293,0.0,220.0,279584.2
18/03/25,UPI,UPI-LIBERTYSRIHARIOKICIC-LIBERTYSRIHARI@ OKICICI-BKID0008627-544335603750-UPI,0000544335603750,0.0,1300.0,278284.2
18/03/25,IMPS,IMPS-507720344430-M MADHU YADAV-KKBK-XXX XXX7813-CASH,0000507720344430,0.0,75000.0,203284.2
18/03/25,UPI,UPI-ANGEL ONE LIMITED-ANGELONENSE@ICICI- ICIC0DC0099-544322501675-PAYINGANGELONE,0000544322501675,0.0,70000.0,133284.2
18/03/25,UPI,UPI-ZERODHA BROKING LTD-ZERODHABROKING@H DFCBANK-HDFC0MERUPI-507740192574-4132515 699505229 Z,0000507740192574,0.0,20100.0,113184.2
18/03/25,UPI,UPI-MUKKERLA GEETA SUDHA-GEETHAMUKKERLA- 1@OKAXIS-KKBK0007463-544316802028-UPI,0000544316802028,0.0,5320.0,107864.2
19/03/25,,ATW-416021XXXXXX2657-S1AWHY59-HYDERABAD,0000000000001877,0.0,20000.0,87864.2
19/03/25,,ATW-416021XXXXXX2657-S1ANHD25-HYDERABAD,0000000000007938,0.0,20000.0,67864.2
19/03/25,,ATW-416021XXXXXX2657-S1AWHY59-HYDERABAD,0000000000001878,0.0,20000.0,47864.2
19/03/25,UPI,UPI-PUNY PALS HIGH SCHOO-PUNYPALSHIGHSCH OOLDORMA@ICICI-ICIC0DC0099-544425110001- UPI,0000544425110001,0.0,5717.0,42147.2
19/03/25,UPI,UPI-SEELA MANJUNATH-SEELAMANJUNATH67533@ DBS-DBSS0IN0811-275030187591-PAYMENT FRO M PHONE,0000275030187591,0.0,1000.0,41147.2
19/03/25,IMPS,IMPS-507825389341-APIBANKING-RATN-XXXXXX XXXXXX0168-ACCOUNTVALIDATION,0000507825389341,1.0,0.0,41148.2
19/03/25,UPI,UPI-JURRU RAHUL YADAV-Q758292524@YBL-YE SB0YBLUPI-544496643381-UPI,0000544496643381,0.0,160.0,40988.2
19/03/25,UPI,UPI-GAJARLA NARSING-ENTERPRISESNARSING@O KSBI-UBIN0806048-544418147693-UPI,0000544418147693,0.0,1000.0,39988.2
19/03/25,UPI,UPI-MALKAJGIRI SUJATHA-9000531649@YBL-PU NB0159700-544419860814-UPI,0000544419860814,0.0,1500.0,38488.2
19/03/25,NEFT,NEFT CR-ICIC0099999-ANGEL ONE LIMITED-MU KKERLA MADHU YADAV-ICICN220250319335161,ICICN22025031933,20000.0,0.0,58488.2
19/03/25,UPI,UPI-MARGAM VANI-9392657723@YBL-SBIN0021 100-514409100584-PAYMENT FROM PHONE,0000514409100584,0.0,26000.0,32488.2
19/03/25,UPI,UPI-LIBERTYSRIHARIOKICIC-LIBERTYSRIHARI@ OKICICI-BKID0008627-544411753502-UPI,0000544411753502,0.0,1300.0,31188.2
19/03/25,UPI,UPI-MUKKERLA GEETA SUDHA-GEETHAMUKKERLA- 1@OKAXIS-KKBK0007463-544422777027-UPI,0000544422777027,15000.0,0.0,46188.2
19/03/25,UPI,UPI-M ANIL YADAV-ANILYADAV63473-1@OKSBI- UBIN0803219-544400564962-UPI,0000544400564962,0.0,5000.0,41188.2
19/03/25,UPI,UPI-B RAJESHWARI-RAJESHWARIYADAV147-1@OK HDFCBANK-SBIN0RRDCGB-544453856484-UPI,0000544453856484,0.0,9745.0,31443.2
20/03/25,NEFT,NEFT CR-YESB0000001-ZERODHA BROKING LTD- DSCNB A/C-MUKKERLA MADHU YADAV-YESBN1202,YESBN12025032000,5500.0,0.0,36943.2
20/03/25,UPI,UPI-KUMBUM VIJAYA LAKSHM-LAKSHMIVIJAYA85 60@OKHDFCBANK-HDFC0000081-101748826829-C URD ND MILK,0000101748826829,95.0,0.0,37038.2
20/03/25,UPI,UPI-TIRIVISETTY SATYANAR-Q628175389@YBL- YESB0YBLUPI-544536865046-UPI,0000544536865046,0.0,50.0,36988.2
20/03/25,UPI,UPI-AMIT CHARAN-PAYTMQR6B64QP@PTYS-YESB0 PTMUPI-544536674780-UPI,0000544536674780,0.0,20.0,36968.2
20/03/25,UPI,UPI-KHAN BABU-KHANBABU78001@YBL-ICIC0001 015-424247418146-PAYMENT FROM PHONE,0000424247418146,0.0,10000.0,26968.2
20/03/25,UPI,UPI-M ARVIND-9550183344@YBL-KKBK000745 5-173326266588-PAYMENT FROM PHONE,0000173326266588,200.0,0.0,27168.2
20/03/25,UPI,UPI-MUNIGAPATI RAJU-BHARATPE09901912082@ YESBANKLTD-YESB0YESUPI-507973011867-PAY TO BHARATPE ME,0000507973011867,0.0,60.0,27108.2
20/03/25,UPI,UPI-GOUROJU CHANDRA SHEK-GSHEKAR1975-1@O KHDFCBANK-HDFC0000081-507903317945-UPI,0000507903317945,0.0,10000.0,17108.2
20/03/25,UPI,UPI-LIBERTYSRIHARIOKICIC-LIBERTYSRIHARI@ OKICICI-BKID0008627-507974928668-UPI,0000507974928668,0.0,1300.0,15808.2
20/03/25,NEFT,NEFT CR-ICIC0099999-ANGEL ONE LIMITED-MU KKERLA MADHU YADAV-ICICN220250320344384,ICICN22025032034,15000.0,0.0,30808.2
20/03/25,UPI,UPI-MUKKERLA GEETA SUDHA-GEETHAMUKKERLA- 1@OKAXIS-KKBK0007463-507988558626-UPI,0000507988558626,20000.0,0.0,50808.2
20/03/25,UPI,UPI-MAHENDRA JALA-JALAMAHENDRA@OKAXIS-K KBK0007466-507980517885-UPI,0000507980517885,0.0,30000.0,20808.2
21/03/25,NEFT,NEFT CR-YESB0000001-ZERODHA BROKING LTD- DSCNB A/C-MUKKERLA MADHU YADAV-YESBN1202,YESBN12025032100,8000.0,0.0,28808.2
21/03/25,UPI,UPI-B RAJESHWARI-RAJESHWARIYADAV147-1@OK HDFCBANK-SBIN0RRDCGB-508064332228-UPI,0000508064332228,0.0,6140.0,22668.2
21/03/25,UPI,UPI-CHITRA APPLARAJU-GPAY-11256411307@OK BIZAXIS-UTIB0000553-508030934637-UPI,0000508030934637,0.0,130.0,22538.2
21/03/25,UPI,UPI-P NAND KISHOR-BHARATPE.90069295183@F BPE-FDRL0001382-508062333835-PAY TO BHAR ATPE ME,0000508062333835,0.0,50.0,22488.2
21/03/25,UPI,UPI-MUKKERLA GEETA SUDHA-GEETHAMUKKERLA- 1@OKAXIS-KKBK0007463-508045585834-UPI,0000508045585834,7500.0,0.0,29988.2
21/03/25,UPI,UPI-G PRASHANTH-7702920675@AXL-UTIB00008 81-216080656182-PAYMENT FROM PHONE,0000216080656182,0.0,21375.0,8613.2
21/03/25,UPI,UPI-KOLA RAMU-Q670893886@YBL-YESB0YBLUP I-508098561982-UPI,0000508098561982,0.0,100.0,8513.2
21/03/25,,ATW-416021XXXXXX2657-P3ENTS55-HYDERABAD,0000000000001789,0.0,3000.0,5513.2
21/03/25,UPI,UPI-MR RAVI TEJA POTHAR-RAVITEJAYADAV95 28@OKHDFCBANK-CBIN0280808-508027264239-U PI,0000508027264239,0.0,1000.0,4513.2
21/03/25,NEFT,NEFT CR-ICIC0099999-ANGEL ONE LIMITED-MU KKERLA MADHU YADAV-ICICN220250321355410,ICICN22025032135,15000.0,0.0,19513.2
21/03/25,UPI,UPI-LIBERTYSRIHARIOKICIC-LIBERTYSRIHARI@ OKICICI-BKID0008627-508041885566-UPI,0000508041885566,0.0,1300.0,18213.2
22/03/25,NEFT,NEFT CR-YESB0000001-ZERODHA BROKING LTD- DSCNB A/C-MUKKERLA MADHU YADAV-YESBN1202,YESBN12025032202,5500.0,0.0,23713.2
22/03/25,UPI,UPI-MOHD ABDUL WASEEM-BHARATPE.9N0Y0Z7O 3Z377745@FBPE-FDRL0001382-544760804072-P AY TO BHARATPE ME,0000544760804072,0.0,30.0,23683.2
22/03/25,UPI,UPI-MUKKERLA GEETA SUDHA-GEETHAMUKKERLA- 1@OKAXIS-KKBK0007463-544734480953-UPI,0000544734480953,40000.0,0.0,63683.2
22/03/25,UPI,UPI-ARVOG-ARVOG.ESBZ@KOTAK-KKBK0000958-5 08148781906-PAY,0000508148781906,0.0,20478.92,43204.28
22/03/25,UPI,UPI-MARGAM VANI-9392657723@YBL-SBIN0021 100-582006568453-PAYMENT FROM PHONE,0000582006568453,0.0,13000.0,30204.28
22/03/25,UPI,UPI-GANTA SUJATHA-SUJATHAGANAT13@OKSBI- SBIN0005895-508122094948-UPI,0000508122094948,1050.0,0.0,31254.28
22/03/25,UPI,UPI-MR DIGLESHA VINODKU-Q72340540@YBL-Y ESB0YBLUPI-544779620486-UPI,0000544779620486,0.0,260.0,30994.28
22/03/25,UPI,UPI-MOHD AHMED ALI-AQUA.AHMED98@AXL-UTIB 0001808-336973184185-PAYMENT FROM PHONE,0000336973184185,360.0,0.0,31354.28
22/03/25,UPI,UPI-MR RAVI TEJA POTHAR-RAVITEJAYADAV95 28@OKHDFCBANK-CBIN0280808-544798627513-U PI,0000544798627513,0.0,2000.0,29354.28
22/03/25,UPI,UPI-LIBERTYSRIHARIOKICIC-LIBERTYSRIHARI@ OKICICI-BKID0008627-544783453616-UPI,0000544783453616,0.0,1300.0,28054.28
22/03/25,UPI,UPI-B VINOD KUMAR-BALERAOVINOD077@OKSBI- CNRB0000033-544758630959-UPI,0000544758630959,0.0,2000.0,26054.28
23/03/25,UPI,UPI-SHABAAZ IOCL PRANEET-Q030573181@YBL- YESB0YBLUPI-544848254861-UPI,0000544848254861,0.0,350.0,25704.28
23/03/25,UPI,UPI-M ANIL YADAV-ANILYADAV63473-1@OKSBI- UBIN0803219-544800446436-UPI,0000544800446436,0.0,2500.0,23204.28
23/03/25,UPI,UPI-M ANIL YADAV-ANILYADAV63473-1@OKSBI- UBIN0803219-544865053636-UPI,0000544865053636,0.0,600.0,22604.28
23/03/25,UPI,UPI-MURALIKRISHNA VEGETA-GPAY-1124438713 1@OKBIZAXIS-UTIB0000553-544884955388-UPI,0000544884955388,0.0,310.0,22294.28
23/03/25,UPI,UPI-PADALALAKSHMI-Q447576464@YBL-YESB0YB LUPI-544878957402-UPI,0000544878957402,0.0,40.0,22254.28
23/03/25,UPI,UPI-P NAND KISHOR-BHARATPE.90069295183@F BPE-FDRL0001382-544835755429-PAY TO BHAR ATPE ME,0000544835755429,0.0,50.0,22204.28
23/03/25,UPI,UPI-RAPARTI SRIHARI-9493207195@YBL-BKID0 008627-966278747870-PAYMENT FROM PHONE,0000966278747870,0.0,10000.0,12204.28
23/03/25,UPI,UPI-PANUGOTHU RAVINAIK-PANUGOTHUNAIK2@Y BL-SBIN0005895-544869969745-UPI,0000544869969745,0.0,880.0,11324.28
23/03/25,UPI,UPI-MR RAVI TEJA POTHAR-RAVITEJAYADAV95 28@OKHDFCBANK-CBIN0280808-544867091783-U PI,0000544867091783,0.0,500.0,10824.28
23/03/25,UPI,UPI-M MADHU YADAV-9985065404-2@YBL-SBIN 0006645-311979219999-PAYMENT FROM PHONE,0000311979219999,490.0,0.0,11314.28
23/03/25,UPI,UPI-SRI SAI RESTAURANT A-PAYTM-80659624@ PTYS-YESB0PTMUPI-544860585939-UPI,0000544860585939,0.0,220.0,11094.28
23/03/25,UPI,UPI-LIBERTYSRIHARIOKICIC-LIBERTYSRIHARI@ OKICICI-BKID0008627-508242103692-UPI,0000508242103692,0.0,1300.0,9794.28
24/03/25,UPI,UPI-PANYAM MANJULA-MANJUPANYAM@OKSBI-SB IN0007641-508396823496-MILK,0000508396823496,2000.0,0.0,11794.28
24/03/25,UPI,UPI-SWISS CASTLE BAKERY -SWISSCASTLEBAKE RYNAR.99974990@HDFCBANK-HDFC0MERUPI-5083 09040995-UPI,0000508309040995,0.0,272.0,11522.28
24/03/25,UPI,UPI-MR RAMINI LAXMAN-BHARATPE.90064262 153@FBPE-FDRL0001382-508331622767-PAY TO BHARATPE ME,0000508331622767,0.0,10.0,11512.28
24/03/25,UPI,UPI-KEERTHI NEELI-SAI.TAANYA26@OKAXIS-BA RB0BARKAT-508368805645-UPI,0000508368805645,1000.0,0.0,12512.28
24/03/25,UPI,UPI-MAHENDAR KUMAR BAHET-MAHENDAR.BAHETI @OKICICI-ICIC0000040-508398850759-ADVANC E,0000508398850759,7000.0,0.0,19512.28
24/03/25,UPI,UPI-APPALA GURUPRASAD-GURUATNIC.IN@OKHD FCBANK-SBIN0020432-101993884596-UPI,0000101993884596,2000.0,0.0,21512.28
25/03/25,UPI,UPI-LIBERTYSRIHARIOKICIC-LIBERTYSRIHARI@ OKICICI-BKID0008627-508499168809-UPI,0000508499168809,0.0,1300.0,20212.28
25/03/25,UPI,UPI-MUNTHA RAMESH YADAV-RAMEESHM6666@YBL -BKID0008604-549372339228-PAYMENT FROM P HONE,0000549372339228,0.0,8000.0,12212.28
25/03/25,UPI,UPI-CHITRA APPLARAJU-GPAY-11256411307@OK BIZAXIS-UTIB0000553-508489572031-UPI,0000508489572031,0.0,130.0,12082.28
25/03/25,,ANGEL ONE LIMI-244598397,0000503256309038,2200.2,0.0,14282.48
25/03/25,UPI,UPI-GATTU RAMYA-RAMYAGATTU1304@YBL-SBIN 0020095-013618388697-PAYMENT FROM PHONE,0000013618388697,2000.0,0.0,16282.48
25/03/25,UPI,UPI-M ARVIND-ARVINDYADAV69552@OKAXIS-K KBK0007473-508464662179-MILK,0000508464662179,225.0,0.0,16507.48
25/03/25,UPI,UPI-VOLIGE SRIKANTH-VOLIGESRIKANTH@OKSB I-IOBA0002397-545082904273-UPI,0000545082904273,0.0,400.0,16107.48
25/03/25,UPI,UPI-LIBERTYSRIHARIOKICIC-LIBERTYSRIHARI@ OKICICI-BKID0008627-545085511316-UPI,0000545085511316,0.0,1300.0,14807.48
26/03/25,UPI,UPI-GANTA SUJATHA-SUJATHAGANAT13@OKSBI- SBIN0005895-545145546265-UPI,0000545145546265,0.0,10000.0,4807.48
26/03/25,UPI,UPI-PHONEPE-BBPSBP@YBL-YESB0YBLUPI-99290 7451524-PAYMENT FROM PHONE,0000992907451524,0.0,855.0,3952.48
26/03/25,UPI,UPI-SRI BALAJI WINES-PAYTM.S151559@PTY-Y ESB0MCHUPI-545144680208-UPI,0000545144680208,0.0,410.0,3542.48
26/03/25,UPI,UPI-MR RAVI TEJA POTHAR-RAVITEJAYADAV95 28@OKHDFCBANK-CBIN0280808-545128480889-U PI,0000545128480889,0.0,500.0,3042.48
26/03/25,UPI,UPI-LIBERTYSRIHARIOKICIC-LIBERTYSRIHARI@ OKICICI-BKID0008627-545115696732-UPI,0000545115696732,0.0,1300.0,1742.48
26/03/25,UPI,UPI-B VINOD KUMAR-BALERAOVINOD077@OKSBI- CNRB0000033-545115987693-UPI,0000545115987693,0.0,1500.0,242.48
27/03/25,UPI,UPI-MUKKERLA GEETA SUDHA-GEETHAMUKKERLA- 1@OKAXIS-KKBK0007463-545256288013-UPI,0000545256288013,20000.0,0.0,20242.48
27/03/25,UPI,UPI-MANIKESHWAR SS3 NEW-Q006276047@YBL-Y ESB0YBLUPI-545212797365-UPI,0000545212797365,0.0,350.0,19892.48
27/03/25,UPI,UPI-SIMMA RAMALAKSHMI-8179933440@AXL-UBI N0800236-811381676110-PAYMENT FROM PHONE,0000811381676110,30.0,0.0,19922.48
27/03/25,UPI,UPI-TIRIVISETTY SATYANAR-Q628175389@YBL- YESB0YBLUPI-545234599836-UPI,0000545234599836,0.0,30.0,19892.48
27/03/25,UPI,UPI-RAPARTI SRIHARI-9493207195@YBL-BKID0 008627-105527912485-PAYMENT FROM PHONE,0000105527912485,0.0,13000.0,6892.48
27/03/25,UPI,UPI-MUKKERLA GEETA SUDHA-GEETHAMUKKERLA- 1@OKAXIS-KKBK0007463-508649630727-UPI,0000508649630727,12500.0,0.0,19392.48
27/03/25,UPI,UPI-MAHENDRA JALA-JALAMAHENDRA@OKAXIS-K KBK0007466-508674121398-UPI,0000508674121398,0.0,16000.0,3392.48
27/03/25,UPI,UPI-RAJESH C PATEL-CNKRAJESHPATEL@OKAXIS -KKBK0008052-508660348647-ADVANCE,0000508660348647,2000.0,0.0,5392.48
27/03/25,UPI,UPI-LIBERTYSRIHARIOKICIC-LIBERTYSRIHARI@ OKICICI-BKID0008627-508690651469-UPI,0000508690651469,0.0,1300.0,4092.48
28/03/25,UPI,UPI-NANDINI RAMESH GANDH-MAB.03724402210 0110@AXISBANK-UTIB0000100-508793564378-U PI,0000508793564378,0.0,200.0,3892.48
28/03/25,POS,CASH DEPOSIT-416021XXXXXX2657-BARKATPURA,0000000000002069,2600.0,0.0,6492.48
28/03/25,UPI,UPI-GANTA SUJATHA-SUJATHAGANAT13@OKSBI- SBIN0005895-508737089965-UPI,0000508737089965,0.0,5000.0,1492.48
28/03/25,UPI,UPI-PREMLATA MARDA-8639436017@PNB-PUNB00 50201-508734596510-PAY REQUEST,0000508734596510,1000.0,0.0,2492.48
28/03/25,UPI,UPI-MR RAVI TEJA POTHAR-RAVITEJAYADAV95 28@OKHDFCBANK-CBIN0280808-545302503823-U PI,0000545302503823,0.0,500.0,1992.48
28/03/25,UPI,UPI-LIBERTYSRIHARIOKICIC-LIBERTYSRIHARI@ OKICICI-BKID0008627-545307403102-UPI,0000545307403102,0.0,1300.0,692.48
28/03/25,UPI,UPI-M ARVIND-ARVINDYADAV69552@OKAXIS-K KBK0007473-545374637971-UPI,0000545374637971,350.0,0.0,1042.48
28/03/25,UPI,UPI-MOHD AHMED ALI-AQUA.AHMED98@AXL-UTIB 0001808-688074737043-PAYMENT FROM PHONE,0000688074737043,180.0,0.0,1222.48
28/03/25,UPI,UPI-MOHD AHMED ALI-AQUA.AHMED98@AXL-UTIB 0001808-824658179956-PAYMENT FROM PHONE,0000824658179956,90.0,0.0,1312.48
29/03/25,UPI,UPI-MAHAVIR SETHI-9392489604@AXL-SBIN00 05895-287359028620-PAYMENT FROM PHONE,0000287359028620,2000.0,0.0,3312.48
29/03/25,UPI,UPI-MR MARYPEDDY YADAIAH-PAYTMQR5WD1F4@P TYS-YESB0PTMUPI-545429223428-UPI,0000545429223428,0.0,35.0,3277.48
29/03/25,UPI,UPI-MR MARYPEDDY YADAIAH-PAYTMQR5WD1F4@P TYS-YESB0PTMUPI-545440731517-UPI,0000545440731517,0.0,116.0,3161.48
29/03/25,UPI,UPI-DURGA WINES PROP BAD-Q784417476@YBL- YESB0YBLUPI-545442937838-UPI,0000545442937838,0.0,380.0,2781.48
29/03/25,UPI,UPI-S MADHU-BHARATPE.8002846649@FBPE-FDR L0001382-545446549589-PAY TO MADHU SAHAD,0000545446549589,0.0,110.0,2671.48
29/03/25,UPI,UPI-B BHARATHI-Q594782917@YBL-YESB0YBLU PI-545400146879-UPI,0000545400146879,0.0,12.0,2659.48
29/03/25,UPI,UPI-MR RAVI TEJA POTHAR-RAVITEJAYADAV95 28@OKHDFCBANK-CBIN0280808-545447056294-U PI,0000545447056294,0.0,1000.0,1659.48
29/03/25,UPI,UPI-MUKKAMI ANAND-ANAND.MUKKAMI@OKAXIS- SBIN0000952-508851335239-UPI,0000508851335239,1240.0,0.0,2899.48
29/03/25,UPI,UPI-LIBERTYSRIHARIOKICIC-LIBERTYSRIHARI@ OKICICI-BKID0008627-545437582610-UPI,0000545437582610,0.0,1300.0,1599.48
29/03/25,UPI,UPI-MARIYALA VENKATESH-MARIYALA.VENKATES H.87-1@OKAXIS-BKID0008626-545468786730-U PI,0000545468786730,0.0,400.0,1199.48
30/03/25,UPI,UPI-TIRIVISETTY SATYANAR-Q628175389@YBL- YESB0YBLUPI-545568891151-UPI,0000545568891151,0.0,30.0,1169.48
30/03/25,UPI,UPI-JAI SANTHOSHI MATHA-GPAY-11256386643 @OKBIZAXIS-UTIB0000553-508952003965-UPI,0000508952003965,0.0,20.0,1149.48
30/03/25,UPI,UPI-R VANDANA-Q021206969@YBL-YESB0YBLUP I-545500795641-UPI,0000545500795641,0.0,25.0,1124.48
30/03/25,UPI,UPI-NEWSURESH LAXMAIAH -Q438494362@YBL- YESB0YBLUPI-508962734076-UPI,0000508962734076,0.0,250.0,874.48
30/03/25,UPI,UPI-AKSHAY CHINTALA-AKKI4655-1@OKICICI-C NRB0000033-508995738685-UPI,0000508995738685,1395.0,0.0,2269.48
30/03/25,UPI,UPI-SUKDEB DAS-PAYTM.S15MZBJ@PTY-YESB0MC HUPI-508986348859-UPI,0000508986348859,0.0,120.0,2149.48
30/03/25,UPI,UPI-ANJALI BASANT-9903315499@IKWIK-UBIN0 825522-100261903329-NA,0000100261903329,1200.0,0.0,3349.48
30/03/25,UPI,UPI-LIBERTYSRIHARIOKICIC-LIBERTYSRIHARI@ OKICICI-BKID0008627-508991041828-UPI,0000508991041828,0.0,1300.0,2049.48
30/03/25,UPI,UPI-BHAGYA LAKSHIMI WINE-PAYTM.S19K5D0@P TY-YESB0MCHUPI-508988447192-UPI,0000508988447192,0.0,320.0,1729.48
30/03/25,UPI,UPI-DUSAR VIJAY KUMAR GO-PAYTM.S1BP5ET@P TY-YESB0MCHUPI-508912442013-UPI,0000508912442013,0.0,63.0,1666.48
31/03/25,UPI,UPI-M ANIL YADAV-ANILYADAV63473-1@OKSBI- UBIN0803219-509012043706-UPI,0000509012043706,0.0,600.0,1066.48
31/03/25,UPI,UPI-CHITRA APPLARAJU-GPAY-11256411307@OK BIZAXIS-UTIB0000553-509092361590-UPI,0000509092361590,0.0,115.0,951.48
31/03/25,UPI,UPI-A LAXMI-Q655807646@YBL-YESB0YBLUPI-5 09039753758-UPI,0000509039753758,0.0,40.0,911.48
31/03/25,UPI,UPI-SBIPMOPAD02221190031-SBIPMOPAD.02221 1900319216-YM542723@SBIPAY-SBIP0123456-5 09005063466-UPI,0000509005063466,0.0,155.0,756.48
31/03/25,UPI,UPI-BUDUMURU BHARGAVI-BHARGAVIBUDUMURU@ YBL-CNRB0000033-308479085036-PAYMENT FRO M PHONE,0000308479085036,2170.0,0.0,2926.48
31/03/25,UPI,UPI-MOHD AHMED ALI-AQUA.AHMED98@AXL-UTIB 0001808-943893227426-PAYMENT FROM PHONE,0000943893227426,270.0,0.0,3196.48
31/03/25,UPI,UPI-SHABARI ENGINEERING -MERUGUNARENDER9 99-6@OKHDFCBANK-BKID0005749-102369859486 -UPI,0000102369859486,2200.0,0.0,5396.48
31/03/25,UPI,UPI-MR RAVI TEJA POTHAR-RAVITEJAYADAV95 28@OKHDFCBANK-CBIN0280808-509092895391-U PI,0000509092895391,0.0,500.0,4896.48
31/03/25,UPI,UPI-KAJAL DEVI-Q083881791@YBL-YESB0YBLUP I-545642012378-UPI,0000545642012378,0.0,20.0,4876.48
31/03/25,UPI,UPI-NAGRAJ-MUKKERLANAGRAJ@OKAXIS-UBIN080 3219-545685908543-UPI,0000545685908543,0.0,200.0,4676.48
31/03/25,UPI,UPI-LIBERTYSRIHARIOKICIC-LIBERTYSRIHARI@ OKICICI-BKID0008627-545649401895-UPI,0000545649401895,0.0,1300.0,3376.48
31/03/25,UPI,UPI-NAGRAJ-MUKKERLANAGRAJ@OKAXIS-UBIN080 3219-509022918692-UPI,0000509022918692,4000.0,0.0,7376.48
31/03/25,,BHDFOTJ0H3EL6O/BILLDKRATNAKARBANKLI,0000259080384478,0.0,6857.0,519.48
31/03/25,UPI,UPI-KOLLAPURAM MALLIKARJ-MALLIKARJUNKOLA PURAM@OKSBI-HDFC0000218-509048097274-UPI,0000509048097274,0.0,100.0,419.48
31/03/25,UPI,UPI-MAHAVIR SETHI-9392489604@AXL-SBIN00 05895-282289147683-PAYMENT FROM PHONE,0000282289147683,960.0,0.0,1379.48
01/04/25,,INTEREST PAID TILL 31-MAR-2025,000000000000000,509.0,0.0,1888.48
01/04/25,UPI,UPI-CHITRA APPLARAJU-GPAY-11256411307@OK BIZAXIS-UTIB0000553-545774709696-UPI,0000545774709696,0.0,180.0,1708.48
01/04/25,UPI,UPI-KOUR H-HARDEEPKOUR24@OKAXIS-HSBC0500 002-509198342596-UPI,0000509198342596,1395.0,0.0,3103.48
01/04/25,UPI,UPI-MADHURI MARAM-LIPIKAMARAM@OKICICI-IC IC0000008-545787428143-UPI,0000545787428143,2790.0,0.0,5893.48
01/04/25,UPI,UPI-ATEEQAHMED5789OKICIC-ATEEQAHMED5789@ OKICICI-KKBK0007474-545782542572-UPI,0000545782542572,0.0,520.0,5373.48
01/04/25,UPI,UPI-JIO RECHARGE-JIOINAPPDIRECT@YBL-YESB 0YBLUPI-546364075162-PAYMENT FROM PHONE,0000546364075162,0.0,352.0,5021.48
01/04/25,UPI,UPI-MOHD PASHA MIYA-8074523914@YBL-LAVB0 000572-824733902018-PAYMENT FROM PHONE,0000824733902018,0.0,600.0,4421.48
01/04/25,UPI,UPI-MOHD PASHA MIYA-8074523914@YBL-LAVB0 000572-985505324847-PAYMENT FROM PHONE,0000985505324847,0.0,200.0,4221.48
01/04/25,UPI,UPI-RITHIK MITTAL-RITHIKMITTAL2606-1@OKH DFCBANK-HDFC0000081-102440790123-UPI,0000102440790123,1090.0,0.0,5311.48
01/04/25,UPI,UPI-LIBERTYSRIHARIOKICIC-LIBERTYSRIHARI@ OKICICI-BKID0008627-545782272328-UPI,0000545782272328,0.0,1300.0,4011.48
02/04/25,UPI,UPI-PANYAM MANJULA-MANJUPANYAM@OKSBI-SB IN0007641-509210697734-MILK PAY,0000509210697734,640.0,0.0,4651.48
02/04/25,UPI,UPI-RONAK NEELESH RUPARA-KUMARRONAK7@OKA XIS-HDFC0000545-545831440265-APRIL MILK BILL,0000545831440265,685.0,0.0,5336.48
02/04/25,UPI,UPI-MURALIKRISHNA VEGETA-GPAY-1124438713 1@OKBIZAXIS-UTIB0000553-545871181837-UPI,0000545871181837,0.0,270.0,5066.48
02/04/25,UPI,UPI-RAPARTHI SRI HARI-9493207195-2@YBL-K KBK0000563-079094152312-PAYMENT FROM PHO NE,0000079094152312,100000.0,0.0,105066.48
02/04/25,UPI,UPI-RITHIK MITTAL-RITHIKMITTAL2606-1@OKH DFCBANK-HDFC0000081-545805176396-UPI,0000545805176396,0.0,75.0,104991.48
02/04/25,UPI,UPI-ANGEL ONE LIMITED-ANGELONENSE@ICICI- ICIC0DC0099-545849478287-PAYINGANGELONE,0000545849478287,0.0,40000.0,64991.48
02/04/25,UPI,UPI-FATAKPAY DIGITAL PRI-FATAKPAYDIGITAL 136700.RZP@AXISBANK-UTIB0000100-54585318 1420-OUTSTANDINGAMOUNT,0000545853181420,0.0,7774.8,57216.68
02/04/25,UPI,UPI-MUNTHA RAMESH YADAV-RAMEESHM6666@YBL -BKID0008604-800321532086-PAYMENT FROM P HONE,0000800321532086,0.0,6000.0,51216.68
02/04/25,UPI,UPI-M MADHU YADAV-9985065404-2@YBL-SBIN 0006645-763506433726-PAYMENT FROM PHONE,0000763506433726,5200.0,0.0,56416.68
02/04/25,UPI,UPI-MWYN TECH PRIVATE LI-MWYNTECHPRIVATE 893267.RZP@RXAIRTEL-AIRP0000011-54581037 5214-MWYNTECHPRIVATELIM,0000545810375214,0.0,1163.02,55253.66
02/04/25,UPI,UPI-RAPARTI SRIHARI-9493207195@YBL-BKID0 008627-204827430115-PAYMENT FROM PHONE,0000204827430115,0.0,10000.0,45253.66
02/04/25,UPI,UPI-MOHAMMED IRFAN-GPAY-11254060173@OKBI ZAXIS-UTIB0000553-509249800240-UPI,0000509249800240,0.0,40.0,45213.66
02/04/25,UPI,UPI-KATEPALLY VINAY KUM-VINAYKUMARKATEP ALLY@OKSBI-SBIN0003086-509248448712-UPI,0000509248448712,1305.0,0.0,46518.66
02/04/25,UPI,UPI-LIBERTYSRIHARIOKICIC-LIBERTYSRIHARI@ OKICICI-BKID0008627-509276622964-UPI,0000509276622964,0.0,1300.0,45218.66
02/04/25,UPI,UPI-ABSIPURAM PRASOONA-9948434877@YBL-S BIN0020083-917167665702-PAYMENT FROM PHO NE,0000917167665702,640.0,0.0,45858.66
02/04/25,UPI,UPI-RAPARTI SRIHARI-9493207195@YBL-BKID0 008627-486514040312-PAYMENT FROM PHONE,0000486514040312,90000.0,0.0,135858.66
02/04/25,UPI,UPI-MARGAM VANI-VANIMARGAM510@OKAXIS-SB IN0021100-509280450154-UPI,0000509280450154,0.0,60000.0,75858.66
02/04/25,UPI,UPI-ZERODHA BROKING LTD-ZERODHABROKING@H DFCBANK-HDFC0MERUPI-509227842220-6121512 260888531 Z,0000509227842220,0.0,18000.0,57858.66
03/04/25,IMPS,IMPS-509300110497-FDPL FINANCE PRIVATE-I CIC-XXXXXXXX3844-ICITXN47356888,0000509300110497,7292.0,0.0,65150.66
03/04/25,UPI,UPI-M ANIL YADAV-ANILYADAV63473-1@OKSBI- UBIN0803219-509393252863-UPI,0000509393252863,0.0,3000.0,62150.66
03/04/25,UPI,UPI-M ANIL YADAV-ANILYADAV63473-1@OKSBI- UBIN0803219-509301947317-UPI,0000509301947317,0.0,3000.0,59150.66
03/04/25,UPI,UPI-MANE NAVNEETHA-PAYTMQR66O8TP@PTYS-YE SB0PTMUPI-509382141711-UPI,0000509382141711,0.0,30.0,59120.66
03/04/25,UPI,UPI-MUKKERLA GEETA SUDHA-6302856696@YBL- KKBK0007463-509340655308-UPI,0000509340655308,0.0,2300.0,56820.66
03/04/25,UPI,UPI-A NARESH KUMAR-Q749466560@YBL-YESB0Y BLUPI-509390650785-UPI,0000509390650785,0.0,11.0,56809.66
03/04/25,UPI,UPI-LAXMI NARSHIMA SWAMY-GPAY-1124082018 5@OKBIZAXIS-UTIB0000553-509311153029-UPI,0000509311153029,0.0,10.0,56799.66
03/04/25,UPI,UPI-ZERODHA BROKING LTD-ZERODHABROKING@H DFCBANK-HDFC0MERUPI-509350060735-6528746 646687146 Z,0000509350060735,0.0,13000.0,43799.66
03/04/25,UPI,UPI-LIMBAGIRI SWAMY BAND-LIMBAGIRISWAMY1 @YBL-HDFC0000562-159432650513-PAYMENT FR OM PHONE,0000159432650513,1.0,0.0,43800.66
03/04/25,UPI,UPI-ZERODHA BROKING LTD-ZERODHABROKING@H DFCBANK-HDFC0MERUPI-509362458055-8817260 942447592 Z,0000509362458055,0.0,5000.0,38800.66
03/04/25,UPI,UPI-B SHIRISHA-SIRISHA0413@YBL-UBIN08007 67-916862143148-PAYMENT FROM PHONE,0000916862143148,2325.0,0.0,41125.66
03/04/25,UPI,UPI-PREMLATA MARDA-8639436017@PNB-PUNB00 50201-509336094202-PAY REQUEST,0000509336094202,445.0,0.0,41570.66
03/04/25,UPI,UPI-KEERTHI NEELI-SAI.TAANYA26@OKAXIS-BA RB0BARKAT-509302575791-UPI,0000509302575791,1320.0,0.0,42890.66
03/04/25,UPI,UPI-MOHD PASHA MIYA-8074523914@YBL-LAVB0 000572-102530509595-PAYMENT FROM PHONE,0000102530509595,0.0,600.0,42290.66
03/04/25,UPI,UPI-NEW MADHUSHALA RESTA-MAB.03734601380 0012@AXISBANK-UTIB0000100-509398996891-U PI,0000509398996891,0.0,420.0,41870.66
03/04/25,UPI,UPI-LIBERTYSRIHARIOKICIC-LIBERTYSRIHARI@ OKICICI-BKID0008627-509363692471-UPI,0000509363692471,0.0,1300.0,40570.66
03/04/25,NEFT,NEFT CR-ICIC0099999-ANGEL ONE LIMITED-MU KKERLA MADHU YADAV-ICICN220250403000976,ICICN22025040300,1279.1,0.0,41849.76
04/04/25,UPI,UPI-SUHAS MADHUKAR CHAUD-DRSUHAS2003@OKH DFCBANK-KKBK0001367-102558155412-UPI,0000102558155412,2250.0,0.0,44099.76
04/04/25,UPI,UPI-MANE NAVNEETHA-PAYTMQR66O8TP@PTYS-YE SB0PTMUPI-546022511341-UPI,0000546022511341,0.0,30.0,44069.76
04/04/25,,ANGEL ONE LIMI-246175028,0000504044919589,220.9,0.0,44290.66
04/04/25,,ACH D- PROTIUM FINANCE LIMI-DSQGRUW6F15T,0000006807854536,0.0,28475.0,15815.66
04/04/25,UPI,UPI-SAMUDHRALA MANASA-6305167013@PTHDFC- SBIN0RRDCGB-509437566574-SENT USING PAYT M U,0000509437566574,2780.0,0.0,18595.66
04/04/25,UPI,UPI-RAPARTI SRIHARI-LIBERTYSRIHARI@OKICI CI-BKID0008627-102599058095-PAYMENT FROM PHONE,0000102599058095,0.0,10000.0,8595.66
04/04/25,UPI,UPI-MOHAMMEDGHOUSE123407-MOHAMMEDGHOUSE1 2340786@OKAXIS-SBIN0005895-546074941083- UPI,0000546074941083,0.0,500.0,8095.66
04/04/25,UPI,UPI-GOGA ELECTRONICS-9849436607@YBL-APMC 0000006-180289433602-PAYMENT FROM PHONE,0000180289433602,0.0,1.0,8094.66
04/04/25,UPI,UPI-GOGA ELECTRONICS-9849436607@YBL-APMC 0000006-264776135789-PAYMENT FROM PHONE,0000264776135789,5880.0,0.0,13974.66
04/04/25,UPI,UPI-HARSHITA SRIVASTAVA-HARSHITASINGHPAB ARI@OKAXIS-KARB0000289-546076453851-UPI,0000546076453851,3265.0,0.0,17239.66
04/04/25,UPI,UPI-IRFANA ANJUM-SYEDTALIBTALIB9@OKAXIS- IOBA0001275-546025068499-UPI,0000546025068499,1600.0,0.0,18839.66
04/04/25,UPI,UPI-SASHIKALA BHANDARI-9032117972@IBL-S BIN0005895-187899028881-PAYMENT FROM PHO NE,0000187899028881,2490.0,0.0,21329.66
04/04/25,UPI,UPI-DADIGA SHIVA KUMAR-DADIGASHIVA86@OK AXIS-SBIN0005895-546082751752-UPI,0000546082751752,0.0,50.0,21279.66
04/04/25,UPI,UPI-BILLA S-9700452204-2@IBL-HSBC0500002 -754375957046-PAYMENT FROM PHONE,0000754375957046,1240.0,0.0,22519.66
04/04/25,NEFT,NEFT CR-ICIC0099999-ANGEL ONE LIMITED-MU KKERLA MADHU YADAV-ICICN220250404011047,ICICN22025040401,45000.0,0.0,67519.66
04/04/25,UPI,UPI-LIBERTYSRIHARIOKICIC-LIBERTYSRIHARI@ OKICICI-BKID0008627-546080754683-UPI,0000546080754683,0.0,1300.0,66219.66
04/04/25,UPI,UPI-B VINOD KUMAR-BALERAOVINOD077@OKSBI- CNRB0000033-546044545027-UPI,0000546044545027,0.0,3000.0,63219.66
04/04/25,UPI,UPI-HANAMANT SHIVASHARAN-9845711128@YBL- SBIN0015263-975120840758-PAYMENT FROM PH ONE,0000975120840758,1800.0,0.0,65019.66
04/04/25,UPI,UPI-JURRU RAHUL YADAV-JRAHULYADAV29@OKS BI-SBIN0007641-546019450870-UPI,0000546019450870,0.0,10740.0,54279.66
04/04/25,UPI,UPI-MUNTHA RAMESH YADAV-RAMEESHM6666@YBL -BKID0008604-818157931853-PAYMENT FROM P HONE,0000818157931853,0.0,4000.0,50279.66
05/04/25,UPI,UPI-M ARVIND-ARVINDYADAV69552@OKAXIS-K KBK0007473-509514206567-UPI,0000509514206567,500.0,0.0,50779.66
05/04/25,,ANGEL ONE LIMI-1043414108,0000504057321622,15470.25,0.0,66249.91
05/04/25,UPI,UPI-TIRIVISETTY SATYANAR-Q628175389@YBL- YESB0YBLUPI-546141874741-UPI,0000546141874741,0.0,50.0,66199.91
05/04/25,,ACH D- IKF HOME FINANCE LTD-050420250516,0000006856220984,0.0,18882.0,47317.91
05/04/25,UPI,UPI-MR MARYPEDDY YADAIAH-PAYTMQR1QEBB0LQ 0U@PAYTM-YESB0PTMUPI-546151284817-UPI,0000546151284817,0.0,35.0,47282.91
05/04/25,,ACH D- WHIZDM FINANCE PRIVA-269030793860,0000006857102619,0.0,7460.0,39822.91
05/04/25,UPI,UPI-JAI SANTHOSHI MATHA-GPAY-11250766748 @OKBIZAXIS-UTIB0000553-546127898200-UPI,0000546127898200,0.0,20.0,39802.91
05/04/25,UPI,UPI-BALA KASHYAP-BALA.KASHYAP1@YBL-HDFC0 000126-635490009414-PAYMENT FROM PHONE,0000635490009414,1085.0,0.0,40887.91
05/04/25,UPI,UPI-JURRU RAHUL YADAV-Q758292524@YBL-YE SB0YBLUPI-509587509543-UPI,0000509587509543,0.0,70.0,40817.91
05/04/25,UPI,UPI-MOHD PASHA MIYA-8074523914@YBL-LAVB0 000572-166057049934-PAYMENT FROM PHONE,0000166057049934,0.0,600.0,40217.91
05/04/25,UPI,UPI-SHAIK ABU ZUBEIR-ZUBEIR14-2@OKHDFCB ANK-SBIN0016275-102658289493-UPI,0000102658289493,1570.0,0.0,41787.91
05/04/25,UPI,UPI-LIBERTYSRIHARIOKICIC-LIBERTYSRIHARI@ OKICICI-BKID0008627-509505026359-UPI,0000509505026359,0.0,1300.0,40487.91
05/04/25,UPI,UPI-MOHD MAHMOOD ALI-9347010777@YBL-PUNB 0020700-530781301907-PAYMENT FROM PHONE,0000530781301907,3000.0,0.0,43487.91
05/04/25,UPI,UPI-JURRU RAHUL YADAV-9963019626@YBL-SB IN0007641-905500934234-PAYMENT FROM PHON E,0000905500934234,2300.0,0.0,45787.91
06/04/25,UPI,UPI-CHELUKALA BABU-MAHESHBABU14999@OKSBI -JIOP0000001-509636748514-UPI,0000509636748514,0.0,500.0,45287.91
06/04/25,UPI,UPI-J SHIVANARAYANA-BHARATPE90726407443@ YESBANKLTD-YESB0YESUPI-509643247977-PAY TO J SHIVANARA,0000509643247977,0.0,220.0,45067.91
06/04/25,UPI,UPI-MANE NAVNEETHA-PAYTMQR66FHIY@PTYS-YE SB0PTMUPI-509670655058-UPI,0000509670655058,0.0,30.0,45037.91
06/04/25,UPI,UPI-KONDUPUGANTI MAHESH-KODUPUGANTIMAHE SH4@OKHDFCBANK-SBIN0003086-509643160794- UPI,0000509643160794,0.0,160.0,44877.91
06/04/25,UPI,UPI-UNDRATHI SAI NATH-9121898470-2@IBL-H DFC0000743-509696766087-UPI,0000509696766087,0.0,20.0,44857.91
06/04/25,UPI,UPI-SANDIP MAROTIRAO BOG-123SANDEEPBOGUL WAR-1@OKHDFCBANK-BARB0MUKHED-50960556461 6-UPI,0000509605564616,0.0,450.0,44407.91
06/04/25,UPI,UPI-J SHIVANARAYANA-BHARATPE90726407443@ YESBANKLTD-YESB0YESUPI-509660978130-PAY TO J SHIVANARA,0000509660978130,0.0,50.0,44357.91
06/04/25,UPI,UPI-BALAJI-Q569840321@YBL-YESB0YBLUPI-50 9694669896-UPI,0000509694669896,0.0,25.0,44332.91
06/04/25,UPI,UPI-DADIGA SHIVA KUMAR-DADIGASHIVA86@OK AXIS-SBIN0005895-509691273260-UPI,0000509691273260,0.0,350.0,43982.91
06/04/25,UPI,UPI-BHARATHI BHARATHI-BHARTHI9573@YBL-S BIN0020701-509612660664-UPI,0000509612660664,0.0,6000.0,37982.91
06/04/25,UPI,UPI-ZERODHA BROKING LTD-ZERODHABROKING@H DFCBANK-HDFC0MERUPI-509622057796-3128617 683058863 Z,0000509622057796,0.0,20250.0,17732.91
06/04/25,,IB BILLPAY DR-HDFC92-434155XXXXXX1025,MB06154544682T17,0.0,10481.0,7251.91
06/04/25,UPI,UPI-RAPARTI SRIHARI-LIBERTYSRIHARI@OKICI CI-BKID0008627-368359917229-PAYMENT FROM PHONE,0000368359917229,0.0,1500.0,5751.91
06/04/25,UPI,UPI-LIBERTYSRIHARIOKICIC-LIBERTYSRIHARI@ OKICICI-BKID0008627-509687980018-UPI,0000509687980018,0.0,1300.0,4451.91
06/04/25,UPI,UPI-RDS112 BARKATPURA-PAYTM-70912842@PTY S-YESB0PTMUPI-509614791355-UPI,0000509614791355,0.0,375.0,4076.91
06/04/25,UPI,UPI-JURRU RAHUL YADAV-9963019626@YBL-SB IN0007641-750406876429-PAYMENT FROM PHON E,0000750406876429,0.0,300.0,3776.91
06/04/25,UPI,UPI-RASALA KRANTHI KUMAR-KRANTHIRANADHEE R3@YBL-HDFC0003916-759549019600-PAYMENT FROM PHONE,0000759549019600,32000.0,0.0,35776.91
06/04/25,UPI,UPI-MOHAMMAD AHMED-AHMEDPAILWAN1@AXL-HDF C0001635-626168302001-PAYMENT FROM PHONE,0000626168302001,15000.0,0.0,50776.91
06/04/25,UPI,UPI-ANGEL LTD NSE-ANGELONENSE@HDFCBANK-H DFC0MERUPI-546290904303-PAYINGANGELONE,0000546290904303,0.0,21000.0,29776.91
07/04/25,UPI,UPI-M ANIL YADAV-ANILYADAV63473-1@OKHDFC BANK-UBIN0803219-102742281223-UPI,0000102742281223,5795.0,0.0,35571.91
07/04/25,UPI,UPI-MUKKERLA GEETA SUDHA-6302856696@YBL- KKBK0007463-546396238873-UPI,0000546396238873,0.0,30000.0,5571.91
07/04/25,UPI,UPI-ANGEL LTD NSE-ANGELONENSE@HDFCBANK-H DFC0MERUPI-546334218341-PAYINGANGELONE,0000546334218341,0.0,3200.0,2371.91
07/04/25,UPI,UPI-KARRA SATHISH-9293555325-7@AXL-BKID0 005707-327476953143-PAYMENT FROM PHONE,0000327476953143,42000.0,0.0,44371.91
07/04/25,UPI,UPI-ZERODHA BROKING LTD-ZERODHABROKING@H DFCBANK-HDFC0MERUPI-546331731403-5450536 366235635 Z,0000546331731403,0.0,8000.0,36371.91
07/04/25,UPI,UPI-RAPARTI SRIHARI-LIBERTYSRIHARI@OKICI CI-BKID0008627-883248585993-PAYMENT FROM PHONE,0000883248585993,0.0,13000.0,23371.91
07/04/25,UPI,UPI-PHONEPE-BBPSBP@YBL-YESB0YBLUPI-32299 8071989-PAYMENT FROM PHONE,0000322998071989,0.0,5337.96,18033.95
07/04/25,UPI,UPI-RATNADEEP SUPERMARKE-PAYTM-64471141@ PTYS-YESB0PTMUPI-546371850127-UPI,0000546371850127,0.0,59.0,17974.95
07/04/25,UPI,UPI-ERABOGADA SURESHRAO-BHARATPE.9O0X0R 7S3L186288@FBPE-FDRL0001382-546329739889 -PAY TO BHARATPE ME,0000546329739889,0.0,100.0,17874.95
07/04/25,UPI,UPI-G KRANTHI KUMAR-9966660645@YBL-ANDB0 000858-990717763724-PAYMENT FROM PHONE,0000990717763724,1000.0,0.0,18874.95
07/04/25,UPI,UPI-VARTHYAVATH THIRUPA-THIRUPATI1981NA IK@OKHDFCBANK-SBIN0021009-102758684735-U PI,0000102758684735,2250.0,0.0,21124.95
07/04/25,UPI,UPI-M MADHU YADAV-9985065404-2@YBL-SBIN 0006645-979399071810-PAYMENT FROM PHONE,0000979399071810,25000.0,0.0,46124.95
07/04/25,UPI,UPI-MOHD PASHA MIYA-8074523914@YBL-LAVB0 000572-929666703090-PAYMENT FROM PHONE,0000929666703090,0.0,600.0,45524.95
07/04/25,UPI,UPI-KARRA SATHISH-9293555325-7@YBL-BKID0 005707-118006625090-PAYMENT FROM PHONE,0000118006625090,0.0,1000.0,44524.95
07/04/25,UPI,UPI-JURRU RAHUL YADAV-9963019626@YBL-SB IN0007641-091620105082-PAYMENT FROM PHON E,0000091620105082,0.0,300.0,44224.95
07/04/25,UPI,UPI-MUTHOOT FINCORP LIMI-ONEMUTHOOT468.R ZP@AXISBANK-UTIB0000100-546322569332-PAY VIARAZORPAY,0000546322569332,0.0,16783.18,27441.77
07/04/25,NEFT,NEFT CR-ICIC0099999-ANGEL ONE LIMITED-MU KKERLA MADHU YADAV-ICICN220250407087615,ICICN22025040708,12000.0,0.0,39441.77
07/04/25,UPI,UPI-LIBERTYSRIHARIOKICIC-LIBERTYSRIHARI@ OKICICI-BKID0008627-546331877631-UPI,0000546331877631,0.0,1300.0,38141.77
07/04/25,UPI,UPI-DEEP SHIKHA GUPTA-7416324551@IBL-BAR B0HIMHYD-546391990158-UPI,0000546391990158,0.0,1870.0,36271.77
07/04/25,UPI,UPI-ORUGANTI SRINIVAS RE-OSRINIVAS555@OK AXIS-UTIB0000426-509713034684-UPI,0000509713034684,1200.0,0.0,37471.77
08/04/25,NEFT,NEFT CR-YESB0000001-ZERODHA BROKING LTD- DSCNB A/C-MUKKERLA MADHU YADAV-YESBN1202,YESBN12025040800,5000.0,0.0,42471.77
08/04/25,UPI,UPI-KOUR H-HARDEEPKOUR24@OKAXIS-HSBC0500 002-509805847573-UPI,0000509805847573,400.0,0.0,42871.77
08/04/25,UPI,UPI-MUKKERLA GEETA SUDHA-6302856696@YBL- KKBK0007463-546432194538-UPI,0000546432194538,0.0,600.0,42271.77
08/04/25,UPI,UPI-UPMOVE CAPITAL PRIVA-UPMOVECAPITALPR 695125.RZP@RXAIRTEL-AIRP0000011-50980815 7050-UPMOVECAPITALPRIVA,0000509808157050,0.0,7134.54,35137.23
08/04/25,UPI,UPI-LAXMI NARSHIMA SWAMY-GPAY-1124082018 5@OKBIZAXIS-UTIB0000553-546412193300-UPI,0000546412193300,0.0,10.0,35127.23
08/04/25,UPI,UPI-CHAKALI CHINNA KURUM-96669658523@IBL -KKBK0007473-509872314153-UPI,0000509872314153,0.0,180.0,34947.23
08/04/25,UPI,UPI-M ARVIND RAJ-ARVINDRAJ57964-1@OKHDFC BANK-HDFC0000512-102794631086-UPI,0000102794631086,1705.0,0.0,36652.23
08/04/25,UPI,UPI-PHONEPE-BBPSBP@YBL-YESB0YBLUPI-71614 8559168-PAYMENT FROM PHONE,0000716148559168,0.0,1700.0,34952.23
08/04/25,UPI,UPI-SANJAY UIKEY-7997088152@YBL-SBIN000 6962-757848152652-PAYMENT FROM PHONE,0000757848152652,0.0,3000.0,31952.23
08/04/25,UPI,UPI-PASHAM SANDEEP KUMA-PASHAMSANDEEPHY D@YBL-SBIN0006645-796071297957-PAYMENT F ROM PHONE,0000796071297957,1200.0,0.0,33152.23
08/04/25,UPI,UPI-RAKESH B-B.RAKESHY97@OKSBI-SBIN0020 067-509800609956-GOLNAK MILK BILL S,0000509800609956,0.0,1200.0,31952.23
08/04/25,UPI,UPI-ANGEL ONE LIMITED-ANGELONENSE@ICICI- ICIC0DC0099-546465194342-PAYINGANGELONE,0000546465194342,0.0,2000.0,29952.23
08/04/25,UPI,UPI-SRI BALAJI BAKERY-PAYTMQR66O95U@PTYS -YESB0PTMUPI-509884717340-UPI,0000509884717340,0.0,10.0,29942.23
08/04/25,UPI,UPI-ANGEL ONE LIMITED-ANGELONENSE@ICICI- ICIC0DC0099-546410699468-PAYINGANGELONE,0000546410699468,0.0,8000.0,21942.23
08/04/25,UPI,UPI-K S CONSTRUCTIONS-9393995648-2@YBL-A UBL0002591-021331935247-PAYMENT FROM PHO NE,0000021331935247,700.0,0.0,22642.23
08/04/25,UPI,UPI-BHARATHI BHARATHI-BHARTHI9573@YBL-S BIN0020701-509884615275-UPI,0000509884615275,0.0,6000.0,16642.23
08/04/25,UPI,UPI-B RAYUDU-RAYUDU10-1@OKHDFCBANK-HDFC0 000042-102821387380-MILK EXP,0000102821387380,1135.0,0.0,17777.23
08/04/25,UPI,UPI-SHAIK OSMAN-9948812753@IBL-ICIC00000 76-449874925829-PAYMENT FROM PHONE,0000449874925829,1150.0,0.0,18927.23
08/04/25,UPI,UPI-MOHD AHMED ALI-AQUA.AHMED98@AXL-UTIB 0001808-064261780016-PAYMENT FROM PHONE,0000064261780016,40.0,0.0,18967.23
08/04/25,UPI,UPI-KARRA SATHISH-9293555325-7@YBL-BKID0 005707-309941267017-PAYMENT FROM PHONE,0000309941267017,0.0,1000.0,17967.23
08/04/25,UPI,UPI-JURRU RAHUL YADAV-9963019626@YBL-SB IN0007641-032152590184-PAYMENT FROM PHON E,0000032152590184,0.0,300.0,17667.23
08/04/25,UPI,UPI-RAPARTI SRIHARI-LIBERTYSRIHARI@OKAXI S-BKID0008627-509890829235-UPI,0000509890829235,0.0,1300.0,16367.23
08/04/25,UPI,UPI-SURESH NLAXMAIAH BR-Q995279325@YBL- YESB0YBLUPI-509895636541-UPI,0000509895636541,0.0,250.0,16117.23
08/04/25,UPI,UPI-A NARESH KUMAR-Q749466560@YBL-YESB0Y BLUPI-509848346745-UPI,0000509848346745,0.0,44.0,16073.23
08/04/25,UPI,UPI-MASQATI SUPER MARKET-OMBK.AAFT325671 05MILQKREN@ICICI-ICIC0DC0099-50982156436 0-UPI,0000509821564360,0.0,284.0,15789.23
08/04/25,UPI,UPI-A NARESH KUMAR-Q749466560@YBL-YESB0Y BLUPI-509816154022-UPI,0000509816154022,0.0,40.0,15749.23
08/04/25,UPI,UPI-MIRDODI NARESH-8885567891@IBL-SBIN0 021790-250999427447-PAYMENT FROM PHONE,0000250999427447,750.0,0.0,16499.23
09/04/25,NEFT,NEFT CR-YESB0000001-ZERODHA BROKING LTD- DSCNB A/C-MUKKERLA MADHU YADAV-YESBN1202,YESBN12025040901,8000.0,0.0,24499.23
09/04/25,UPI,UPI-MUKKERLA GEETA SUDHA-GEETHAMUKKERLA- 1@OKAXIS-KKBK0007463-546523222296-UPI,0000546523222296,10000.0,0.0,34499.23
09/04/25,UPI,UPI-NAGRAJ-MUKKERLANAGRAJ@OKAXIS-UBIN080 3219-509984567966-UPI,0000509984567966,0.0,1100.0,33399.23
09/04/25,UPI,UPI-M ANIL YADAV-ANILYADAV63473-1@OKSBI- UBIN0803219-509989767562-UPI,0000509989767562,0.0,600.0,32799.23
09/04/25,UPI,UPI-TRUE CREDITS-TRUECREDITS991413.RZP@R XAIRTEL-AIRP0000011-509917066054-TRUECRE DITS,0000509917066054,0.0,6821.0,25978.23
09/04/25,UPI,UPI-GANTA SUJATHA-SUJATHAGANAT13@OKSBI- SBIN0005895-509988878185-UPI,0000509988878185,0.0,6000.0,19978.23
09/04/25,UPI,UPI-ZERODHA BROKING LTD-ZERODHABROKING@H DFCBANK-HDFC0MERUPI-509943482380-3657920 140701991 Z,0000509943482380,0.0,5000.0,14978.23
09/04/25,UPI,UPI-ZERODHA BROKING LTD-ZERODHABROKING@H DFCBANK-HDFC0MERUPI-509940282383-9593679 217680060 Z,0000509940282383,0.0,3000.0,11978.23
09/04/25,UPI,UPI-ZERODHA BROKING LTD-ZERODHABROKING@H DFCBANK-HDFC0MERUPI-509965879570-1762466 350009309 Z,0000509965879570,0.0,2000.0,9978.23
09/04/25,UPI,UPI-JAKKULA PARVATHALU-9948851530@YBL-S BIN0008809-248741556334-PAYMENT FROM PHO NE,0000248741556334,700.0,0.0,10678.23
09/04/25,UPI,UPI-T SRIDHAR SINGH-THAKURSRIDHARSINGH14 @OKICICI-SBIN0006629-509953095181-UPI,0000509953095181,775.0,0.0,11453.23
09/04/25,UPI,UPI-VADICHARLA LAVANYA-9293555325-2@YBL- UTIB0003574-035200444180-PAYMENT FROM PH ONE,0000035200444180,0.0,1000.0,10453.23
09/04/25,UPI,UPI-MOHD PASHA MIYA-8074523914@YBL-LAVB0 000572-007279069753-PAYMENT FROM PHONE,0000007279069753,0.0,600.0,9853.23
09/04/25,UPI,UPI-JURRU RAHUL YADAV-9963019626@YBL-SB IN0007641-769978781828-PAYMENT FROM PHON E,0000769978781828,0.0,300.0,9553.23
09/04/25,UPI,UPI-LIBERTYSRIHARIOKICIC-LIBERTYSRIHARI@ OKICICI-BKID0008627-546527733649-UPI,0000546527733649,0.0,1300.0,8253.23
09/04/25,NEFT,NEFT CR-ICIC0099999-ANGEL ONE LIMITED-MU KKERLA MADHU YADAV-ICICN220250409111931,ICICN22025040911,537.07,0.0,8790.3
10/04/25,UPI,UPI-BHARATHI BHARATHI-BHARTHI9573@YBL-S BIN0020701-546606042869-UPI,0000546606042869,0.0,6000.0,2790.3
10/04/25,UPI,REV-UPI-50100123131847-M.MADHUYADAV26-3@ OKICICI-546606042869-UPI,0000546606042869,6000.0,0.0,8790.3
10/04/25,UPI,UPI-MUKKERLA GEETA SUDHA-GEETHAMUKKERLA- 1@OKAXIS-KKBK0007463-546646098113-UPI,0000546646098113,15000.0,0.0,23790.3
10/04/25,,ATW-416021XXXXXX2657-S1AWHY59-HYDERABAD,0000000000003899,0.0,10000.0,13790.3
10/04/25,UPI,UPI-MUKKERLA GEETA SUDHA-GEETHAMUKKERLA- 1@OKAXIS-KKBK0007463-510072236814-UPI,0000510072236814,9000.0,0.0,22790.3
10/04/25,UPI,UPI-B BHARATHI-Q594782917@YBL-YESB0YBLU PI-546613774815-UPI,0000546613774815,0.0,12.0,22778.3
10/04/25,UPI,UPI-MOHD AHMED ALI-AQUA.AHMED98@AXL-UTIB 0001808-141390975516-PAYMENT FROM PHONE,0000141390975516,180.0,0.0,22958.3
10/04/25,UPI,UPI-KOLLAPURAM MALLIKARJ-MALLIKARJUNKOLA PURAM@OKSBI-HDFC0000218-546653791604-UPI,0000546653791604,0.0,120.0,22838.3
10/04/25,,ATW-416021XXXXXX2657-P3ENTS55-HYDERABAD,0000000000005907,0.0,20000.0,2838.3
10/04/25,UPI,UPI-VADICHARLA LAVANYA-9293555325-2@YBL- UTIB0003574-554210606609-PAYMENT FROM PH ONE,0000554210606609,0.0,1000.0,1838.3
10/04/25,UPI,UPI-JURRU RAHUL YADAV-9963019626@YBL-SB IN0007641-116959608463-PAYMENT FROM PHON E,0000116959608463,0.0,300.0,1538.3
10/04/25,UPI,UPI-LIBERTYSRIHARIOKICIC-LIBERTYSRIHARI@ OKICICI-BKID0008627-546681996523-UPI,0000546681996523,0.0,1300.0,238.3
10/04/25,UPI,UPI-JIO RECHARGE-JIOINAPPDIRECT1@YBL-YES B0YBLUPI-882231586324-PAYMENT FROM PHONE,0000882231586324,0.0,19.0,219.3
11/04/25,UPI,UPI-MUKKERLA GEETA SUDHA-GEETHAMUKKERLA- 1@OKAXIS-KKBK0007463-510180288335-UPI,0000510180288335,6000.0,0.0,6219.3
11/04/25,,ANGEL ONE LIMI-247019059,0000504110228876,62.93,0.0,6282.23
11/04/25,UPI,UPI-BHARATHI BHARATHI-BHARTHI9573@YBL-S BIN0020701-510175419494-UPI,0000510175419494,0.0,6000.0,282.23
11/04/25,UPI,UPI-DAFTARDAR ANAND-7731898619@AXL-HDFC0 000545-208643008747-PAYMENT FROM PHONE,0000208643008747,7680.0,0.0,7962.23
11/04/25,UPI,UPI-SYED FAREEDUDDIN-SYEDFAREED29-4@OKIC ICI-UBIN0812820-510113731754-UPI,0000510113731754,11305.0,0.0,19267.23
11/04/25,UPI,UPI-GOWRA VEERA SHETTY-9177223851@YBL-S BIN0040981-489101144212-PAYMENT FROM PHO NE,0000489101144212,400.0,0.0,19667.23
11/04/25,UPI,UPI-NUTAN MEDICAL HALL-7337557229@OKBIZA XIS-UTIB0000553-510151548114-UPI,0000510151548114,0.0,151.0,19516.23
11/04/25,UPI,UPI-BBASAVARAJ NLAXMAIAH-Q406529394@YBL- YESB0YBLUPI-510119440328-UPI,0000510119440328,0.0,250.0,19266.23
11/04/25,UPI,UPI-MR RAVI TEJA POTHAR-RAVITEJAYADAV95 28@OKHDFCBANK-CBIN0280808-510153160084-U PI,0000510153160084,0.0,1000.0,18266.23
11/04/25,UPI,UPI-VADICHERLA PRADEEP K-9293555325@AXL- UBIN0800619-429361797772-PAYMENT FROM PH ONE,0000429361797772,0.0,1000.0,17266.23
11/04/25,UPI,UPI-JURRU RAHUL YADAV-9963019626@YBL-SB IN0007641-572688618897-PAYMENT FROM PHON E,0000572688618897,0.0,300.0,16966.23
11/04/25,UPI,UPI-MOHD PASHA MIYA-8074523914@YBL-LAVB0 000572-885262002699-PAYMENT FROM PHONE,0000885262002699,0.0,600.0,16366.23
11/04/25,UPI,UPI-JIO RECHARGE-JIOINAPPDIRECT@YBL-YESB 0YBLUPI-826499000819-PAYMENT FROM PHONE,0000826499000819,0.0,29.0,16337.23
11/04/25,UPI,UPI-KOLLAPURAM MALLIKARJ-MALLIKARJUNKOLA PURAM@OKSBI-HDFC0000218-510173886696-UPI,0000510173886696,0.0,200.0,16137.23
11/04/25,UPI,UPI-LIBERTYSRIHARIOKICIC-LIBERTYSRIHARI@ OKICICI-BKID0008627-510125974790-UPI,0000510125974790,0.0,1300.0,14837.23
11/04/25,NEFT,NEFT CR-ICIC0099999-ANGEL ONE LIMITED-MU KKERLA MADHU YADAV-ICICN220250411134576,ICICN22025041113,70000.0,0.0,84837.23
11/04/25,UPI,UPI-MRS CHANCHAL KUMARI-Q786777201@YBL- YESB0YBLUPI-510113980624-UPI,0000510113980624,0.0,40.0,84797.23
11/04/25,UPI,UPI-ANGEL LTD NSE-ANGELONENSE@HDFCBANK-H DFC0MERUPI-510158280424-PAYINGANGELONE,0000510158280424,0.0,12700.0,72097.23
12/04/25,UPI,UPI-M ANIL YADAV-ANILYADAV63473-1@OKSBI- UBIN0803219-510228279175-UPI,0000510228279175,0.0,7500.0,64597.23
12/04/25,UPI,UPI-M ANIL YADAV-ANILYADAV63473-1@OKSBI- UBIN0803219-510295893213-UPI,0000510295893213,0.0,6000.0,58597.23
12/04/25,UPI,UPI-M ANIL YADAV-ANILYADAV63473-1@OKSBI- UBIN0803219-510233387796-UPI,0000510233387796,0.0,7000.0,51597.23
12/04/25,UPI,UPI-SRI BALAJI BAKERY-PAYTMQR66O95U@PTYS -YESB0PTMUPI-510209385588-UPI,0000510209385588,0.0,50.0,51547.23
12/04/25,UPI,UPI-VOLIGE SRIKANTH-VOLIGESRIKANTH@OKSB I-IOBA0002397-546839803433-UPI,0000546839803433,0.0,1350.0,50197.23
12/04/25,UPI,UPI-B SUMAN GOUD-9553484848@AXL-KKBK000 7451-420790195407-PAYMENT FROM PHONE,0000420790195407,0.0,6000.0,44197.23
12/04/25,UPI,UPI-MR MUDDHE GANGADHAR-GANGADHARMUDDHE@ AXL-SCBL0036046-909328635267-PAYMENT FRO M PHONE,0000909328635267,12000.0,0.0,56197.23
12/04/25,UPI,UPI-G PRASHANTH-PRASHANTH.GHANKOT07@OKIC ICI-UTIB0000881-383938018363-PAYMENT FRO M PHONE,0000383938018363,0.0,20000.0,36197.23
12/04/25,UPI,UPI-B VINOD KUMAR-BALERAOVINOD077@OKSBI- CNRB0000033-510285897746-UPI,0000510285897746,0.0,3000.0,33197.23
12/04/25,,ATW-416021XXXXXX2657-P3ENTS55-HYDERABAD,0000000000006391,0.0,8000.0,25197.23
12/04/25,UPI,UPI-SANTOSH-PAYTM.S19IMBH@PTY-YESB0MCHUP I-546859645726-UPI,0000546859645726,0.0,15.0,25182.23
12/04/25,UPI,UPI-KHAN BABU-KHANBABU78001@AXL-ICIC0001 015-354124864166-PAYMENT FROM PHONE,0000354124864166,0.0,5000.0,20182.23
12/04/25,UPI,UPI-JIO RECHARGE-JIOINAPPDIRECT1@AXL-UTI B0AXLUPI-920079330547-PAYMENT FROM PHONE,0000920079330547,0.0,29.0,20153.23
12/04/25,UPI,UPI-JURRU RAHUL YADAV-9963019626@YBL-SB IN0007641-732654039299-PAYMENT FROM PHON E,0000732654039299,0.0,300.0,19853.23
12/04/25,UPI,UPI-KARRA SATHISH-9293555325-7@AXL-BKID0 005707-100566312338-PAYMENT FROM PHONE,0000100566312338,0.0,1000.0,18853.23
12/04/25,UPI,UPI-LIBERTYSRIHARIOKICIC-LIBERTYSRIHARI@ OKICICI-BKID0008627-546833559545-UPI,0000546833559545,0.0,1300.0,17553.23
13/04/25,UPI,UPI-MUDDE GAYATHRI-9550147698@AXL-SBIN0 020650-274794154435-PAYMENT FROM PHONE,0000274794154435,1240.0,0.0,18793.23
13/04/25,UPI,UPI-MUKKERLA GEETA SUDHA-GEETHAMUKKERLA- 1@OKAXIS-KKBK0007463-510324834841-UPI,0000510324834841,1900.0,0.0,20693.23
13/04/25,UPI,UPI-SHAIK HABEEBUDDIN-7989814974@YESCRED -ICIC0000558-510331091217-FIRST AND SECO ND M,0000510331091217,7450.0,0.0,28143.23
13/04/25,UPI,UPI-SHAIK AYESHA SIDDIQ-7989814974@AXIS B-SBIN0012917-546975235290-PAID VIA CRED,0000546975235290,3625.0,0.0,31768.23
13/04/25,UPI,UPI-NADIMANE RESTAURANT-Q478981379@YBL-Y ESB0YBLUPI-546914786737-UPI,0000546914786737,0.0,650.0,31118.23
13/04/25,UPI,UPI-SHEELAM SAI KUMAR-JABILI.SAIKUMAR@OK AXIS-HDFC0009095-510362752569-UPI,0000510362752569,15105.0,0.0,46223.23
13/04/25,UPI,UPI-MARGAM AKSHAY KUMAR-AKSHAYMARGAM111 @OKSBI-SBIN0021100-510346708393-UPI,0000510346708393,0.0,2000.0,44223.23
13/04/25,UPI,UPI-NAGRAJ-MUKKERLANAGRAJ@OKAXIS-UBIN080 3219-510337909920-UPI,0000510337909920,0.0,360.0,43863.23
13/04/25,UPI,UPI-MOHD PASHA MIYA-8074523914@YBL-LAVB0 000572-248807020286-PAYMENT FROM PHONE,0000248807020286,0.0,600.0,43263.23
13/04/25,UPI,UPI-MR BHAIRAVA SRIKANTH-9293555325-5@YB L-CBIN0284811-265316886010-PAYMENT FROM PHONE,0000265316886010,0.0,1000.0,42263.23
13/04/25,UPI,UPI-JURRU RAHUL YADAV-9963019626@YBL-SB IN0007641-470268916026-PAYMENT FROM PHON E,0000470268916026,0.0,300.0,41963.23
13/04/25,UPI,UPI-LIBERTYSRIHARIOKICIC-LIBERTYSRIHARI@ OKICICI-BKID0008627-510360013675-UPI,0000510360013675,0.0,1300.0,40663.23
13/04/25,UPI,UPI-MALKAJGIRI SUJATHA-9000531649@AXL-PU NB0159700-579095251959-PAYMENT FROM PHON E,0000579095251959,1.0,0.0,40664.23
14/04/25,UPI,UPI-BHARKATHPURA-BHARKATHPURA.60983458@H DFCBANK-HDFC0MERUPI-510484542655-UPI,0000510484542655,0.0,114.0,40550.23
14/04/25,UPI,UPI-MAADEVI-Q552508687@YBL-YESB0YBLUPI-5 10411049418-UPI,0000510411049418,0.0,200.0,40350.23
14/04/25,UPI,UPI-M ANIL YADAV-ANILYADAV63473-1@OKSBI- UBIN0803219-510441056240-UPI,0000510441056240,0.0,1000.0,39350.23
14/04/25,UPI,UPI-SRI SAI RESTAURANT A-PAYTM-80659624@ PTYS-YESB0PTMUPI-510468855038-UPI,0000510468855038,0.0,335.0,39015.23
14/04/25,UPI,UPI-SRI SAI RESTAURANT A-PAYTM-80610737@ PTYS-YESB0PTMUPI-510488353088-UPI,0000510488353088,0.0,26.0,38989.23
14/04/25,UPI,UPI-TALASANI SANTOSH YA-9182342214@AXL- SBIN0020256-300647435014-PAYMENT FROM PH ONE,0000300647435014,8550.0,0.0,47539.23
14/04/25,UPI,UPI-RAFI AHMED KHAN-PAYTM.S1AR3QF@PTY-YE SB0MCHUPI-510468969485-UPI,0000510468969485,0.0,35.0,47504.23
14/04/25,UPI,UPI-MOHAMMED IRFAN-GPAY-11257026077@OKBI ZAXIS-UTIB0000553-510451369016-UPI,0000510451369016,0.0,50.0,47454.23
14/04/25,UPI,UPI-VARSHA YADAV VALLALA-7416131313@YBL- ICIC0000075-344997030183-PAYMENT FROM PH ONE,0000344997030183,22500.0,0.0,69954.23
14/04/25,UPI,UPI-B BHARATHI-Q594782917@YBL-YESB0YBLU PI-510499369845-UPI,0000510499369845,0.0,10.0,69944.23
14/04/25,UPI,UPI-HP PETROL PUMP PETR-Q139482159@YBL- YESB0YBLUPI-510438570689-UPI,0000510438570689,0.0,250.0,69694.23
14/04/25,UPI,UPI-JIO RECHARGE-JIOINAPPDIRECT@YBL-YESB 0YBLUPI-687318832892-PAYMENT FROM PHONE,0000687318832892,0.0,302.0,69392.23
14/04/25,UPI,UPI-MR RAVI TEJA POTHAR-RAVITEJAYADAV95 28@OKHDFCBANK-CBIN0280808-510418584527-U PI,0000510418584527,0.0,800.0,68592.23
14/04/25,UPI,UPI-GURRAM VARALAKSHMI-9908898266@AXL-S BIN0003608-574199411704-PAYMENT FROM PHO NE,0000574199411704,7680.0,0.0,76272.23
14/04/25,UPI,UPI-KHAN BABU-KHANBABU78001@AXL-ICIC0001 015-214343770668-PAYMENT FROM PHONE,0000214343770668,0.0,2000.0,74272.23
14/04/25,NEFT,"NEFT DR-KKBK0007463-M MADHU YADAV-NETBAN K, MUM-HDFCN52025041478841064-CASH",HDFCN52025041478,0.0,10000.0,64272.23
14/04/25,UPI,UPI-ZERODHA BROKING LTD-ZERODHABROKING@H DFCBANK-HDFC0MERUPI-547078312649-6464174 880680618 Z,0000547078312649,0.0,20500.0,43772.23
14/04/25,UPI,UPI-ANGEL LTD NSE-ANGELONENSE@HDFCBANK-H DFC0MERUPI-547096900623-PAYINGANGELONE,0000547096900623,0.0,10000.0,33772.23
14/04/25,UPI,UPI-ANGEL LTD NSE-ANGELONENSE@HDFCBANK-H DFC0MERUPI-510494495653-PAYINGANGELONE,0000510494495653,0.0,2000.0,31772.23
15/04/25,UPI,UPI-MUKKERLA GEETA SUDHA-GEETHAMUKKERLA- 1@OKAXIS-KKBK0007463-547198912276-UPI,0000547198912276,0.0,13000.0,18772.23
15/04/25,UPI,UPI-ANGEL LTD NSE-ANGELONENSE@HDFCBANK-H DFC0MERUPI-547188109226-PAYINGANGELONE,0000547188109226,0.0,10000.0,8772.23
15/04/25,,ACH D- LIC OF INDIA-6577926590425,0000008279263105,0.0,2488.0,6284.23
15/04/25,UPI,UPI-PENUG-Q379847902@YBL-YESB0YBLUPI-547 157003852-UPI,0000547157003852,0.0,150.0,6134.23
15/04/25,UPI,UPI-MOHD PASHA MIYA-8074523914@YBL-LAVB0 000572-871576035142-PAYMENT FROM PHONE,0000871576035142,0.0,600.0,5534.23
15/04/25,IMPS,IMPS-510519309278-M MADHU YADAV-KKBK-XXX XXX7813-CASH,0000510519309278,0.0,2600.0,2934.23
15/04/25,UPI,UPI-CHINTALA SRINIVAS Y-9989394957@AXL- SBIN0020812-611175813235-PAYMENT FROM PH ONE,0000611175813235,9975.0,0.0,12909.23
15/04/25,UPI,UPI-SRINU MOTHRAPU-SRINUMOTHRAPU08-1@OK AXIS-SBIN0020256-510526133781-UPI,0000510526133781,9975.0,0.0,22884.23
16/04/25,UPI,UPI-MR RAVI TEJA POTHAR-RAVITEJAYADAV95 28@OKHDFCBANK-CBIN0280808-510684918597-U PI,0000510684918597,0.0,2000.0,20884.23
16/04/25,UPI,UPI-M ARVIND-ARVINDYADAV69552@OKAXIS-K KBK0007473-510631414631-UPI,0000510631414631,0.0,800.0,20084.23
16/04/25,UPI,UPI-JIO RECHARGE-JIOINAPPDIRECT1@AXL-UTI B0AXLUPI-246385631777-PAYMENT FROM PHONE,0000246385631777,0.0,19.0,20065.23
16/04/25,IMPS,IMPS-510619335897-M MADHU YADAV-KKBK-XXX XXX7813-CASH,0000510619335897,0.0,3000.0,17065.23
16/04/25,NEFT,NEFT CR-ICIC0099999-ANGEL ONE LIMITED-MU KKERLA MADHU YADAV-ICICN220250416169451,ICICN22025041616,13000.0,0.0,30065.23
16/04/25,IMPS,IMPS-510620357155-M MADHU YADAV-KKBK-XXX XXX7813-CASH,0000510620357155,0.0,13000.0,17065.23
17/04/25,UPI,UPI-M ARVIND-ARVINDYADAV69552@OKAXIS-K KBK0007473-510700237350-UPI,0000510700237350,0.0,100.0,16965.23
17/04/25,UPI,UPI-KOLLAPURAM MALLIKARJ-MALLIKARJUNKOLA PURAM@OKSBI-HDFC0000218-510793950394-UPI,0000510793950394,0.0,100.0,16865.23
17/04/25,UPI,UPI-RAPARTI SRIHARI-LIBERTYSRIHARI@OKICI CI-BKID0008627-248327084020-PAYMENT FROM PHONE,0000248327084020,0.0,13000.0,3865.23
17/04/25,IMPS,IMPS-510718330483-M MADHU YADAV-KKBK-XXX XXX7813-CASH,0000510718330483,0.0,3000.0,865.23
17/04/25,NEFT,NEFT CR-ICIC0099999-ANGEL ONE LIMITED-MU KKERLA MADHU YADAV-ICICN220250417178558,ICICN22025041717,18000.0,0.0,18865.23
18/04/25,UPI,UPI-JURRU RAHUL YADAV-Q758292524@YBL-YE SB0YBLUPI-547462824904-UPI,0000547462824904,0.0,40.0,18825.23
18/04/25,UPI,UPI-NARLA SRIKANTH YADA-Q470718822@YBL- YESB0YBLUPI-547423314744-UPI,0000547423314744,0.0,35.0,18790.23
18/04/25,UPI,UPI-BHARATHI BHARATHI-BHARTHI9573@YBL-S BIN0020701-547425809874-UPI,0000547425809874,0.0,6000.0,12790.23
18/04/25,UPI,UPI-M PRABHAKAR-Q435661641@YBL-YESB0YBLU PI-547445836391-UPI,0000547445836391,0.0,150.0,12640.23
18/04/25,UPI,UPI-PANUGOTHU RAVINAIK-PANUGOTHUNAIK2@Y BL-SBIN0005895-547410136364-UPI,0000547410136364,0.0,760.0,11880.23
18/04/25,UPI,UPI-SOMALWAR SHRINIVAS-SOMALWAR73@OKSBI -SBIN0010356-510839096253-UPI,0000510839096253,2160.0,0.0,14040.23
18/04/25,UPI,UPI-VADICHARLA LAVANYA-9293555325-2@YBL- UTIB0003574-457241593030-PAYMENT FROM PH ONE,0000457241593030,0.0,1000.0,13040.23
18/04/25,UPI,UPI-JURRU RAHUL YADAV-9963019626@YBL-SB IN0007641-227892173399-PAYMENT FROM PHON E,0000227892173399,0.0,300.0,12740.23
19/04/25,UPI,UPI-LIBERTYSRIHARIOKICIC-LIBERTYSRIHARI@ OKICICI-BKID0008627-547543680972-UPI,0000547543680972,0.0,1300.0,11440.23
19/04/25,UPI,UPI-M ANIL YADAV-ANILYADAV63473-1@OKSBI- UBIN0803219-547569067054-UPI,0000547569067054,0.0,600.0,10840.23
19/04/25,UPI,UPI-MWYN TECH PRIVATE LI-MWYNTECHPRIVATE 893267.RZP@RXAIRTEL-AIRP0000011-54756356 7222-MWYNTECHPRIVATELIM,0000547563567222,0.0,1163.02,9677.21
19/04/25,IMPS,IMPS-510925127560-TAPSTART CAPITAL PVT L TD-RATN-XXXXXXXX6589-WITHDRAWAL,0000510925127560,3594.05,0.0,13271.26
19/04/25,UPI,UPI-PSATISH-ADARSH.PRINTERS999@OKHDFCBAN K-PUNB0362800-547504892723-UPI,0000547504892723,0.0,3000.0,10271.26
19/04/25,UPI,UPI-B VINOD KUMAR-BALERAOVINOD077@OKSBI- CNRB0000033-547562378352-UPI,0000547562378352,0.0,3000.0,7271.26
19/04/25,UPI,UPI-MR MARYPEDDY YADAIAH-PAYTMQR1QEBB0LQ 0U@PAYTM-YESB0PTMUPI-547513269446-UPI,0000547513269446,0.0,55.0,7216.26
19/04/25,UPI,UPI-PENUG-Q379847902@YBL-YESB0YBLUPI-547 599690585-UPI,0000547599690585,0.0,150.0,7066.26
19/04/25,UPI,UPI-MR DIGLESHA VINODKU-Q361656464@YBL- YESB0YBLUPI-510954803218-UPI,0000510954803218,0.0,139.0,6927.26
19/04/25,UPI,UPI-MOHD PASHA MIYA-8074523914@YBL-LAVB0 000572-107005499684-PAYMENT FROM PHONE,0000107005499684,0.0,600.0,6327.26
19/04/25,UPI,UPI-VADICHARLA LAVANYA-9293555325-2@YBL- UTIB0003574-868524533997-PAYMENT FROM PH ONE,0000868524533997,0.0,1000.0,5327.26
19/04/25,UPI,UPI-JURRU RAHUL YADAV-9963019626@YBL-SB IN0007641-014985823723-PAYMENT FROM PHON E,0000014985823723,0.0,300.0,5027.26
19/04/25,UPI,UPI-LIBERTYSRIHARIOKICIC-LIBERTYSRIHARI@ OKICICI-BKID0008627-510920325080-UPI,0000510920325080,0.0,1300.0,3727.26
19/04/25,POS,CASH DEPOSIT-XXXXXXXXXX1847-BARKATPURA,0000000000006698,2700.0,0.0,6427.26
19/04/25,UPI,UPI-M MADHU YADAV-9985065404-2@AXL-SBIN 0006645-856830291550-PAYMENT FROM PHONE,0000856830291550,4900.0,0.0,11327.26
19/04/25,UPI,UPI-BAKKA NAGESH-BAKKANAGESH1983@OKHDFCB ANK-BKID0008603-103449684680-LED BOARD,0000103449684680,2160.0,0.0,13487.26
20/04/25,UPI,UPI-CHITRA APPLARAJU-GPAY-11256411307@OK BIZAXIS-UTIB0000553-511010745850-UPI,0000511010745850,0.0,130.0,13357.26
20/04/25,UPI,UPI-VINODKUMAR TERALA-PAYTMQR6129OH@PTY S-YESB0PTMUPI-511030551478-UPI,0000511030551478,0.0,50.0,13307.26
20/04/25,UPI,UPI-PANYAM MANJULA-MANJUPANYAM@OKSBI-SB IN0007641-511004061826-UPI,0000511004061826,2000.0,0.0,15307.26
20/04/25,UPI,UPI-AZAAD KHAN-AZAADKHAN2280@OKSBI-SBIN 0020083-511038263236-UPI,0000511038263236,0.0,15000.0,307.26
20/04/25,UPI,UPI-RONAK NEELESH RUPARA-KUMARRONAK7@OKA XIS-HDFC0000545-547654641784-UPI,0000547654641784,1000.0,0.0,1307.26
20/04/25,POS,CASH DEPOSIT-416021XXXXXX2657-BARKATPURA,0000000000006799,5100.0,0.0,6407.26
20/04/25,UPI,UPI-MR TANUSH SONTE-8978155654@YBL-MAHB 0000565-757558725453-PAYMENT FROM PHONE,0000757558725453,2000.0,0.0,8407.26
20/04/25,UPI,UPI-MADHU SUDHAN GHODKE-MADHUSUDHANGHOD KE@AXL-SBIN0005895-169348554602-PAYMENT FROM PHONE,0000169348554602,2000.0,0.0,10407.26
20/04/25,UPI,UPI-AZAAD KHAN-AZAADKHAN2280@OKSBI-SBIN 0020083-511025448109-UPI,0000511025448109,0.0,10000.0,407.26
20/04/25,UPI,UPI-MOHD AHMED ALI-AQUA.AHMED98@AXL-UTIB 0001808-960826997571-PAYMENT FROM PHONE,0000960826997571,90.0,0.0,497.26
20/04/25,UPI,UPI-MOHD AHMED ALI-AQUA.AHMED98@AXL-UTIB 0001808-970669425038-PAYMENT FROM PHONE,0000970669425038,1500.0,0.0,1997.26
20/04/25,UPI,UPI-MAHAVIR SETHI-9392489604@YBL-SBIN00 05895-445277066619-PAYMENT FROM PHONE,0000445277066619,2000.0,0.0,3997.26
20/04/25,UPI,UPI-KEERTHI NEELI-SAI.TAANYA26@OKAXIS-BA RB0BARKAT-547681974667-UPI,0000547681974667,1000.0,0.0,4997.26
20/04/25,UPI,UPI-P VINOD KUMAR-Q801724639@YBL-YESB0YB LUPI-511065390221-UPI,0000511065390221,0.0,450.0,4547.26
20/04/25,UPI,UPI-VADICHERLA PRADEEP K-9293555325@AXL- UBIN0800619-224794909767-PAYMENT FROM PH ONE,0000224794909767,0.0,1000.0,3547.26
20/04/25,UPI,UPI-JURRU RAHUL YADAV-9963019626@YBL-SB IN0007641-449117356749-PAYMENT FROM PHON E,0000449117356749,0.0,300.0,3247.26
20/04/25,UPI,UPI-MR DIGLESHA VINODKU-Q361656464@YBL- YESB0YBLUPI-547669901602-UPI,0000547669901602,0.0,170.0,3077.26
20/04/25,UPI,UPI-LIBERTYSRIHARIOKICIC-LIBERTYSRIHARI@ OKICICI-BKID0008627-547673006909-UPI,0000547673006909,0.0,1300.0,1777.26
21/04/25,UPI,UPI-SHRAVAN REDDY KURAKU-SHRAVANREDDYR91 @OKAXIS-UBIN0803219-547732016257-UPI,0000547732016257,0.0,200.0,1577.26
21/04/25,UPI,UPI-TIRIVISETTY SATYANAR-Q628175389@YBL- YESB0YBLUPI-547751807267-UPI,0000547751807267,0.0,30.0,1547.26
21/04/25,UPI,UPI-P NAND KISHOR-BHARATPE.90069295183@F BPE-FDRL0001382-547732419852-PAY TO BHAR ATPE ME,0000547732419852,0.0,50.0,1497.26
21/04/25,UPI,UPI-AMIT CHARAN-PAYTMQR6EW4Z5@PTYS-YESB0 PTMUPI-547706824502-UPI,0000547706824502,0.0,20.0,1477.26
21/04/25,UPI,UPI-MOHAMMED IBRAHIM-BHARATPE90727407781 @YESBANKLTD-YESB0YESUPI-547797430626-PAY TO BHARATPE ME,0000547797430626,0.0,300.0,1177.26
21/04/25,UPI,UPI-ABSIPURAM PRASOONA-9948434877@YBL-S BIN0020083-155819490862-PAYMENT FROM PHO NE,0000155819490862,2000.0,0.0,3177.26
21/04/25,UPI,UPI-MADHU SUDHAN GHODKE-MADHUSUDHANGHOD KE@YBL-SBIN0005895-091033314460-PAYMENT FROM PHONE,0000091033314460,0.0,2000.0,1177.26
21/04/25,,ANGEL ONE LIMI-W24A1568UQM15F,0000504212659263,6200.0,0.0,7377.26
21/04/25,UPI,UPI-MOHD PASHA MIYA-8074523914@YBL-LAVB0 000572-252195578890-PAYMENT FROM PHONE,0000252195578890,0.0,600.0,6777.26
21/04/25,UPI,UPI-MOHD AHMED ALI-AQUA.AHMED98@AXL-UTIB 0001808-854851424070-PAYMENT FROM PHONE,0000854851424070,90.0,0.0,6867.26
21/04/25,UPI,UPI-MR RAVI TEJA POTHAR-RAVITEJAYADAV95 28@OKHDFCBANK-CBIN0280808-547719852638-U PI,0000547719852638,0.0,500.0,6367.26
21/04/25,UPI,UPI-M MADHU YADAV-9985065404-2@YBL-SBIN 0006645-695415008503-PAYMENT FROM PHONE,0000695415008503,80000.0,0.0,86367.26
21/04/25,POS,CASH DEPOSIT-XXXXXXXXXX1847-BARKATPURA,0000000000007104,22000.0,0.0,108367.26
21/04/25,POS,CASH DEPOSIT-XXXXXXXXXX1847-BARKATPURA,0000000000007107,23500.0,0.0,131867.26
21/04/25,POS,CASH DEPOSIT-XXXXXXXXXX1847-BARKATPURA,0000000000007110,23500.0,0.0,155367.26
21/04/25,UPI,UPI-JIO RECHARGE-JIOINAPPDIRECT1@AXL-UTI B0AXLUPI-790215692907-PAYMENT FROM PHONE,0000790215692907,0.0,19.0,155348.26
21/04/25,UPI,UPI-JIO RECHARGE-JIOINAPPDIRECT1@AXL-UTI B0AXLUPI-773570535184-PAYMENT FROM PHONE,0000773570535184,0.0,19.0,155329.26
21/04/25,IMPS,IMPS-511121305717-SRIDEVI JT1-ICIC-XXXXX XXX3198-CASH,0000511121305717,0.0,14000.0,141329.26
21/04/25,UPI,UPI-PHONEPE-BBPSBP@YBL-YESB0YBLUPI-17267 5327185-PAYMENT FROM PHONE,0000172675327185,0.0,35947.97,105381.29
21/04/25,UPI,UPI-ANGEL LTD NSE-ANGELONENSE@HDFCBANK-H DFC0MERUPI-547784774180-PAYINGANGELONE,0000547784774180,0.0,45000.0,60381.29
21/04/25,UPI,UPI-ZERODHA BROKING LTD-ZERODHABROKING@H DFCBANK-HDFC0MERUPI-547739370297-8693776 426009721 Z,0000547739370297,0.0,40000.0,20381.29
21/04/25,UPI,UPI-M ANIL YADAV-ANILYADAV63473-1@OKSBI- UBIN0803219-547728748985-UPI,0000547728748985,0.0,2500.0,17881.29
22/04/25,UPI,UPI-PHONEPE-BBPSBP@YBL-YESB0YBLUPI-47738 1415373-PAYMENT FROM PHONE,0000477381415373,0.0,905.0,16976.29
22/04/25,UPI,UPI-ANGEL LTD NSE-ANGELONENSE@HDFCBANK-H DFC0MERUPI-547859278990-PAYINGANGELONE,0000547859278990,0.0,5000.0,11976.29
22/04/25,UPI,UPI-ANGEL LTD NSE-ANGELONENSE@HDFCBANK-H DFC0MERUPI-547841982547-PAYINGANGELONE,0000547841982547,0.0,10000.0,1976.29
22/04/25,UPI,UPI-PENUG-Q379847902@YBL-YESB0YBLUPI-547 802779965-UPI,0000547802779965,0.0,150.0,1826.29
22/04/25,UPI,UPI-MUKKAMI ANAND-ANAND.MUKKAMI-1@OKSBI -SBIN0000952-511231330879-FLAT 403 SREE KRIS,0000511231330879,920.0,0.0,2746.29
22/04/25,UPI,UPI-M D AKBAR-Q975391006@YBL-YESB0YBLUPI -511233111009-UPI,0000511233111009,0.0,20.0,2726.29
22/04/25,UPI,UPI-MR RAVI TEJA POTHAR-RAVITEJAYADAV95 28@OKHDFCBANK-CBIN0280808-511298912815-U PI,0000511298912815,0.0,2000.0,726.29
22/04/25,UPI,UPI-A PAVANI YADAV-PAVANIYADAU39406@OKH DFCBANK-SBIN0020068-103606475192-UPI,0000103606475192,1500.0,0.0,2226.29
22/04/25,UPI,UPI-VADICHERLA PRADEEP K-9293555325@AXL- UBIN0800619-160418909988-PAYMENT FROM PH ONE,0000160418909988,0.0,1000.0,1226.29
22/04/25,UPI,UPI-M MADHU YADAV-9985065404-2@AXL-SBIN 0006645-237981529703-PAYMENT FROM PHONE,0000237981529703,200.0,0.0,1426.29
22/04/25,UPI,UPI-LIBERTYSRIHARIOKICIC-LIBERTYSRIHARI@ OKICICI-BKID0008627-511246419439-UPI,0000511246419439,0.0,1300.0,126.29
22/04/25,UPI,UPI-JIO RECHARGE-JIOINAPPDIRECT@AXL-UTIB 0AXLUPI-251292857411-PAYMENT FROM PHONE,0000251292857411,0.0,19.0,107.29
22/04/25,UPI,UPI-JIO RECHARGE-JIOINAPPDIRECT1@AXL-UTI B0AXLUPI-210794218321-PAYMENT FROM PHONE,0000210794218321,0.0,19.0,88.29
23/04/25,UPI,UPI-RITHIK MITTAL-RITHIKMITTAL2606-1@OKH DFCBANK-HDFC0000081-103622965457-UPI,0000103622965457,375.0,0.0,463.29
23/04/25,UPI,UPI-MAADEVI-Q122247139@YBL-YESB0YBLUPI-5 11304850620-UPI,0000511304850620,0.0,200.0,263.29
23/04/25,POS,CASH DEPOSIT-416021XXXXXX2657-BARKATPURA,0000000000007348,24000.0,0.0,24263.29
23/04/25,UPI,UPI-MAHENDRA JALA-JALAMAHENDRA@OKAXIS-K KBK0007466-511330333073-UPI,0000511330333073,0.0,20000.0,4263.29
23/04/25,UPI,UPI-GANTA SUJATHA-SUJATHAGANAT13@OKSBI- SBIN0005895-511350036106-UPI,0000511350036106,1050.0,0.0,5313.29
23/04/25,UPI,UPI-M MADHU YADAV-9985065404-2@YBL-SBIN 0006645-317966309407-PAYMENT FROM PHONE,0000317966309407,3500.0,0.0,8813.29
23/04/25,UPI,UPI-MADHURI MARAM-LIPIKAMARAM@OKICICI-IC IC0000008-511393260462-UPI,0000511393260462,2000.0,0.0,10813.29
23/04/25,UPI,UPI-RAPARTI SRIHARI-LIBERTYSRIHARI@OKICI CI-BKID0008627-699924945617-PAYMENT FROM PHONE,0000699924945617,0.0,10000.0,813.29
23/04/25,UPI,UPI-MOHAMMED SAYEED AHME-Q953113184@YBL- YESB0YBLUPI-511376068540-UPI,0000511376068540,0.0,20.0,793.29
23/04/25,UPI,UPI-JURRU RAHUL YADAV-Q758292524@YBL-YE SB0YBLUPI-511332580803-UPI,0000511332580803,0.0,120.0,673.29
23/04/25,UPI,UPI-MR RAVI TEJA POTHAR-RAVITEJAYADAV95 28@OKHDFCBANK-CBIN0280808-511310877582-U PI,0000511310877582,0.0,600.0,73.29
23/04/25,NEFT,NEFT CR-ICIC0099999-ANGEL ONE LIMITED-MU KKERLA MADHU YADAV-ICICN220250423221823,ICICN22025042322,4000.0,0.0,4073.29
23/04/25,UPI,UPI-VADICHARLA LAVANYA-9293555325-2@YBL- UTIB0003574-024747871786-PAYMENT FROM PH ONE,0000024747871786,0.0,1000.0,3073.29
24/04/25,UPI,UPI-LIBERTYSRIHARIOKICIC-LIBERTYSRIHARI@ OKICICI-BKID0008627-548031102224-UPI,0000548031102224,0.0,1300.0,1773.29
24/04/25,UPI,UPI-CHITRA APPLARAJU-GPAY-11256411307@OK BIZAXIS-UTIB0000553-548049809771-UPI,0000548049809771,0.0,130.0,1643.29
24/04/25,UPI,UPI-CHITRA APPLARAJU-GPAY-11256411307@OK BIZAXIS-UTIB0000553-548054909308-UPI,0000548054909308,0.0,130.0,1513.29
24/04/25,UPI,UPI-J SHIVANARAYANA-BHARATPE90726407443@ YESBANKLTD-YESB0YESUPI-548019216090-PAY TO J SHIVANARA,0000548019216090,0.0,50.0,1463.29
24/04/25,UPI,UPI-ZERODHA BROKING LTD-ZERODHABROKING@H DFCBANK-HDFC0MERUPI-548025611220-7676541 555336352 Z,0000548025611220,0.0,1400.0,63.29
24/04/25,IMPS,IMPS-511411514862-MUTHOOTFINCORPLTD-UTIB -XXXXXXXXXXX2057-TREASURYDISBURSAL,0000511411514862,40665.0,0.0,40728.29
24/04/25,UPI,UPI-K VINOD KUMAR-9010163038-2@YBL-SBIN0 020199-580639762202-PAYMENT FROM PHONE,0000580639762202,0.0,400.0,40328.29
24/04/25,UPI,UPI-MARGAM VANI-9392657723@YBL-SBIN0021 100-989667762483-PAYMENT FROM PHONE,0000989667762483,0.0,40000.0,328.29
24/04/25,UPI,UPI-GANGARAM COOL DRINK -PAYTMQR6EVYQS@P TYS-YESB0PTMUPI-548065521176-UPI,0000548065521176,0.0,6.0,322.29
24/04/25,UPI,UPI-DUDIKIKAR SHAILAJA-8367261624@AXL- KKBK0007472-974257147347-PAYMENT FROM PH ONE,0000974257147347,600.0,0.0,922.29
24/04/25,UPI,UPI-M MADHU YADAV-9985065404-2@YBL-SBIN 0006645-057380245742-PAYMENT FROM PHONE,0000057380245742,28000.0,0.0,28922.29
24/04/25,UPI,UPI-VEMURI RADHA KRISHNA-RADHAKRISHNA781 60@OKAXIS-ANDB0000076-511485438098-UPI,0000511485438098,1500.0,0.0,30422.29
24/04/25,IMPS,IMPS-511419388366-M MADHU YADAV-KKBK-XXX XXX7813-CASH,0000511419388366,0.0,30000.0,422.29
24/04/25,UPI,UPI-MOHD AHMED ALI-AQUA.AHMED98@AXL-UTIB 0001808-505694765909-PAYMENT FROM PHONE,0000505694765909,270.0,0.0,692.29
24/04/25,UPI,UPI-JURRU RAHUL YADAV-9963019626@YBL-SB IN0007641-404692591453-PAYMENT FROM PHON E,0000404692591453,11800.0,0.0,12492.29
24/04/25,IMPS,IMPS-511420301597-M MADHU YADAV-KKBK-XXX XXX7813-CASH,0000511420301597,0.0,2300.0,10192.29
24/04/25,NEFT,NEFT CR-ICIC0099999-ANGEL ONE LIMITED-MU KKERLA MADHU YADAV-ICICN220250424232458,ICICN22025042423,8000.0,0.0,18192.29
24/04/25,IMPS,IMPS-511421318936-M MADHU YADAV-KKBK-XXX XXX7813-CASH,0000511421318936,0.0,900.0,17292.29
25/04/25,NEFT,NEFT CR-YESB0000001-ZERODHA BROKING LTD- DSCNB A/C-MUKKERLA MADHU YADAV-YESBN1202,YESBN12025042500,5500.0,0.0,22792.29
25/04/25,UPI,UPI-MUNTHA RAMESH YADAV-RAMEESHM6666@YBL -BKID0008604-930535920301-PAYMENT FROM P HONE,0000930535920301,0.0,8000.0,14792.29
25/04/25,UPI,UPI-J SHIVANARAYANA-BHARATPE90726407443@ YESBANKLTD-YESB0YESUPI-548111685500-PAY TO J SHIVANARA,0000548111685500,0.0,50.0,14742.29
25/04/25,UPI,UPI-PIONEER COMMUNICATIO-Q248007101@YBL- YESB0YBLUPI-511501615555-UPI,0000511501615555,0.0,200.0,14542.29
25/04/25,UPI,UPI-MR RAVI TEJA POTHAR-RAVITEJAYADAV95 28@OKHDFCBANK-CBIN0280808-511595718823-U PI,0000511595718823,0.0,500.0,14042.29
25/04/25,NEFT,NEFT CR-ICIC0099999-ANGEL ONE LIMITED-MU KKERLA MADHU YADAV-ICICN220250425241481,ICICN22025042524,11000.0,0.0,25042.29
25/04/25,UPI,UPI-VADICHERLA PRADEEP K-9293555325@YBL- UBIN0800619-608891268984-PAYMENT FROM PH ONE,0000608891268984,0.0,1000.0,24042.29
25/04/25,UPI,UPI-LIBERTYSRIHARIOKICIC-LIBERTYSRIHARI@ OKICICI-BKID0008627-511569936332-UPI,0000511569936332,0.0,1300.0,22742.29
25/04/25,UPI,UPI-MADIGELA MUKESH-Q120657734@YBL-YESB 0YBLUPI-511569528460-UPI,0000511569528460,0.0,54.0,22688.29
26/04/25,NEFT,NEFT CR-YESB0000001-ZERODHA BROKING LTD- DSCNB A/C-MUKKERLA MADHU YADAV-YESBN1202,YESBN12025042600,10000.0,0.0,32688.29
26/04/25,UPI,UPI-JETTI PRASAD YADAV-VYAPAR.1721418654 99@HDFCBANK-HDFC0MERUPI-511649556297-UPI,0000511649556297,0.0,50.0,32638.29
26/04/25,UPI,UPI-PENUG-Q379847902@YBL-YESB0YBLUPI-511 635759521-UPI,0000511635759521,0.0,150.0,32488.29
26/04/25,UPI,UPI-GANTA SUJATHA-SUJATHAGANAT13@OKSBI- SBIN0005895-511640059124-UPI,0000511640059124,0.0,10000.0,22488.29
26/04/25,UPI,UPI-RAPARTI SRIHARI-LIBERTYSRIHARI@OKICI CI-BKID0008627-814016138741-PAYMENT FROM PHONE,0000814016138741,0.0,13000.0,9488.29
26/04/25,UPI,UPI-SANJAY SAGAR-8595942809@AXL-UTIB0003 156-077597854870-PAYMENT FROM PHONE,0000077597854870,1000.0,0.0,10488.29
26/04/25,UPI,UPI-SANJAY SAGAR-8595942809@AXL-UTIB0003 156-988961674309-PAYMENT FROM PHONE,0000988961674309,350.0,0.0,10838.29
26/04/25,UPI,UPI-KOLLAPURAM MALLIKARJ-MALLIKARJUNKOLA PURAM@OKSBI-HDFC0000218-548297502723-UPI,0000548297502723,0.0,200.0,10638.29
26/04/25,UPI,UPI-MADHU SUDHAN GHODKE-MADHUSUDHANGHOD KE@AXL-SBIN0005895-917491291269-PAYMENT FROM PHONE,0000917491291269,100.0,0.0,10738.29
26/04/25,UPI,UPI-VADICHERLA PRADEEP K-9293555325-3@YB L-HDFC0001635-952723452690-PAYMENT FROM PHONE,0000952723452690,0.0,1000.0,9738.29
26/04/25,IMPS,IMPS-511620337071-M MADHU YADAV-KKBK-XXX XXX7813-CASH,0000511620337071,0.0,1300.0,8438.29
27/04/25,UPI,UPI-TIRIVISETTY SATYANAR-Q628175389@YBL- YESB0YBLUPI-548374927418-UPI,0000548374927418,0.0,30.0,8408.29
27/04/25,UPI,UPI-RAKESH IOCL PRANEE-Q425873229@YBL- YESB0YBLUPI-548335509954-UPI,0000548335509954,0.0,350.0,8058.29
27/04/25,UPI,UPI-A LAXMI-Q655807646@YBL-YESB0YBLUPI-5 48369006917-UPI,0000548369006917,0.0,30.0,8028.29
27/04/25,UPI,UPI-JAI SANTHOSHI MATHA-GPAY-11250766748 @OKBIZAXIS-UTIB0000553-548374226908-UPI,0000548374226908,0.0,45.0,7983.29
27/04/25,UPI,UPI-KASULA VAMSI KRISHNA-PAYTM.S18LZG9@P TY-YESB0MCHUPI-548312619881-UPI,0000548312619881,0.0,10.0,7973.29
27/04/25,UPI,UPI-LIBERTYSRIHARIOKICIC-LIBERTYSRIHARI@ OKICICI-BKID0008627-548302967603-UPI,0000548302967603,0.0,1300.0,6673.29
27/04/25,UPI,UPI-VADICHERLA PRADEEP K-9293555325-3@YB L-HDFC0001635-959515267875-PAYMENT FROM PHONE,0000959515267875,0.0,1000.0,5673.29
27/04/25,UPI,UPI-MOHD PASHA MIYA-8074523914@YBL-LAVB0 000572-462900860779-PAYMENT FROM PHONE,0000462900860779,0.0,600.0,5073.29
27/04/25,UPI,UPI-RAPARTI SRIHARI-LIBERTYSRIHARI@OKSBI -BKID0008627-511748425320-UPI,0000511748425320,50000.0,0.0,55073.29
27/04/25,UPI,UPI-ANGEL LTD NSE-ANGELONENSE@HDFCBANK-H DFC0MERUPI-548307571135-PAYINGANGELONE,0000548307571135,0.0,30000.0,25073.29
27/04/25,UPI,UPI-ZERODHA BROKING LTD-ZERODHABROKING@H DFCBANK-HDFC0MERUPI-548340465199-7449880 671629249 Z,0000548340465199,0.0,10000.0,15073.29
28/04/25,UPI,UPI-M ANIL YADAV-ANILYADAV63473-1@OKSBI- UBIN0803219-548442975764-UPI,0000548442975764,0.0,600.0,14473.29
28/04/25,UPI,UPI-ANGEL LTD NSE-ANGELONENSE@HDFCBANK-H DFC0MERUPI-548461996134-PAYINGANGELONE,0000548461996134,0.0,10000.0,4473.29
28/04/25,UPI,UPI-B BHARATHI-Q594782917@YBL-YESB0YBLU PI-511818518044-UPI,0000511818518044,0.0,12.0,4461.29
28/04/25,UPI,UPI-HOTEL GREENLAND-GPAY-11244528013@OKB IZAXIS-UTIB0000553-511822831099-UPI,0000511822831099,0.0,55.0,4406.29
28/04/25,UPI,UPI-MR BHAIRAVA SRIKANTH-9293555325-5@YB L-CBIN0284811-166090657876-PAYMENT FROM PHONE,0000166090657876,0.0,1000.0,3406.29
28/04/25,UPI,UPI-MOHD AHMED ALI-AQUA.AHMED98@AXL-UTIB 0001808-210584316382-PAYMENT FROM PHONE,0000210584316382,360.0,0.0,3766.29
28/04/25,UPI,UPI-LIBERTYSRIHARIOKICIC-LIBERTYSRIHARI@ OKICICI-BKID0008627-511832046059-UPI,0000511832046059,0.0,1300.0,2466.29
28/04/25,UPI,UPI-LIBERTYSRIHARIOKICIC-LIBERTYSRIHARI@ OKICICI-BKID0008627-511888639748-UPI,0000511888639748,0.0,650.0,1816.29
28/04/25,NEFT,NEFT CR-ICIC0099999-ANGEL ONE LIMITED-MU KKERLA MADHU YADAV-ICICN220250428256725,ICICN22025042825,10000.0,0.0,11816.29
28/04/25,UPI,UPI-DARAM RAMYA-9959304512@AXL-HDFC00024 79-642822416279-PAYMENT FROM PHONE,0000642822416279,26700.0,0.0,38516.29
28/04/25,IMPS,IMPS-511821329478-M MADHU YADAV-KKBK-XXX XXX7813-CASH,0000511821329478,0.0,5500.0,33016.29
28/04/25,IMPS,IMPS-511822223535-BRANCH INTERNATIONAL-I CIC-XXXXXXXX0890-50832926 CF,0000511822223535,4529.0,0.0,37545.29
29/04/25,UPI,UPI-J SHIVANARAYANA-BHARATPE90726407443@ YESBANKLTD-YESB0YESUPI-511952059390-PAY TO J SHIVANARA,0000511952059390,0.0,50.0,37495.29
29/04/25,UPI,UPI-R VANDANA-Q021206969@YBL-YESB0YBLUP I-511913961283-UPI,0000511913961283,0.0,45.0,37450.29
29/04/25,UPI,UPI-ANGEL LTD NSE-ANGELONENSE@HDFCBANK-H DFC0MERUPI-511913462770-PAYINGANGELONE,0000511913462770,0.0,15000.0,22450.29
29/04/25,UPI,UPI-ZERODHA BROKING LTD-ZERODHABROKING@H DFCBANK-HDFC0MERUPI-511921455066-9891521 579246263 Z,0000511921455066,0.0,7000.0,15450.29
29/04/25,NEFT,NEFT CR-YESB0000001-TYCOON CREDIT AND P ORTFOLIOS LIMIT-MUKKERLAMADHUYADAV-YESBN,YESBN12025042905,13230.0,0.0,28680.29
29/04/25,UPI,UPI-SANJAYKUMAR65647OKIC-SANJAYKUMAR6564 7@OKICICI-KKBK0000565-511936298423-UPI,0000511936298423,0.0,21750.0,6930.29
29/04/25,UPI,UPI-JIO RECHARGE-JIOINAPPDIRECT1@AXL-UTI B0AXLUPI-693361556740-PAYMENT FROM PHONE,0000693361556740,0.0,19.0,6911.29
29/04/25,NEFT,NEFT CR-YESB0000001-RULOANS FINANCIAL SE RVICES PVT LTD -M MADHU YADAV-YESBN12025,YESBN12025042905,18348.0,0.0,25259.29
29/04/25,NEFT,NEFT CR-ICIC0099999-ANGEL ONE LIMITED-MU KKERLA MADHU YADAV-ICICN220250429265075,ICICN22025042926,5309.34,0.0,30568.63
29/04/25,UPI,UPI-LIBERTYSRIHARIOKICIC-LIBERTYSRIHARI@ OKICICI-BKID0008627-548502816399-UPI,0000548502816399,0.0,1300.0,29268.63
29/04/25,UPI,UPI-LIBERTYSRIHARIOKICIC-LIBERTYSRIHARI@ OKICICI-BKID0008627-548530114077-UPI,0000548530114077,0.0,650.0,28618.63
29/04/25,IMPS,IMPS-511921395566-M MADHU YADAV-KKBK-XXX XXX7813-CASH,0000511921395566,0.0,1000.0,27618.63
30/04/25,UPI,UPI-MOHD PASHA MIYA-8074523914@YBL-LAVB0 000572-157691085353-PAYMENT FROM PHONE,0000157691085353,0.0,600.0,27018.63
30/04/25,IMPS,IMPS-512007356686-M MADHU YADAV-KKBK-XXX XXX7813-CASH,0000512007356686,0.0,2000.0,25018.63
30/04/25,UPI,UPI-FDPL FINANCE-FDPLFINANCE@ICICI-ICIC0 DC0099-548619033693-UPI,0000548619033693,0.0,8224.22,16794.41
30/04/25,UPI,UPI-ANGEL LTD NSE-ANGELONENSE@HDFCBANK-H DFC0MERUPI-548691824410-PAYINGANGELONE,0000548691824410,0.0,12000.0,4794.41
30/04/25,,ANGEL ONE LIMI-249923065,0000504305521912,4690.66,0.0,9485.07
30/04/25,UPI,UPI-ZERODHA-ZERODHABROKING@YESBANK-YESB0 000022-548643535524-9664526842071290 Z,0000548643535524,0.0,1000.0,8485.07
30/04/25,UPI,UPI-SRINIVAS GOUD MERUPU-BAJAJPAY.687972 9.06012637@INDUS-INDB0MERCHA-54861843491 5-UPI,0000548618434915,0.0,190.0,8295.07
30/04/25,UPI,UPI-GARG SANITARY AND EL-GPAY-1125690396 7@OKBIZAXIS-UTIB0000553-548656447775-UPI,0000548656447775,0.0,850.0,7445.07
30/04/25,IMPS,IMPS-512014375332-M MADHU YADAV-KKBK-XXX XXX7813-CASH,0000512014375332,0.0,5000.0,2445.07
30/04/25,UPI,UPI-JIO RECHARGE-JIOINAPPDIRECT1@YBL-YES B0YBLUPI-669111315805-PAYMENT FROM PHONE,0000669111315805,0.0,19.0,2426.07
30/04/25,UPI,UPI-AKSHAY CHINTALA-9849868607@YESCRED- CNRB0000033-548601852974-PAID VIA CRED,0000548601852974,1350.0,0.0,3776.07
30/04/25,NEFT,NEFT CR-ICIC0099999-ANGEL ONE LIMITED-MU KKERLA MADHU YADAV-ICICN220250430280991,ICICN22025043028,10000.0,0.0,13776.07
30/04/25,UPI,UPI-ABBOJU HARISH-9110749456@AXL-SBIN00 20128-281594016089-PAYMENT FROM PHONE,0000281594016089,1080.0,0.0,14856.07
30/04/25,UPI,UPI-KATEPALLY VINAY KUM-VINAYKUMARKATEP ALLY@OKSBI-SBIN0003086-512067828895-UPI,0000512067828895,1260.0,0.0,16116.07
30/04/25,UPI,UPI-ANJALI BASANT-9903315499@IKWIK-UBIN0 825522-100455083464-NA,0000100455083464,1000.0,0.0,17116.07
01/05/25,UPI,UPI-KOUR H-HARDEEPKOUR24@OKAXIS-HSBC0500 002-512101276546-UPI,0000512101276546,1350.0,0.0,18466.07
01/05/25,UPI,UPI-MUKKERLA GEETA SUDHA-GEETHAMUKKERLA- 1@OKAXIS-KKBK0007463-548739196414-UPI,0000548739196414,0.0,6000.0,12466.07
01/05/25,NEFT,NEFT CR-ICIC0SF0002-FDPL FINANCE PRIVATE LIMITED-MMADHUYADAV-ICICN42025050158938,ICICN42025050158,7292.0,0.0,19758.07
01/05/25,,BHDFAUD0JOPSD8/BILLDKRATNAKARBANKLI,0002512183123715,0.0,6857.0,12901.07
01/05/25,UPI,UPI-COUNTER 2 SHIVA SAI -Q144661441@YBL- YESB0YBLUPI-512191226466-UPI,0000512191226466,0.0,350.0,12551.07
01/05/25,UPI,UPI-JIO RECHARGE-JIOINAPPDIRECT@YBL-YESB 0YBLUPI-728554628014-PAYMENT FROM PHONE,0000728554628014,0.0,352.0,12199.07
01/05/25,UPI,UPI-BHAGWAN DAS MARDA-7816018341@AXL-KVB L0001443-128207122619-PAYMENT FROM PHONE,0000128207122619,1350.0,0.0,13549.07
01/05/25,UPI,UPI-MOHD PASHA MIYA-8074523914@YBL-LAVB0 000572-051180271600-PAYMENT FROM PHONE,0000051180271600,0.0,600.0,12949.07
01/05/25,UPI,UPI-MR BHAIRAVA SRIKANTH-9293555325-5@YB L-CBIN0284811-088069098969-PAYMENT FROM PHONE,0000088069098969,0.0,1300.0,11649.07
01/05/25,UPI,UPI-MADHU SUDHAN GHODKE-MADHUSUDHANGHOD KE@YBL-SBIN0005895-978992870639-PAYMENT FROM PHONE,0000978992870639,200.0,0.0,11849.07
01/05/25,UPI,UPI-NAVDURGA PLASTICS-Q669378539@YBL-YES B0YBLUPI-512170054549-UPI,0000512170054549,0.0,320.0,11529.07
01/05/25,UPI,UPI-PANYAM MANJULA-MANJUPANYAM@OKSBI-SB IN0007641-512104096130-MILK,0000512104096130,2440.0,0.0,13969.07
01/05/25,UPI,UPI-LIBERTYSRIHARIOKICIC-LIBERTYSRIHARI@ OKICICI-BKID0008627-512147776924-UPI,0000512147776924,0.0,1300.0,12669.07
01/05/25,UPI,UPI-LIBERTYSRIHARIOKICIC-LIBERTYSRIHARI@ OKICICI-BKID0008627-512192960977-UPI,0000512192960977,0.0,650.0,12019.07
02/05/25,UPI,UPI-MENDE MONMOHAN YADA-Q199398888@YBL- YESB0YBLUPI-512280975313-UPI,0000512280975313,0.0,35.0,11984.07
02/05/25,,ANGEL ONE LIMI-250138337,0000505020454633,12000.0,0.0,23984.07
02/05/25,UPI,UPI-MADHURI MARAM-LIPIKAMARAM@OKICICI-IC IC0000008-512266287123-UPI,0000512266287123,1285.0,0.0,25269.07
02/05/25,UPI,UPI-SAMUDHRALA MANASA-MANASA31961@AXL-SB IN0RRDCGB-491232380434-PAYMENT FROM PHON E,0000491232380434,2450.0,0.0,27719.07
02/05/25,UPI,UPI-SAMUDHRALA MANASA-MANASA31961@AXL-SB IN0RRDCGB-033057027413-PAYMENT FROM PHON E,0000033057027413,10.0,0.0,27729.07
02/05/25,UPI,UPI-RAPARTI SRIHARI-LIBERTYSRIHARI@OKICI CI-BKID0008627-439075841731-PAYMENT FROM PHONE,0000439075841731,0.0,10000.0,17729.07
02/05/25,UPI,UPI-ALLI ASHWINIKUMAR-ASHWINYADAV85@AXL- INDB0000839-262691453569-PAYMENT FROM PH ONE,0000262691453569,900.0,0.0,18629.07
02/05/25,UPI,UPI-B RAJESHWARI-RAJESHWARIYADAV147@OKSB I-SBIN0RRDCGB-512221264063-UPI,0000512221264063,7680.0,0.0,26309.07
02/05/25,UPI,UPI-SOMALWAR SHRINIVAS-SOMALWAR73@OKSBI -SBIN0010356-512222099534-UPI,0000512222099534,2400.0,0.0,28709.07
02/05/25,UPI,UPI-VENTHURLA RAMANI-9542959457@YBL-SBI N0021416-922955372072-PAYMENT FROM PHONE,0000922955372072,0.0,400.0,28309.07
02/05/25,UPI,UPI-FREO PAY-FREOPAY.PAYU@ICICI-ICIC0DC0 099-512253899356-UPIINTENT,0000512253899356,0.0,1162.02,27147.05
02/05/25,UPI,UPI-MONEYVIEW-MONEYVIEW.EASEBUZZ@KOTAK-K KBK0000958-548847606789-PAY,0000548847606789,0.0,7460.0,19687.05
02/05/25,IMPS,IMPS-512214980642-MUTHOOTFINCORPLTD-UTIB -XXXXXXXXXXX6541-TREASURYDISBURSAL,0000512214980642,13698.0,0.0,33385.05
02/05/25,UPI,UPI-BUDUMURU BHARGAVI-6303219486-3@AXL-C NRB0000033-822907774549-PAYMENT FROM PHO NE,0000822907774549,2030.0,0.0,35415.05
02/05/25,IMPS,IMPS-512221342975-M MADHU YADAV-KKBK-XXX XXX7813-CASH,0000512221342975,0.0,4000.0,31415.05
02/05/25,UPI,UPI-ABSIPURAM KARUNAKAR-9000103377@YBL- SBIN0020083-294962357613-PAYMENT FROM PH ONE,0000294962357613,3600.0,0.0,35015.05
03/05/25,UPI,UPI-TIRIVISETTY SATYANAR-Q628175389@YBL- YESB0YBLUPI-548995242707-UPI,0000548995242707,0.0,30.0,34985.05
03/05/25,UPI,UPI-VINODKUMAR TERALA-PAYTMQR6EVQTE@PTY S-YESB0PTMUPI-548918749056-UPI,0000548918749056,0.0,50.0,34935.05
03/05/25,UPI,UPI-MR MARYPEDDY YADAIAH-PAYTMQR5WD1F4@P TYS-YESB0PTMUPI-548995564723-UPI,0000548995564723,0.0,262.0,34673.05
03/05/25,UPI,UPI-MOHAMMED IBRAHIM-BHARATPE90727407781 @YESBANKLTD-YESB0YESUPI-548947768121-PAY TO BHARATPE ME,0000548947768121,0.0,300.0,34373.05
03/05/25,UPI,UPI-GTHIRUPATHAIAH-Q455385456@YBL-YESB0Y BLUPI-548972660344-UPI,0000548972660344,0.0,90.0,34283.05
03/05/25,UPI,UPI-J SHIVANARAYANA-BHARATPE90726407443@ YESBANKLTD-YESB0YESUPI-548949570899-PAY TO J SHIVANARA,0000548949570899,0.0,50.0,34233.05
03/05/25,UPI,UPI-SHIFA CLINIC-SHIFACLINIC.42828558@HD FCBANK-HDFC0MERUPI-548991270109-GENERATI NG DYNAMIC,0000548991270109,0.0,100.0,34133.05
03/05/25,UPI,UPI-RAPARTI SRIHARI-LIBERTYSRIHARI@OKICI CI-BKID0008627-261102910392-PAYMENT FROM PHONE,0000261102910392,0.0,10000.0,24133.05
03/05/25,UPI,UPI-BALA KASHYAP-BALA.KASHYAP1@YBL-HDFC0 000126-251232971108-PAYMENT FROM PHONE,0000251232971108,945.0,0.0,25078.05
03/05/25,UPI,UPI-NAGRAJ-MUKKERLANAGRAJ@OKAXIS-UBIN080 3219-512392244637-UPI,0000512392244637,3000.0,0.0,28078.05
03/05/25,UPI,UPI-BILLA SAI KUMAR-BILLADUMBU@YBL-SBIN 0012916-753153824949-PAYMENT FROM PHONE,0000753153824949,1200.0,0.0,29278.05
03/05/25,UPI,UPI-MUKKERLA GEETA SUDHA-GEETHAMUKKERLA- 1@OKAXIS-KKBK0007463-548932275478-UPI,0000548932275478,0.0,2300.0,26978.05
03/05/25,UPI,UPI-LAKSHMI APPALA-LAKSHME1202@OKSBI-SB IN0005895-512379538164-UPI,0000512379538164,1000.0,0.0,27978.05
03/05/25,UPI,UPI-M MADHU YADAV-9985065404-2@AXL-SBIN 0006645-990297983544-PAYMENT FROM PHONE,0000990297983544,14000.0,0.0,41978.05
03/05/25,UPI,UPI-MOHD PASHA MIYA-8074523914@YBL-LAVB0 000572-107167116441-PAYMENT FROM PHONE,0000107167116441,0.0,600.0,41378.05
03/05/25,UPI,UPI-GANTA SUJATHA-SUJATHAGANAT13@OKSBI- SBIN0005895-548989698335-UPI,0000548989698335,0.0,1.0,41377.05
03/05/25,UPI,UPI-GANTA SUJATHA-SUJATHAGANAT13@OKICIC I-SBIN0005895-548942395413-UPI,0000548942395413,45000.0,0.0,86377.05
03/05/25,UPI,UPI-SYED SULIMAN-SYEDSULIMAN9700-1@OKAX IS-KKBK0007452-512358973421-UPI,0000512358973421,2760.0,0.0,89137.05
03/05/25,UPI,UPI-SRI SAI RESTAURANT A-PAYTM-80659624@ PTYS-YESB0PTMUPI-512351801917-UPI,0000512351801917,0.0,240.0,88897.05
03/05/25,UPI,UPI-VADICHERLA PRADEEP K-9293555325@AXL- UBIN0800619-731011570310-PAYMENT FROM PH ONE,0000731011570310,0.0,1300.0,87597.05
03/05/25,UPI,UPI-JURRU RAHUL YADAV-9963019626@YBL-SB IN0007641-733950897072-PAYMENT FROM PHON E,0000733950897072,0.0,500.0,87097.05
03/05/25,UPI,UPI-LIBERTYSRIHARIOKICIC-LIBERTYSRIHARI@ OKICICI-BKID0008627-512311614088-UPI,0000512311614088,0.0,1300.0,85797.05
03/05/25,IMPS,IMPS-512319338775-M MADHU YADAV-KKBK-XXX XXX7813-CASH,0000512319338775,0.0,1000.0,84797.05
03/05/25,UPI,UPI-MOHD AFROZ-MAFROZ272@OKAXIS-UBIN0805 211-512345179986-UPI,0000512345179986,2000.0,0.0,86797.05
03/05/25,UPI,UPI-SUHAS MADHUKAR CHAUD-DRSUHAS2003@OKH DFCBANK-KKBK0001367-104218785156-UPI,0000104218785156,2160.0,0.0,88957.05
03/05/25,IMPS,IMPS-512322309467-M MADHU YADAV-KKBK-XXX XXX7813-CASH,0000512322309467,0.0,10000.0,78957.05
04/05/25,UPI,UPI-SASHIKALA BHANDARI-9032117972@YBL-S BIN0005895-049222888345-PAYMENT FROM PHO NE,0000049222888345,3375.0,0.0,82332.05
04/05/25,POS,CASH DEPOSIT-XXXXXXXXXX1847-HIMAYATNAGAR,0000000000003514,8400.0,0.0,90732.05
04/05/25,UPI,UPI-RAPARTI SRIHARI-LIBERTYSRIHARI@OKICI CI-BKID0008627-084816962127-PAYMENT FROM PHONE,0000084816962127,0.0,10000.0,80732.05
04/05/25,,ACH D- PROTIUM FINANCE LIMI-BSP2T8RHGSYD,0000007983952947,0.0,28475.0,52257.05
04/05/25,UPI,UPI-M MADHU YADAV-9985065404-2@AXL-SBIN 0006645-860669495030-PAYMENT FROM PHONE,0000860669495030,15000.0,0.0,67257.05
04/05/25,UPI,UPI-DISHA BANSAL-BANSALDISHA918@OKICIC I-KKBK0007463-512498156918-UPI,0000512498156918,7920.0,0.0,75177.05
04/05/25,UPI,UPI-B RAYUDU-RAYUDU10-1@OKHDFCBANK-HDFC0 000042-104247523348-MILK AMT,0000104247523348,1050.0,0.0,76227.05
04/05/25,UPI,UPI-JURRU RAHUL YADAV-9963019626@YBL-SB IN0007641-989419866548-PAYMENT FROM PHON E,0000989419866548,0.0,500.0,75727.05
04/05/25,UPI,UPI-VADICHERLA PRADEEP K-9293555325@AXL- UBIN0800619-551074323477-PAYMENT FROM PH ONE,0000551074323477,0.0,1300.0,74427.05
04/05/25,UPI,UPI-CHAVALI LAVANYA-9490255943@YBL-CNRB0 000000-794540098575-PAYMENT FROM PHONE,0000794540098575,2040.0,0.0,76467.05
04/05/25,UPI,UPI-LIBERTYSRIHARIOKICIC-LIBERTYSRIHARI@ OKICICI-BKID0008627-512455198621-UPI,0000512455198621,0.0,1300.0,75167.05
04/05/25,UPI,UPI-ANGEL ONE LIMITED-ANGELONENSE@ICICI- ICIC0DC0099-512464488498-PAYINGANGELONE,0000512464488498,0.0,25000.0,50167.05
04/05/25,UPI,UPI-ZERODHA BROKING LTD-ZERODHABROKING@H DFCBANK-HDFC0MERUPI-512460583568-3242745 375374950 Z,0000512460583568,0.0,13000.0,37167.05
04/05/25,UPI,UPI-M ANIL YADAV-ANILYADAV63473-1@OKSBI- UBIN0803219-512409899103-UPI,0000512409899103,0.0,3000.0,34167.05
04/05/25,UPI,UPI-MAHAVIR SETHI-9392489604@YBL-SBIN00 05895-843051305880-PAYMENT FROM PHONE,0000843051305880,1560.0,0.0,35727.05
04/05/25,UPI,UPI-KURINDULA RAJASHEKAR-9966883802-4@YB L-HDFC0000218-677372836003-PAYMENT FROM PHONE,0000677372836003,2400.0,0.0,38127.05
05/05/25,UPI,UPI-P NAND KISHOR-BHARATPE.90069295183@F BPE-FDRL0001382-549156021735-PAY TO BHAR ATPE ME,0000549156021735,0.0,100.0,38027.05
05/05/25,UPI,UPI-ANGEL ONE LIMITED-ANGELONENSE@ICICI- ICIC0DC0099-549194106211-PAYINGANGELONE,0000549194106211,0.0,1500.0,36527.05
05/05/25,UPI,UPI-JIO RECHARGE-JIOINAPPDIRECT1@AXL-UTI B0AXLUPI-069688103820-PAYMENT FROM PHONE,0000069688103820,0.0,352.0,36175.05
05/05/25,,ACH D- IKF HOME FINANCE LTD-050520250518,0000008014477638,0.0,22875.0,13300.05
05/05/25,UPI,UPI-MOHD AHMED ALI-AQUA.AHMED98@AXL-UTIB 0001808-669507291811-PAYMENT FROM PHONE,0000669507291811,300.0,0.0,13600.05
05/05/25,UPI,UPI-ZERODHA BROKING LTD-ZERODHABROKING@H DFCBANK-HDFC0MERUPI-549134026262-4308925 210715048 Z,0000549134026262,0.0,1000.0,12600.05
05/05/25,UPI,UPI-KANAKA LAXMI FOODS-Q306728433@YBL-YE SB0YBLUPI-549103627191-UPI,0000549103627191,0.0,500.0,12100.05
05/05/25,UPI,UPI-NEMALI KARUNAKAR-PAYTMQR66OYO2@PTYS- YESB0PTMUPI-549124533036-UPI,0000549124533036,0.0,2000.0,10100.05
05/05/25,UPI,UPI-ALTAF LAXMAIAH BRO-Q153561498@YBL- YESB0YBLUPI-549100538123-UPI,0000549100538123,0.0,350.0,9750.05
05/05/25,UPI,UPI-MOHD KHAJA FAHEEM AL-POWERHOUSEKIRAN -3@OKAXIS-UTIB0001498-512515207195-UPI,0000512515207195,2340.0,0.0,12090.05
05/05/25,UPI,UPI-KOTHAPALLI PARASURA-KOTHAPALLYPARSH URAMPARSHURAM@OKSBI-SBIN0007641-54914205 6575-UPI,0000549142056575,0.0,500.0,11590.05
05/05/25,UPI,UPI-KOTHAPALLI PARASURA-KOTHAPALLYPARSH URAMPARSHURAM@OKSBI-SBIN0007641-54919804 1235-UPI,0000549198041235,0.0,300.0,11290.05
05/05/25,UPI,UPI-ANOOP JAISWAL-8978900259@YBL-SBIN00 05895-233009142465-PAYMENT FROM PHONE,0000233009142465,350.0,0.0,11640.05
05/05/25,UPI,UPI-B SHIRISHA-SIRISHA0413@YBL-UBIN08007 67-767309011130-PAYMENT FROM PHONE,0000767309011130,2175.0,0.0,13815.05
05/05/25,UPI,UPI-RAVI SONI-8588863000@YBL-HDFC0009461 -422323727748-PAYMENT FROM PHONE,0000422323727748,6090.0,0.0,19905.05
05/05/25,UPI,UPI-MADHU SUDHAN GHODKE-MADHUSUDHANGHOD KE@AXL-SBIN0005895-549174053512-UPI,0000549174053512,0.0,100.0,19805.05
05/05/25,UPI,UPI-LIBERTYSRIHARIOKICIC-LIBERTYSRIHARI@ OKICICI-BKID0008627-549177064694-UPI,0000549177064694,0.0,1300.0,18505.05
05/05/25,UPI,UPI-LIBERTYSRIHARIOKICIC-LIBERTYSRIHARI@ OKICICI-BKID0008627-549168374908-UPI,0000549168374908,0.0,650.0,17855.05
05/05/25,UPI,UPI-VADICHERLA PRADEEP K-9293555325@AXL- UBIN0800619-506675791193-PAYMENT FROM PH ONE,0000506675791193,0.0,1300.0,16555.05
05/05/25,UPI,UPI-GOGA ELECTRONICS-9849436607@AXL-APMC 0000006-950832151555-PAYMENT FROM PHONE,0000950832151555,6160.0,0.0,22715.05
06/05/25,UPI,UPI-VINODKUMAR TERALA-PAYTMQR56YMWQ@PAY TM-YESB0PTMUPI-549206882662-UPI,0000549206882662,0.0,50.0,22665.05
06/05/25,UPI,UPI-MOHD FAREED-PAYTMQR6F0IPL@PTYS-YESB0 PTMUPI-549270983170-UPI,0000549270983170,0.0,20.0,22645.05
06/05/25,,ANGEL ONE LIMI-250672669,0000505066493755,2213.47,0.0,24858.52
06/05/25,UPI,UPI-R VANDANA-Q021206969@YBL-YESB0YBLUP I-549211686048-UPI,0000549211686048,0.0,45.0,24813.52
06/05/25,UPI,UPI-PHONEPE-BBPSBP@YBL-YESB0YBLUPI-69784 7696780-PAYMENT FROM PHONE,0000697847696780,0.0,8936.84,15876.68
06/05/25,UPI,UPI-MR MOHAMMED SHAFI A-BHARATPE.900554 90128@FBPE-FDRL0001382-549284299665-PAY TO BHARATPE ME,0000549284299665,0.0,300.0,15576.68
06/05/25,UPI,UPI-BHARATHI BHARATHI-BHARTHI9573@YBL-S BIN0020701-549293790170-UPI,0000549293790170,0.0,6000.0,9576.68
06/05/25,UPI,UPI-RAPARTI SRIHARI-LIBERTYSRIHARI@OKICI CI-BKID0008627-957363192197-PAYMENT FROM PHONE,0000957363192197,0.0,1500.0,8076.68
06/05/25,UPI,UPI-KOLLAPURAM MALLIKARJ-MALLIKARJUNKOLA PURAM@OKSBI-HDFC0000218-512685926514-UPI,0000512685926514,0.0,400.0,7676.68
06/05/25,UPI,UPI-MR RAVI TEJA POTHAR-RAVITEJAYADAV95 28@OKHDFCBANK-CBIN0280808-512652626628-U PI,0000512652626628,0.0,500.0,7176.68
06/05/25,IMPS,IMPS-512621357735-M MADHU YADAV-KKBK-XXX XXX7813-CASH,0000512621357735,0.0,4000.0,3176.68
07/05/25,UPI,UPI-MEDI KRISHNAVENI-9908073394@IBL-SBI N0015762-475738574231-PAYMENT FROM PHONE,0000475738574231,1200.0,0.0,4376.68
07/05/25,,ANGEL ONE LIMI-W24ANXROCVKV4S,0000505079147190,14000.0,0.0,18376.68
07/05/25,UPI,UPI-PERIKA NAVEEN KUMAR-9949580450@YBL-K KBK0007473-555824253548-PAYMENT FROM PHO NE,0000555824253548,8000.0,0.0,26376.68
07/05/25,UPI,UPI-RAPARTI SRIHARI-LIBERTYSRIHARI@OKICI CI-BKID0008627-829193234170-PAYMENT FROM PHONE,0000829193234170,0.0,13000.0,13376.68
07/05/25,,IB BILLPAY DR-HDFC92-434155XXXXXX1025,MB07123635040T45,0.0,10581.0,2795.68
07/05/25,UPI,UPI-ANGEL LTD M2P-ANGELONEM2P@HDFCBANK-H DFC0MERUPI-100508754806-W24AOBFUREU9CF,0000100508754806,890.0,0.0,3685.68
07/05/25,UPI,UPI-ORUGANTI SRINIVAS RE-OSRINIVAS555@OK AXIS-UTIB0000426-549358628409-UPI,0000549358628409,1100.0,0.0,4785.68
07/05/25,UPI,UPI-HARSHITA SRIVASTAVA-7703933115@AXL- FINO0000001-880671636247-PAYMENT FROM PH ONE,0000880671636247,2437.0,0.0,7222.68
07/05/25,UPI,UPI-MAISHWARYA-Q653350877@YBL-YESB0YBLUP I-512737165296-UPI,0000512737165296,0.0,50.0,7172.68
07/05/25,UPI,UPI-VADICHERLA PRADEEP K-9293555325-3@YB L-HDFC0001635-305298103257-PAYMENT FROM PHONE,0000305298103257,0.0,1300.0,5872.68
07/05/25,NEFT,NEFT CR-YESB0000001-ZERODHA BROKING LTD- DSCNB A/C-MUKKERLA MADHU YADAV-YESBN1202,YESBN12025050705,9000.0,0.0,14872.68
07/05/25,UPI,UPI-RAJESH C PATEL-CNKRAJESHPATEL@OKAXIS -KKBK0008052-549320373025-APRIL MILK BIL L,0000549320373025,1690.0,0.0,16562.68
07/05/25,UPI,UPI-JURRU RAHUL YADAV-9963019626@YBL-SB IN0007641-231830691126-PAYMENT FROM PHON E,0000231830691126,0.0,500.0,16062.68
07/05/25,UPI,UPI-LIBERTYSRIHARIOKICIC-LIBERTYSRIHARI@ OKICICI-BKID0008627-549399603126-UPI,0000549399603126,0.0,1300.0,14762.68
07/05/25,UPI,UPI-LIBERTYSRIHARIOKICIC-LIBERTYSRIHARI@ OKICICI-BKID0008627-512747491437-UPI,0000512747491437,0.0,650.0,14112.68
07/05/25,UPI,UPI-M ANIL YADAV-ANILYADAV63473-1@OKSBI- UBIN0803219-512728094480-UPI,0000512728094480,0.0,450.0,13662.68
07/05/25,UPI,UPI-VARTHYAVATH THIRUPA-THIRUPATI1981NA IK@OKHDFCBANK-SBIN0021009-104443338078-U PI,0000104443338078,2100.0,0.0,15762.68
08/05/25,NEFT,NEFT CR-YESB0000001-ZERODHA BROKING LTD- DSCNB A/C-MUKKERLA MADHU YADAV-YESBN1202 493112 5050801493112,YESBN12025050801,440.0,0.0,16202.68
08/05/25,UPI,UPI-MURALIKRISHNA VEGETA-GPAY-1125407554 1@OKBIZAXIS-UTIB0000553-512828794044-UPI,0000512828794044,0.0,350.0,15852.68
08/05/25,UPI,UPI-TIRIVISETTY SATYANAR-Q628175389@YBL- YESB0YBLUPI-549499814428-UPI,0000549499814428,0.0,30.0,15822.68
08/05/25,UPI,UPI-VINODKUMAR TERALA-PAYTMQR5WE22Q@PTY S-YESB0PTMUPI-549466014499-UPI,0000549466014499,0.0,50.0,15772.68
08/05/25,UPI,UPI-SANGARAJ JAIKRISHNA-JAIKRISHNADHANAL AXMISANGARAJ@OKHDFCBANK-UBIN0803219-5494 29314315-UPI,0000549429314315,0.0,35.0,15737.68
08/05/25,UPI,UPI-BHARATHI BHARATHI-BHARTHI9573@YBL-S BIN0020701-549449125981-UPI,0000549449125981,0.0,6000.0,9737.68
08/05/25,UPI,UPI-M MADHU YADAV-9985065404-2@YBL-SBIN 0006645-371917194082-PAYMENT FROM PHONE,0000371917194082,3000.0,0.0,12737.68
08/05/25,UPI,UPI-K S CONSTRUCTIONS-9393995648-2@IBL-A UBL0002591-871281430513-PAYMENT FROM PHO NE,0000871281430513,30000.0,0.0,42737.68
08/05/25,UPI,UPI-ARJUNA RAO SARA-ARJUNA.SARA@OKSBI-S BIN0011661-512811181515-UPI,0000512811181515,3000.0,0.0,45737.68
08/05/25,UPI,UPI-LIBERTYSRIHARIOKICIC-LIBERTYSRIHARI@ OKICICI-BKID0008627-549482343560-UPI,0000549482343560,0.0,45500.0,237.68
08/05/25,UPI,UPI-HP PETROL PUMP PETR-Q808953223@YBL- YESB0YBLUPI-549427451889-UPI,0000549427451889,0.0,150.0,87.68
08/05/25,UPI,UPI-RAPARTI SRIHARI-LIBERTYSRIHARI@OKAXI S-BKID0008627-512869564679-DAILY 1300 IN TO 1,0000512869564679,50000.0,0.0,50087.68
08/05/25,UPI,UPI-RAPARTI SRIHARI-LIBERTYSRIHARI@OKSBI -BKID0008627-512830794991-NEW 1 LAKH AMO UNT,0000512830794991,50000.0,0.0,100087.68
08/05/25,UPI,UPI-UPMOVE CAPITAL PRIVA-UPMOVECAPITALPR 695125.RZP@RXAIRTEL-AIRP0000011-51282023 0280-UPMOVECAPITALPRIVA,0000512820230280,0.0,7134.54,92953.14
08/05/25,UPI,UPI-TRUE CREDITS-TRUECREDITS991413.RZP@R XAIRTEL-AIRP0000011-549457571365-TRUECRE DITS,0000549457571365,0.0,6821.0,86132.14
08/05/25,UPI,UPI-LIBERTYSRIHARIOKICIC-LIBERTYSRIHARI@ OKICICI-BKID0008627-549498659276-UPI,0000549498659276,0.0,650.0,85482.14
08/05/25,UPI,UPI-VADICHERLA PRADEEP K-9293555325-3@YB L-HDFC0001635-638913515302-PAYMENT FROM PHONE,0000638913515302,0.0,1300.0,84182.14
09/05/25,UPI,UPI-JURRU RAHUL YADAV-Q758292524@YBL-YE SB0YBLUPI-549565875748-UPI,0000549565875748,0.0,80.0,84102.14
09/05/25,UPI,UPI-B VINOD KUMAR-BALERAOVINOD077@OKSBI- CNRB0000033-549592474928-UPI,0000549592474928,0.0,4000.0,80102.14
09/05/25,UPI,UPI-VINODKUMAR TERALA-PAYTMQR56YMWQ@PAY TM-YESB0PTMUPI-549523767501-UPI,0000549523767501,0.0,50.0,80052.14
09/05/25,UPI,UPI-MUKKERLA GEETA SUDHA-GEETHAMUKKERLA- 1@OKAXIS-KKBK0007463-549566679792-UPI,0000549566679792,0.0,1700.0,78352.14
09/05/25,UPI,UPI-HIGH SPIRITZ ELITE U-Q166095648@YBL- YESB0YBLUPI-549551688300-UPI,0000549551688300,0.0,1320.0,77032.14
09/05/25,UPI,UPI-MADHU SUDHAN GHODKE-MADHUSUDHANGHOD KE-2@OKSBI-SBIN0005895-512909105515-UPI,0000512909105515,0.0,500.0,76532.14
09/05/25,UPI,UPI-GANTA SUJATHA-SUJATHAGANAT13@OKSBI- SBIN0005895-512903603531-UPI,0000512903603531,0.0,6000.0,70532.14
09/05/25,UPI,UPI-LIBERTYSRIHARIOKICIC-LIBERTYSRIHARI@ OKICICI-BKID0008627-512901131652-UPI,0000512901131652,0.0,1300.0,69232.14
09/05/25,UPI,UPI-LIBERTYSRIHARIOKICIC-LIBERTYSRIHARI@ OKICICI-BKID0008627-512953027183-UPI,0000512953027183,0.0,650.0,68582.14
09/05/25,UPI,UPI-KARRA SATHISH-9293555325-7@AXL-BKID0 005707-019176908488-PAYMENT FROM PHONE,0000019176908488,0.0,1300.0,67282.14
10/05/25,UPI,UPI-MOHD PASHA MIYA-8074523914@YBL-LAVB0 000572-382426685449-PAYMENT FROM PHONE,0000382426685449,0.0,700.0,66582.14
10/05/25,UPI,UPI-TIRIVISETTY SATYANAR-Q628175389@YBL- YESB0YBLUPI-513047852309-UPI,0000513047852309,0.0,30.0,66552.14
10/05/25,UPI,UPI-VINODKUMAR TERALA-PAYTMQR56YMWQ@PAY TM-YESB0PTMUPI-513011040927-UPI,0000513011040927,0.0,50.0,66502.14
10/05/25,UPI,UPI-K S CONSTRUCTIONS-ASHWINYADAV85-1@OK SBI-AUBL0002591-405636047941-PAYMENT FRO M PHONE,0000405636047941,0.0,10000.0,56502.14
10/05/25,UPI,UPI-MR MARYPEDDY YADAIAH-PAYTMQR5WD1F4@P TYS-YESB0PTMUPI-513048154564-UPI,0000513048154564,0.0,30.0,56472.14
10/05/25,UPI,UPI-BHARATHI BHARATHI-BHARTHI9573@YBL-S BIN0020701-513091741538-UPI,0000513091741538,0.0,6000.0,50472.14
10/05/25,UPI,UPI-VARTHYAVATH THIRUPA-THIRUPATI1981NA IK-1@OKSBI-SBIN0021009-513009116836-UPI,0000513009116836,2100.0,0.0,52572.14
10/05/25,UPI,UPI-AMIT CHARAN-PAYTMQR6F2KJQ@PTYS-YESB0 PTMUPI-513055359428-UPI,0000513055359428,0.0,25.0,52547.14
10/05/25,UPI,UPI-KOUR H-HARDEEPKOUR24@OKSBI-HSBC05000 02-513013156675-UPI,0000513013156675,45.0,0.0,52592.14
10/05/25,UPI,UPI-GANTA SUJATHA-SUJATHAGANAT13@OKSBI- SBIN0005895-513015354982-UPI,0000513015354982,0.0,1.0,52591.14
10/05/25,UPI,UPI-GANTA SUJATHA-SUJATHAGANAT13@OKSBI- SBIN0005895-513019807330-UPI,0000513019807330,36000.0,0.0,88591.14
10/05/25,UPI,UPI-SANTHOSHA ARRA-SANTHU.SANTHOSHA2004@ OKHDFCBANK-HDFC0000562-513068056586-UPI,0000513068056586,0.0,6000.0,82591.14
10/05/25,,NWD-416021XXXXXX2657-STS9102-HYDERABAD,0000513015457363,0.0,7000.0,75591.14
10/05/25,UPI,UPI-JANARDHAN FILL POINT-BPCLJANARDHANFI LLKACHIGUDA0008@YBL-YESB0YBLUPI-51309546 1538-UPI,0000513095461538,0.0,350.0,75241.14
10/05/25,UPI,UPI-VARTHYAVATH THIRUPA-THIRUPATI1981NA IK-1@OKSBI-SBIN0021009-513096193155-UPI,0000513096193155,0.0,2100.0,73141.14
10/05/25,UPI,UPI-VADICHARLA LAVANYA-9293555325-2@YBL- UTIB0003574-558030795852-PAYMENT FROM PH ONE,0000558030795852,0.0,1300.0,71841.14
10/05/25,UPI,UPI-LIBERTYSRIHARIOKICIC-LIBERTYSRIHARI@ OKICICI-BKID0008627-513046181293-UPI,0000513046181293,0.0,650.0,71191.14
10/05/25,UPI,UPI-LIBERTYSRIHARIOKICIC-LIBERTYSRIHARI@ OKICICI-BKID0008627-513043279009-UPI,0000513043279009,0.0,1300.0,69891.14
11/05/25,,ATW-416021XXXXXX2657-S1AWHY59-HYDERABAD,0000000000006877,0.0,20000.0,49891.14
11/05/25,,ATW-416021XXXXXX2657-S1AWHY59-HYDERABAD,0000000000006878,0.0,20000.0,29891.14
11/05/25,UPI,UPI-A NARESH KUMAR-Q749466560@YBL-YESB0Y BLUPI-549728308151-UPI,0000549728308151,0.0,5.0,29886.14
11/05/25,UPI,UPI-SRI BALAJI WINES-PAYTMQR11PZPHQ2DI@P AYTM-YESB0PTMUPI-549753620381-UPI,0000549753620381,0.0,330.0,29556.14
11/05/25,UPI,UPI-NEMALI KARUNAKAR-KARUNAKARNEMALI901 @OKSBI-SBIN0016294-549760420219-UPI,0000549760420219,0.0,1000.0,28556.14
11/05/25,UPI,UPI-MOHD SAIF-PAYTMQRFGZRP91W8H@PAYTM-YE SB0PTMUPI-549738720170-UPI,0000549738720170,0.0,260.0,28296.14
11/05/25,UPI,UPI-B BHARATHI-Q594782917@YBL-YESB0YBLU PI-549748638659-UPI,0000549748638659,0.0,12.0,28284.14
11/05/25,UPI,UPI-MADHU SUDHAN GHODKE-MADHUSUDHANGHOD KE-2@OKSBI-SBIN0005895-549707839153-UPI,0000549707839153,0.0,200.0,28084.14
11/05/25,UPI,UPI-LIBERTYSRIHARIOKICIC-LIBERTYSRIHARI@ OKICICI-BKID0008627-549787358691-UPI,0000549787358691,0.0,1300.0,26784.14
11/05/25,UPI,UPI-LIBERTYSRIHARIOKICIC-LIBERTYSRIHARI@ OKICICI-BKID0008627-549761762943-UPI,0000549761762943,0.0,650.0,26134.14
11/05/25,UPI,UPI-VADICHERLA PRADEEP K-9293555325-3@YB L-HDFC0001635-561678468326-PAYMENT FROM PHONE,0000561678468326,0.0,1300.0,24834.14
11/05/25,POS,CASH DEPOSIT-416021XXXXXX2657-SHIVAM ROA D,0000000000007867,49000.0,0.0,73834.14
11/05/25,POS,CASH DEPOSIT-416021XXXXXX2657-SHIVAM ROA D,0000000000007870,45500.0,0.0,119334.14
11/05/25,UPI,UPI-ANGEL LTD NSE-ANGELONENSE@HDFCBANK-H DFC0MERUPI-549755743334-PAYINGANGELONE,0000549755743334,0.0,15000.0,104334.14
11/05/25,UPI,UPI-SRINIVAS GOUD MERUPU-BAJAJPAY.687972 9.05710844@INDUS-INDB0MERCHA-54976395197 3-UPI,0000549763951973,0.0,180.0,104154.14
12/05/25,UPI,UPI-M ANIL YADAV-ANILYADAV63473-1@OKSBI- UBIN0803219-549874657999-UPI,0000549874657999,0.0,5000.0,99154.14
12/05/25,UPI,UPI-M ANIL YADAV-ANILYADAV63473-1@OKSBI- UBIN0803219-549870453306-UPI,0000549870453306,0.0,2500.0,96654.14
12/05/25,UPI,UPI-M ANIL YADAV-ANILYADAV63473-1@OKSBI- UBIN0803219-549880954126-UPI,0000549880954126,0.0,3000.0,93654.14
12/05/25,UPI,UPI-M ANIL YADAV-ANILYADAV63473-1@OKSBI- UBIN0803219-549870156583-UPI,0000549870156583,0.0,600.0,93054.14
12/05/25,UPI,UPI-ANGEL LTD NSE-ANGELONENSE@HDFCBANK-H DFC0MERUPI-549834864680-PAYINGANGELONE,0000549834864680,0.0,25000.0,68054.14
12/05/25,UPI,UPI-VINODKUMAR TERALA-PAYTMQR5WE22Q@PTY S-YESB0PTMUPI-549872657736-UPI,0000549872657736,0.0,70.0,67984.14
12/05/25,UPI,UPI-MR PRASAD-PAYTMQR5C8CGA@PTYS-YESB0PT MUPI-549836068155-UPI,0000549836068155,0.0,30.0,67954.14
12/05/25,UPI,UPI-M ARVIND RAJ-ARVINDRAJ57964-1@OKHDFC BANK-HDFC0000512-104675660444-UPI,0000104675660444,440.0,0.0,68394.14
12/05/25,UPI,UPI-ANGEL LTD NSE-ANGELONENSE@HDFCBANK-H DFC0MERUPI-549829665980-PAYINGANGELONE,0000549829665980,0.0,3500.0,64894.14
12/05/25,UPI,UPI-RAPARTI SRIHARI-LIBERTYSRIHARI@OKICI CI-BKID0008627-049853295645-PAYMENT FROM PHONE,0000049853295645,0.0,52000.0,12894.14
12/05/25,UPI,UPI-MOHD AHMED ALI-MOHD.AHMED199819@OKAX IS-UTIB0001808-549839823209-UPI,0000549839823209,250.0,0.0,13144.14
12/05/25,UPI,UPI-JAY PRAKASH SAH-JPKUMAR852135@OKSBI -SBIN0014334-513235214753-UPI,0000513235214753,0.0,1000.0,12144.14
12/05/25,UPI,UPI-MADHU SUDHAN GHODKE-MADHUSUDHANGHOD KE-2@OKSBI-SBIN0005895-513243415508-UPI,0000513243415508,0.0,1000.0,11144.14
12/05/25,UPI,UPI-MADHU SUDHAN GHODKE-MADHUSUDHANGHOD KE-2@OKSBI-SBIN0005895-513257630170-UPI,0000513257630170,0.0,150.0,10994.14
12/05/25,UPI,UPI-M MADHU YADAV-9985065404-2@AXL-SBIN 0006645-654396370919-PAYMENT FROM PHONE,0000654396370919,0.0,600.0,10394.14
12/05/25,UPI,UPI-LIBERTYSRIHARIOKICIC-LIBERTYSRIHARI@ OKICICI-BKID0008627-513284415582-UPI,0000513284415582,0.0,1300.0,9094.14
12/05/25,IMPS,IMPS-513221343730-M MADHU YADAV-KKBK-XXX XXX7813-CASH,0000513221343730,0.0,4000.0,5094.14
12/05/25,UPI,UPI-JIO RECHARGE-JIOINAPPDIRECT@YBL-YESB 0YBLUPI-348333656818-PAYMENT FROM PHONE,0000348333656818,0.0,19.0,5075.14
12/05/25,UPI,UPI-RAPARTHI SRI HARI-9493207195-2@YBL-K KBK0000563-384595593907-PAYMENT FROM PHO NE,0000384595593907,50000.0,0.0,55075.14
12/05/25,UPI,UPI-RAPARTI SRIHARI-9493207195@YBL-BKID0 008627-618457488094-PAYMENT FROM PHONE,0000618457488094,50000.0,0.0,105075.14
13/05/25,UPI,UPI-NALLAMOTHU SIVAJI GA-SIVAJI.LIC@OKAX IS-UTIB0000881-513394638124-UPI,0000513394638124,0.0,20345.0,84730.14
13/05/25,UPI,UPI-B SUMAN GOUD-9553484848@YBL-KKBK000 7451-705165013478-PAYMENT FROM PHONE,0000705165013478,0.0,6000.0,78730.14
13/05/25,UPI,UPI-M ANIL YADAV-ANILYADAV63473-1@OKSBI- UBIN0803219-513352140373-RENU AKKA AND A MMA,0000513352140373,0.0,12000.0,66730.14
13/05/25,POS,CASH DEPOSIT-416021XXXXXX2657-BARKATPURA,0000000000001497,92000.0,0.0,158730.14
13/05/25,POS,CASH DEPOSIT-416021XXXXXX2657-BARKATPURA,0000000000001499,13500.0,0.0,172230.14
13/05/25,UPI,UPI-ZERODHA BROKING LTD-ZERODHABROKING@H DFCBANK-HDFC0MERUPI-513314138647-3771242 920194822 Z,0000513314138647,0.0,50051.0,122179.14
13/05/25,UPI,UPI-ANGEL ONE LIMITED-ANGELONENSE@ICICI- ICIC0DC0099-513383651979-PAYINGANGELONE,0000513383651979,0.0,10000.0,112179.14
13/05/25,IMPS,IMPS-513309314962-M MADHU YADAV-KKBK-XXX XXX7813-CASH,0000513309314962,0.0,10000.0,102179.14
13/05/25,UPI,UPI-SANTHOSHA ARRA-SANTHU.SANTHOSHA2004@ OKHDFCBANK-HDFC0000562-104746262651-UPI,0000104746262651,6000.0,0.0,108179.14
13/05/25,UPI,UPI-LIBERTYSRIHARIOKICIC-LIBERTYSRIHARI@ OKICICI-BKID0008627-513339894783-UPI,0000513339894783,0.0,650.0,107529.14
13/05/25,UPI,UPI-LIBERTYSRIHARIOKICIC-LIBERTYSRIHARI@ OKICICI-BKID0008627-513378674853-UPI,0000513378674853,0.0,1300.0,106229.14
13/05/25,UPI,UPI-VADICHERLA PRADEEP K-9293555325-3@YB L-HDFC0001635-372916194084-PAYMENT FROM PHONE,0000372916194084,0.0,1300.0,104929.14
14/05/25,UPI,UPI-ANGEL ONE LIMITED-ANGELONENSE@ICICI- ICIC0DC0099-513448583472-PAYINGANGELONE,0000513448583472,0.0,15000.0,89929.14
14/05/25,UPI,UPI-ANGEL ONE LIMITED-ANGELONENSE@ICICI- ICIC0DC0099-513423196674-PAYINGANGELONE,0000513423196674,0.0,70000.0,19929.14
14/05/25,UPI,UPI-ZERODHA BROKING LTD-ZERODHABROKING@H DFCBANK-HDFC0MERUPI-513427899702-9614682 861801284 Z,0000513427899702,0.0,4000.0,15929.14
14/05/25,UPI,UPI-M ANIL YADAV-ANILYADAV63473-1@OKSBI- UBIN0803219-550003103224-UPI,0000550003103224,0.0,6000.0,9929.14
14/05/25,UPI,UPI-ZERODHA BROKING LTD-ZERODHABROKING@H DFCBANK-HDFC0MERUPI-550031900425-6990801 516071734 Z,0000550031900425,0.0,4000.0,5929.14
14/05/25,UPI,UPI-MR RAVI TEJA POTHAR-RAVITEJAYADAV95 28@OKHDFCBANK-CBIN0280808-550070842582-U PI,0000550070842582,0.0,1500.0,4429.14
14/05/25,UPI,UPI-MOHD AHMED ALI-AQUA.AHMED98@AXL-UTIB 0001808-019389972255-PAYMENT FROM PHONE,0000019389972255,180.0,0.0,4609.14
14/05/25,UPI,UPI-LIBERTYSRIHARIOKICIC-LIBERTYSRIHARI@ OKICICI-BKID0008627-550037343952-UPI,0000550037343952,0.0,1300.0,3309.14
14/05/25,UPI,UPI-LIBERTYSRIHARIOKICIC-LIBERTYSRIHARI@ OKICICI-BKID0008627-550053840601-UPI,0000550053840601,0.0,650.0,2659.14
15/05/25,NEFT,NEFT CR-YESB0000001-ZERODHA BROKING LTD- DSCNB A/C-MUKKERLA MADHU YADAV-YESBN1202 736353 5051500736353,YESBN12025051500,25000.0,0.0,27659.14
15/05/25,UPI,UPI-T NITESH SINGH-7093335756@YBL-BARB0H IMHYD-321007968195-PAYMENT FROM PHONE,0000321007968195,0.0,20000.0,7659.14
15/05/25,UPI,UPI-MOHD PASHA MIYA-8074523914@YBL-LAVB0 000572-911166385725-PAYMENT FROM PHONE,0000911166385725,0.0,600.0,7059.14
15/05/25,POS,CASH DEPOSIT-416021XXXXXX2657-BARKATPURA,0000000000001873,49500.0,0.0,56559.14
15/05/25,UPI,UPI-MUKKERLA GEETA SUDHA-GEETHAMUKKERLA- 1@OKAXIS-KKBK0007463-550138067327-UPI,0000550138067327,0.0,47000.0,9559.14
15/05/25,UPI,UPI-M MADHU YADAV-9985065404-2@AXL-SBIN 0006645-907630824885-PAYMENT FROM PHONE,0000907630824885,2400.0,0.0,11959.14
15/05/25,UPI,UPI-PSATISH-ADARSH.PRINTERS999@OKHDFCBAN K-PUNB0362800-550104875081-UPI,0000550104875081,0.0,3000.0,8959.14
15/05/25,UPI,UPI-SANJAY SAGAR-8595942809@AXL-UTIB0003 156-623932783888-PAYMENT FROM PHONE,0000623932783888,1000.0,0.0,9959.14
15/05/25,,ACH D- LIC OF INDIA-6577926590525,0000008024167135,0.0,2488.0,7471.14
15/05/25,UPI,UPI-KOLLAPURAM MALLIKARJ-MALLIKARJUNKOLA PURAM@OKSBI-HDFC0000218-513576818829-UPI,0000513576818829,0.0,200.0,7271.14
15/05/25,UPI,UPI-MADHU SUDHAN GHODKE-MADHUSUDHANGHOD KE@AXL-SBIN0005895-466180886783-PAYMENT FROM PHONE,0000466180886783,250.0,0.0,7521.14
15/05/25,UPI,UPI-LIBERTYSRIHARIOKICIC-LIBERTYSRIHARI@ OKICICI-BKID0008627-513592311090-UPI,0000513592311090,0.0,1300.0,6221.14
15/05/25,UPI,UPI-LIBERTYSRIHARIOKICIC-LIBERTYSRIHARI@ OKICICI-BKID0008627-513556708266-UPI,0000513556708266,0.0,650.0,5571.14
15/05/25,UPI,UPI-JAYADEEPA M S-BHARATPE.90069770319@F BPE-FDRL0001382-513530915838-PAY TO BHAR ATPE ME,0000513530915838,0.0,50.0,5521.14
15/05/25,NEFT,NEFT CR-ICIC0099999-ANGEL ONE LIMITED-MU KKERLA MADHU YADAV-ICICN220250515425696,ICICN22025051542,27000.0,0.0,32521.14
15/05/25,UPI,UPI-M ANIL YADAV-ANILYADAV63473-1@OKSBI- UBIN0803219-513515005034-UPI,0000513515005034,0.0,7500.0,25021.14
16/05/25,UPI,UPI-JURRU RAHUL YADAV-8099997709@PTSBI- SBIN0007641-422010114532-PAYMENT FROM PH ONE,0000422010114532,0.0,10000.0,15021.14
16/05/25,UPI,UPI-A LAXMI-Q655807646@YBL-YESB0YBLUPI-5 13661229978-UPI,0000513661229978,0.0,20.0,15001.14
16/05/25,UPI,UPI-KANAKA LAXMI FOODS-Q412037241@YBL-YE SB0YBLUPI-513647150211-UPI,0000513647150211,0.0,580.0,14421.14
16/05/25,UPI,UPI-NUTAN MEDICAL HALL-7337557229@OKBIZA XIS-UTIB0000553-513601380395-UPI,0000513601380395,0.0,104.0,14317.14
16/05/25,UPI,UPI-HP PETROL PUMP PETR-Q139482159@YBL- YESB0YBLUPI-513634868681-UPI,0000513634868681,0.0,250.0,14067.14
16/05/25,UPI,UPI-MR BHAIRAVA SRIKANTH-9293555325-5@YB L-CBIN0284811-883295272625-PAYMENT FROM PHONE,0000883295272625,0.0,1300.0,12767.14
16/05/25,UPI,UPI-MOHD PASHA MIYA-8074523914@YBL-LAVB0 000572-077640268340-PAYMENT FROM PHONE,0000077640268340,0.0,900.0,11867.14
16/05/25,UPI,UPI-LIBERTYSRIHARIOKICIC-LIBERTYSRIHARI@ OKICICI-BKID0008627-513660271652-UPI,0000513660271652,0.0,1300.0,10567.14
16/05/25,IMPS,IMPS-513620334022-M MADHU YADAV-KKBK-XXX XXX7813-CASH,0000513620334022,0.0,1000.0,9567.14
16/05/25,UPI,UPI-MUKKERLA GEETA SUDHA-GEETHAMUKKERLA- 1@OKAXIS-KKBK0007463-513695637973-UPI,0000513695637973,25000.0,0.0,34567.14
16/05/25,IMPS,IMPS-513621340315-M MADHU YADAV-KKBK-XXX XXX7813-CASH,0000513621340315,0.0,15000.0,19567.14
16/05/25,NEFT,NEFT CR-ICIC0099999-ANGEL ONE LIMITED-MU KKERLA MADHU YADAV-ICICN220250516435881,ICICN22025051643,15000.0,0.0,34567.14
17/05/25,UPI,UPI-B VINOD KUMAR-BALERAOVINOD077@OKSBI- CNRB0000033-513711778285-UPI,0000513711778285,0.0,4000.0,30567.14
17/05/25,UPI,UPI-MOHD SHAFEEQ HUSSAIN-PAYTMQR67Y1LP@P TYS-YESB0PTMUPI-513751880936-UPI,0000513751880936,0.0,75.0,30492.14
17/05/25,UPI,UPI-MURALIKRISHNA VEGETA-GPAY-1124438713 1@OKBIZAXIS-UTIB0000553-513779087069-UPI,0000513779087069,0.0,340.0,30152.14
17/05/25,UPI,UPI-M ARVIND-ARVINDYADAV69552@OKAXIS-K KBK0007473-513747185669-UPI,0000513747185669,0.0,1400.0,28752.14
17/05/25,UPI,UPI-MR MARYPEDDY YADAIAH-PAYTMQR1QEBB0LQ 0U@PAYTM-YESB0PTMUPI-550374902137-UPI,0000550374902137,0.0,60.0,28692.14
17/05/25,UPI,UPI-AMIT CHARAN-PAYTMQR6F2KJQ@PTYS-YESB0 PTMUPI-513772786761-UPI,0000513772786761,0.0,25.0,28667.14
17/05/25,UPI,UPI-VANAMALA VIJAYA KUMA-PAYTMQR6ADUWW@P TYS-YESB0PTMUPI-513751698790-UPI,0000513751698790,0.0,20.0,28647.14
17/05/25,UPI,UPI-S S TRADERS-Q083701578@YBL-YESB0YBLU PI-550327204817-UPI,0000550327204817,0.0,20.0,28627.14
17/05/25,IMPS,IMPS-513719319637-M MADHU YADAV-KKBK-XXX XXX7813-CASH,0000513719319637,0.0,5000.0,23627.14
18/05/25,UPI,UPI-8309617327PTYES-8309617327@PTYES-FDR L0001332-550430955000-UPI,0000550430955000,0.0,1000.0,22627.14
18/05/25,UPI,UPI-A NARESH KUMAR-Q749466560@YBL-YESB0Y BLUPI-550472169864-UPI,0000550472169864,0.0,24.0,22603.14
18/05/25,UPI,UPI-M MADHU YADAV-9985065404-2@AXL-SBIN 0006645-380244177210-PAYMENT FROM PHONE,0000380244177210,10000.0,0.0,32603.14
18/05/25,UPI,UPI-UPMOVE CAPITAL PRIVA-UPMOVECAPITALPR 321112.RZP@AXISBANK-UTIB0000100-16582916 1385-POWERED BY SMARTCO,0000165829161385,0.0,28527.54,4075.6
19/05/25,UPI,UPI-TIRIVISETTY SATYANAR-Q628175389@YBL- YESB0YBLUPI-513986200354-UPI,0000513986200354,0.0,50.0,4025.6
19/05/25,UPI,UPI-JURRU RAHUL YADAV-Q758292524@YBL-YE SB0YBLUPI-513933402719-UPI,0000513933402719,0.0,30.0,3995.6
19/05/25,UPI,UPI-A LAXMI-Q655807646@YBL-YESB0YBLUPI-5 13999907160-UPI,0000513999907160,0.0,20.0,3975.6
19/05/25,UPI,UPI-MEERPETI MURALI-PAYTMQR6F46PJ@PTYS-Y ESB0PTMUPI-513949206352-UPI,0000513949206352,0.0,100.0,3875.6
19/05/25,UPI,UPI-COMMISSIONER ESD CKP-PAYTM-83098327@ PTYS-YESB0PTMUPI-513995307447-UPI,0000513995307447,0.0,35.0,3840.6
19/05/25,UPI,UPI-COMMISSIONER ESD CKP-PAYTM-83098327@ PTYS-YESB0PTMUPI-513961813375-UPI,0000513961813375,0.0,35.0,3805.6
19/05/25,UPI,UPI-MARGAM VANI-VANIMARGAM510@OKSBI-SBI N0021100-513905706389-UPI,0000513905706389,25000.0,0.0,28805.6
19/05/25,IMPS,IMPS-513916370395-SRIDEVI JT1-ICIC-XXXXX XXX3198-CASH,0000513916370395,0.0,14000.0,14805.6
19/05/25,UPI,UPI-TINKUPRADEEP1986OKIC-TINKUPRADEEP198 6@OKICICI-IBKL0000594-513967433099-UPI,0000513967433099,0.0,4000.0,10805.6
19/05/25,UPI,UPI-NATHI VEERAIAH-PAYTMQR6ATFBV@PTYS-YE SB0PTMUPI-513976346190-UPI,0000513976346190,0.0,30.0,10775.6
19/05/25,UPI,UPI-MADHU SUDHAN GHODKE-MADHUSUDHANGHOD KE-2@OKSBI-SBIN0005895-513932750613-UPI,0000513932750613,0.0,300.0,10475.6
19/05/25,UPI,UPI-LIBERTYSRIHARIOKICIC-LIBERTYSRIHARI@ OKICICI-BKID0008627-513948660332-UPI,0000513948660332,0.0,650.0,9825.6
19/05/25,UPI,UPI-LIBERTYSRIHARIOKICIC-LIBERTYSRIHARI@ OKICICI-BKID0008627-513900558549-UPI,0000513900558549,0.0,1300.0,8525.6
19/05/25,UPI,UPI-VADICHERLA PRADEEP K-9293555325-3@YB L-HDFC0001635-799394805436-PAYMENT FROM PHONE,0000799394805436,0.0,1300.0,7225.6
19/05/25,NEFT,NEFT CR-ICIC0099999-ANGEL ONE LIMITED-MU KKERLA MADHU YADAV-ICICN220250519451530,ICICN22025051945,20000.0,0.0,27225.6
19/05/25,UPI,UPI-T NITESH SINGH-7093335756@YBL-BARB0H IMHYD-630089512863-PAYMENT FROM PHONE,0000630089512863,0.0,20000.0,7225.6
20/05/25,UPI,UPI-MUKKERLA GEETA SUDHA-GEETHAMUKKERLA- 1@OKAXIS-KKBK0007463-514061453509-UPI,0000514061453509,9000.0,0.0,16225.6
20/05/25,NEFT,NEFT CR-UTIB0001165-NORTHERN ARC CAPTIAL LIMITED-M MADHU YADAV-UTIBN620250520536,UTIBN62025052053,21803.0,0.0,38028.6
20/05/25,UPI,UPI-VINODKUMAR TERALA-PAYTMQR6EPYGZ@PTY S-YESB0PTMUPI-514064677553-UPI,0000514064677553,0.0,50.0,37978.6
20/05/25,UPI,UPI-SYED FEROZ AHMED-BAJAJPAY.6879729.VO MW2A90@INDUS-INDB0MERCHA-514048469340-UP I,0000514048469340,0.0,30.0,37948.6
20/05/25,UPI,UPI-R VANDANA-Q274685384@YBL-YESB0YBLUP I-514004677399-UPI,0000514004677399,0.0,25.0,37923.6
20/05/25,UPI,UPI-BRANCH-BRANCHONLINE@YBL-YESB0YBLUPI- 514089680139-BRANCH PAYMENT,0000514089680139,0.0,1793.0,36130.6
20/05/25,UPI,UPI-MOHD SAIF-PAYTMQRFGZRP91W8H@PAYTM-YE SB0PTMUPI-514033980376-UPI,0000514033980376,0.0,323.0,35807.6
20/05/25,UPI,UPI-VANAMALA VIJAYA KUMA-PAYTMQR5F4F56@P TYS-YESB0PTMUPI-514006385051-UPI,0000514006385051,0.0,20.0,35787.6
20/05/25,UPI,UPI-PHONEPE-BBPSBP@AXL-UTIB0AXLUPI-19977 5179240-PAYMENT FROM PHONE,0000199775179240,0.0,4792.96,30994.64
20/05/25,UPI,UPI-PHONEPE-BBPSBP@AXL-UTIB0AXLUPI-28679 7092213-PAYMENT FROM PHONE,0000286797092213,0.0,7630.0,23364.64
20/05/25,UPI,UPI-PHONEPE-BBPSBP@AXL-UTIB0AXLUPI-98614 2187252-PAYMENT FROM PHONE,0000986142187252,0.0,6500.0,16864.64
20/05/25,UPI,UPI-MR RAVI TEJA POTHAR-RAVITEJAYADAV95 28@OKHDFCBANK-CBIN0280808-550658115000-U PI,0000550658115000,0.0,500.0,16364.64
20/05/25,NEFT,NEFT CR-ICIC0099999-ANGEL ONE LIMITED-MU KKERLA MADHU YADAV-ICICN220250520458783,ICICN22025052045,20000.0,0.0,36364.64
20/05/25,UPI,UPI-LIBERTYSRIHARIOKICIC-LIBERTYSRIHARI@ OKICICI-BKID0008627-550686623810-UPI,0000550686623810,0.0,650.0,35714.64
20/05/25,UPI,UPI-LIBERTYSRIHARIOKICIC-LIBERTYSRIHARI@ OKICICI-BKID0008627-550603023278-UPI,0000550603023278,0.0,1300.0,34414.64
20/05/25,UPI,UPI-MUKKERLA GEETA SUDHA-GEETHAMUKKERLA- 1@OKAXIS-KKBK0007463-550696328909-UPI,0000550696328909,15000.0,0.0,49414.64
20/05/25,UPI,UPI-MAHENDRA JALA-JALAMAHENDRA@OKAXIS-K KBK0007466-550640926857-UPI,0000550640926857,0.0,30000.0,19414.64
21/05/25,NEFT,NEFT CR-YESB0000001-RESILIENT INNOVATION S PVT LTD SETTL-M MADHU YADAV-YESBN12025,YESBN12025052100,270.0,0.0,19684.64
21/05/25,UPI,UPI-M MADHU YADAV-9985065404-2@AXL-SBIN 0006645-417302512857-PAYMENT FROM PHONE,0000417302512857,400.0,0.0,20084.64
21/05/25,UPI,UPI-MOHD PASHA MIYA-8074523914@YBL-LAVB0 000572-781850726985-PAYMENT FROM PHONE,0000781850726985,0.0,600.0,19484.64
21/05/25,UPI,UPI-GADDAM MURAHARI-Q935743136@YBL-YESB0 YBLUPI-550774122127-UPI,0000550774122127,0.0,40.0,19444.64
21/05/25,UPI,UPI-ANGEL ONE LIMITED-ANGELONENSE@ICICI- ICIC0DC0099-550730244920-PAYINGANGELONE,0000550730244920,0.0,7000.0,12444.64
21/05/25,UPI,UPI-BHARATHI BHARATHI-BHARTHI9573@YBL-S BIN0020701-550758641180-UPI,0000550758641180,0.0,6000.0,6444.64
21/05/25,UPI,UPI-VADICHERLA PRADEEP K-9293555325@AXL- UBIN0800619-734121861930-PAYMENT FROM PH ONE,0000734121861930,0.0,1300.0,5144.64
21/05/25,UPI,UPI-SRI BALAJI BAKERY-PAYTMQR6EC847@PTYS -YESB0PTMUPI-550716163322-UPI,0000550716163322,0.0,100.0,5044.64
21/05/25,UPI,UPI-RAJ KUMAR MEGHWAL-Q438004319@YBL-YES B0YBLUPI-550769863069-UPI,0000550769863069,0.0,20.0,5024.64
21/05/25,UPI,UPI-NEW GEETA MEDICAL HA-VYAPAR.17272069 0533@HDFCBANK-HDFC0MERUPI-550728181107-U PI,0000550728181107,0.0,45.0,4979.64
21/05/25,NEFT,NEFT CR-ICIC0099999-ANGEL ONE LIMITED-MU KKERLA MADHU YADAV-ICICN220250521467548,ICICN22025052146,26000.0,0.0,30979.64
21/05/25,UPI,UPI-M ANIL YADAV-ANILYADAV63473-1@OKSBI- UBIN0803219-550706984709-UPI,0000550706984709,0.0,13000.0,17979.64
21/05/25,UPI,UPI-LIBERTYSRIHARIOKICIC-LIBERTYSRIHARI@ OKICICI-BKID0008627-550737379809-UPI,0000550737379809,0.0,1300.0,16679.64
21/05/25,UPI,UPI-LIBERTYSRIHARIOKICIC-LIBERTYSRIHARI@ OKICICI-BKID0008627-550731087837-UPI,0000550731087837,0.0,650.0,16029.64
22/05/25,NEFT,NEFT CR-YESB0000001-RESILIENT INNOVATION S PVT LTD SETTL-M MADHU YADAV-YESBN12025,YESBN12025052202,19000.0,0.0,35029.64
22/05/25,UPI,UPI-NARESH KUMAR YADAV-NARESHKUMARYADAV 59426@OKSBI-SBIN0016778-550877794932-UPI,0000550877794932,0.0,200.0,34829.64
22/05/25,UPI,UPI-ANGEL ONE LIMITED-ANGELONENSE@ICICI- ICIC0DC0099-550825691106-PAYINGANGELONE,0000550825691106,0.0,10000.0,24829.64
22/05/25,UPI,UPI-ANGEL ONE LIMITED-ANGELONENSE@ICICI- ICIC0DC0099-514253603335-PAYINGANGELONE,0000514253603335,0.0,6000.0,18829.64
22/05/25,UPI,UPI-B RAJESHWARI-RAJESHWARIYADAV147-1@OK HDFCBANK-SBIN0RRDCGB-514291216310-UPI,0000514291216310,0.0,7476.0,11353.64
22/05/25,UPI,UPI-MOHD AHMED ALI-AQUA.AHMED98@AXL-UTIB 0001808-140427902424-PAYMENT FROM PHONE,0000140427902424,180.0,0.0,11533.64
22/05/25,UPI,UPI-MR RAVI TEJA POTHAR-RAVITEJAYADAV95 28@OKHDFCBANK-CBIN0280808-514282740026-U PI,0000514282740026,0.0,1000.0,10533.64
22/05/25,UPI,UPI-SRI SAI RESTAURANT A-PAYTM-80659624@ PTYS-YESB0PTMUPI-514242732977-UPI,0000514242732977,0.0,235.0,10298.64
22/05/25,UPI,UPI-GANTA SUJATHA-SUJATHAGANAT13@OKAXIS -SBIN0005895-514292666280-UPI,0000514292666280,1050.0,0.0,11348.64
22/05/25,UPI,UPI-KOYALKAR BABULLA-BOBBYKOYALKAR8374- 2@OKSBI-SBIN0020401-514245655812-UPI,0000514245655812,0.0,130.0,11218.64
22/05/25,NEFT,NEFT CR-ICIC0099999-ANGEL ONE LIMITED-MU KKERLA MADHU YADAV-ICICN220250522475976,ICICN22025052247,27461.46,0.0,38680.1
22/05/25,UPI,UPI-NEW GEETA MEDICAL HA-VYAPAR.17272069 0533@HDFCBANK-HDFC0MERUPI-514270735927-U PI,0000514270735927,0.0,49.0,38631.1
22/05/25,UPI,UPI-MUKKERLA GEETA SUDHA-GEETHAMUKKERLA- 1@OKAXIS-KKBK0007463-514288663412-UPI,0000514288663412,20000.0,0.0,58631.1
22/05/25,UPI,UPI-RAJENDRA PRASAD GHAN-RAJGHANKOT11-1@ OKAXIS-TSAB0000103-514276548679-UPI,0000514276548679,0.0,22125.0,36506.1
22/05/25,UPI,UPI-LIBERTYSRIHARIOKICIC-LIBERTYSRIHARI@ OKICICI-BKID0008627-514273757351-UPI,0000514273757351,0.0,1300.0,35206.1
22/05/25,UPI,UPI-LIBERTYSRIHARIOKICIC-LIBERTYSRIHARI@ OKICICI-BKID0008627-514257339771-UPI,0000514257339771,0.0,650.0,34556.1
22/05/25,UPI,UPI-VADICHERLA PRADEEP K-9293555325-3@YB L-HDFC0001635-833305381456-PAYMENT FROM PHONE,0000833305381456,0.0,1300.0,33256.1
22/05/25,IMPS,IMPS-514221385097-M MADHU YADAV-KKBK-XXX XXX7813-CASH,0000514221385097,0.0,14000.0,19256.1
23/05/25,UPI,UPI-B VINOD KUMAR-BALERAOVINOD077@OKSBI- CNRB0000033-514377665912-UPI,0000514377665912,0.0,5000.0,14256.1
23/05/25,,ANGEL ONE LIMI-253741041,0000505234752480,2538.54,0.0,16794.64
23/05/25,UPI,UPI-RAPARTI SRIHARI-LIBERTYSRIHARI@OKICI CI-BKID0008627-386954813850-PAYMENT FROM PHONE,0000386954813850,0.0,10000.0,6794.64
23/05/25,UPI,UPI-KOLLAPURAM MALLIKARJ-MALLIKARJUNKOLA PURAM@OKSBI-HDFC0000218-550970815140-UPI,0000550970815140,0.0,100.0,6694.64
23/05/25,IMPS,IMPS-514319355761-M MADHU YADAV-KKBK-XXX XXX7813-CASH,0000514319355761,0.0,3500.0,3194.64
24/05/25,UPI,UPI-BETHALA MOUNIKA-PAYTMQR6EW5HP@PTYS-Y ESB0PTMUPI-551041831101-UPI,0000551041831101,0.0,35.0,3159.64
24/05/25,UPI,UPI-MR MARYPEDDY YADAIAH-PAYTMQR12M8KT7Q ZP@PAYTM-YESB0PTMUPI-551095934821-UPI,0000551095934821,0.0,45.0,3114.64
24/05/25,UPI,UPI-AMBE SATISH-PAYTM.S14S1YS@PTY-YESB0M CHUPI-551037332143-UPI,0000551037332143,0.0,10.0,3104.64
24/05/25,UPI,UPI-VARJAPARTI NAVEEN KU-6301930510@IBL- INDB0001400-551012428394-UPI,0000551012428394,0.0,1200.0,1904.64
24/05/25,UPI,UPI-SUPRABATH TIFFINS-PAYTMQR5CYPRP@PTYS -YESB0PTMUPI-551006351598-UPI,0000551006351598,0.0,12.0,1892.64
24/05/25,UPI,UPI-MOHD PASHA MIYA-8074523914@YBL-LAVB0 000572-084943075940-PAYMENT FROM PHONE,0000084943075940,0.0,600.0,1292.64
24/05/25,UPI,UPI-MR VEMURI RAMESH-63037777981@AXL-IDI B000N015-982857884130-PAYMENT FROM PHONE,0000982857884130,1700.0,0.0,2992.64
24/05/25,UPI,UPI-VADICHERLA PRADEEP K-9293555325-3@YB L-HDFC0001635-207589889428-PAYMENT FROM PHONE,0000207589889428,0.0,1300.0,1692.64
24/05/25,UPI,UPI-M MADHU YADAV-M.MADHUYADAV261@AXL-KK BK0007463-008958835836-PAYMENT FROM PHON E,0000008958835836,0.0,1500.0,192.64
25/05/25,UPI,UPI-MRS R VANDANA-Q021206969@YBL-YESB0Y BLUPI-551102295251-UPI,0000551102295251,0.0,25.0,167.64
25/05/25,UPI,UPI-K S CONSTRUCTIONS-9393995648-2@AXL-A UBL0002591-265967705866-BARKATPURA 1ST F LO,0000265967705866,3500.0,0.0,3667.64
25/05/25,UPI,UPI-M MADHU YADAV-9985065404-2@YBL-SBIN 0006645-691098563219-PAYMENT FROM PHONE,0000691098563219,30000.0,0.0,33667.64
25/05/25,UPI,UPI-PHONEPE-BBPSBP@AXL-UTIB0AXLUPI-87116 2903706-PAYMENT FROM PHONE,0000871162903706,0.0,5014.5,28653.14
25/05/25,UPI,UPI-ANGEL LTD NSE-ANGELONENSE@HDFCBANK-H DFC0MERUPI-514507213296-PAYINGANGELONE,0000514507213296,0.0,20000.0,8653.14
25/05/25,UPI,UPI-VADICHERLA PRADEEP K-9293555325-3@YB L-HDFC0001635-141438028841-PAYMENT FROM PHONE,0000141438028841,0.0,1300.0,7353.14
25/05/25,UPI,UPI-LIBERTYSRIHARIOKICIC-LIBERTYSRIHARI@ OKICICI-BKID0008627-514580003430-UPI,0000514580003430,0.0,1300.0,6053.14
25/05/25,UPI,UPI-LIBERTYSRIHARIOKICIC-LIBERTYSRIHARI@ OKICICI-BKID0008627-514538320308-UPI,0000514538320308,0.0,650.0,5403.14
26/05/25,UPI,UPI-MANIKANTA TIFFIN CEN-GPAY-1125567948 7@OKBIZAXIS-UTIB0000553-514618551598-UPI,0000514618551598,0.0,45.0,5358.14
26/05/25,,ANGEL ONE LIMI-254058419,0000505267728504,1500.1,0.0,6858.24
26/05/25,UPI,UPI-M MADHU YADAV-9985065404-2@YBL-SBIN 0006645-310992457425-PAYMENT FROM PHONE,0000310992457425,7900.0,0.0,14758.24
26/05/25,UPI,UPI-GANTA SUJATHA-SUJATHAGANAT13@OKSBI- SBIN0005895-514606160671-UPI,0000514606160671,0.0,10000.0,4758.24
26/05/25,,ANGEL ONE LIMI-W24BFFUDCDZ9N7,0000505268496186,20000.0,0.0,24758.24
26/05/25,UPI,UPI-NATHI VEERAIAH-PAYTMQR6ATFBV@PTYS-YE SB0PTMUPI-514693979205-UPI,0000514693979205,0.0,40.0,24718.24
26/05/25,UPI,UPI-JURRU RAHUL YADAV-JRAHULYADAV29@OKS BI-SBIN0007641-514628592062-UPI,0000514628592062,0.0,3000.0,21718.24
26/05/25,UPI,UPI-KOLLAPURAM MALLIKARJ-MALLIKARJUNKOLA PURAM@OKSBI-HDFC0000218-514607488157-UPI,0000514607488157,0.0,150.0,21568.24
26/05/25,UPI,UPI-HANAMANT SHIVASHARAN-9845711128@YBL- SBIN0015263-552736099092-PAYMENT FROM PH ONE,0000552736099092,1200.0,0.0,22768.24
26/05/25,UPI,UPI-LIBERTYSRIHARIOKICIC-LIBERTYSRIHARI@ OKICICI-BKID0008627-514653491730-UPI,0000514653491730,0.0,1300.0,21468.24
26/05/25,IMPS,IMPS-514621366324-M MADHU YADAV-KKBK-XXX XXX7813-CASH,0000514621366324,0.0,3000.0,18468.24
26/05/25,UPI,UPI-ANGEL LTD NSE-ANGELONENSE@HDFCBANK-H DFC0MERUPI-551204101490-PAYINGANGELONE,0000551204101490,0.0,10000.0,8468.24
27/05/25,UPI,UPI-MOHD PASHA MIYA-8074523914@YBL-LAVB0 000572-866135609525-PAYMENT FROM PHONE,0000866135609525,0.0,600.0,7868.24
27/05/25,UPI,UPI-SHAIK RAZIA BEGUM-BHARATPE.900604871 52@FBPE-FDRL0001382-551338502879-PAY TO BHARATPE ME,0000551338502879,0.0,75.0,7793.24
27/05/25,POS,CASH DEPOSIT-XXXXXXXXXX1847-BARKATPURA,0000000000003951,24000.0,0.0,31793.24
27/05/25,POS,CASH DEPOSIT-XXXXXXXXXX1847-BARKATPURA,0000000000003954,24500.0,0.0,56293.24
27/05/25,POS,CASH DEPOSIT-XXXXXXXXXX1847-BARKATPURA,0000000000003957,10500.0,0.0,66793.24
27/05/25,UPI,UPI-ANGEL LTD NSE-ANGELONENSE@HDFCBANK-H DFC0MERUPI-551383314594-PAYINGANGELONE,0000551383314594,0.0,25000.0,41793.24
27/05/25,UPI,UPI-MAHENDRA JALA-JALAMAHENDRA@OKAXIS-K KBK0007466-551338707022-UPI,0000551338707022,0.0,32000.0,9793.24
27/05/25,UPI,UPI-LIBERTYSRIHARIOKICIC-LIBERTYSRIHARI@ OKICICI-BKID0008627-551367654696-UPI,0000551367654696,0.0,650.0,9143.24
27/05/25,UPI,UPI-LIBERTYSRIHARIOKICIC-LIBERTYSRIHARI@ OKICICI-BKID0008627-551326356280-UPI,0000551326356280,0.0,1300.0,7843.24
27/05/25,IMPS,IMPS-514720357630-M MADHU YADAV-KKBK-XXX XXX7813-CASH,0000514720357630,0.0,1000.0,6843.24
28/05/25,,ANGEL ONE LIMI-254557090,0000505281246165,8636.68,0.0,15479.92
28/05/25,UPI,UPI-KOLLAPURAM MALLIKARJ-MALLIKARJUNKOLA PURAM@OKSBI-HDFC0000218-551484286881-UPI,0000551484286881,0.0,100.0,15379.92
28/05/25,UPI,UPI-GANTA SUJATHA-SUJATHAGANAT13@OKSBI- SBIN0005895-551474997680-UPI,0000551474997680,0.0,5000.0,10379.92
28/05/25,UPI,UPI-ABHISHEK LADDHA-PAYTMQR6F036M@PTYS-Y ESB0PTMUPI-551490877458-UPI,0000551490877458,0.0,420.0,9959.92
28/05/25,UPI,UPI-JIO RECHARGE-JIOINAPPDIRECT1@AXL-UTI B0AXLUPI-406914768260-PAYMENT FROM PHONE,0000406914768260,0.0,352.0,9607.92
28/05/25,UPI,UPI-MARGAM VANI-VANIMARGAM510@OKSBI-SBI N0021100-514830242591-UPI,0000514830242591,30000.0,0.0,39607.92
28/05/25,UPI,UPI-RULOANS FINANCIAL SE-RFSPL1ESBZ@YESB ANK-YESB0000728-551406595976-PAY,0000551406595976,0.0,20641.18,18966.74
28/05/25,IMPS,IMPS-514817767083-AURO FINTECH PRIVATE-I DFB-XXXXXXX6249-PENNYDROP,0000514817767083,1.0,0.0,18967.74
28/05/25,UPI,UPI-LIBERTYSRIHARIOKICIC-LIBERTYSRIHARI@ OKICICI-BKID0008627-514877215623-UPI,0000514877215623,0.0,1300.0,17667.74
28/05/25,IMPS,IMPS-514820355725-M MADHU YADAV-KKBK-XXX XXX7813-CASH,0000514820355725,0.0,2000.0,15667.74
29/05/25,UPI,UPI-SHAIK MOHAMMED YOUSU-6304637500-G3EF @AXL-UBIN0803201-514957226707-UPI,0000514957226707,0.0,270.0,15397.74
29/05/25,NEFT,NEFT CR-YESB0000001-RULOANS FINANCIAL SE RVICES PVT LTD -M MADHU YADAV-YESBN12025,YESBN12025052905,21460.0,0.0,36857.74
29/05/25,UPI,UPI-GROWCAP CREDITWISE P-GROWCAPCREDITWI 228367.RZP@RXAIRTEL-AIRP0000011-51492843 6936-GROWCAPCREDITWISEP,0000514928436936,0.0,19050.0,17807.74
29/05/25,UPI,UPI-FDPL FINANCE-FDPLFINANCE@ICICI-ICIC0 DC0099-514982338834-UPI,0000514982338834,0.0,8209.75,9597.99
29/05/25,UPI,UPI-BRANCH INTERNATIONAL-BRANCHAPP@YESBA NK-YESB0000016-514941840014-BRANCH PAYME NT,0000514941840014,0.0,3586.0,6011.99
29/05/25,IMPS,IMPS-514911917551-AURO FINTECH PRIVATE-I DFB-XXXXXXX6249-PENNYDROP,0000514911917551,1.0,0.0,6012.99
29/05/25,NEFT,NEFT CR-YESB0000001-TYCOON CREDIT AND P ORTFOLIOS LIMIT-MUKKERLAMADHUYADAV-YESBN,YESBN12025052905,15395.2,0.0,21408.19
29/05/25,UPI,UPI-MUNTHA RAMESH YADAV-RAMEESHM6666@YBL -BKID0008604-994652853450-PAYMENT FROM P HONE,0000994652853450,0.0,6000.0,15408.19
29/05/25,UPI,UPI-MUNTHA RAMESH YADAV-RAMEESHM6666@YBL -BKID0008604-613158884372-PAYMENT FROM P HONE,0000613158884372,0.0,4000.0,11408.19
29/05/25,UPI,UPI-MR RAVI TEJA POTHAR-RAVITEJAYADAV95 28@OKHDFCBANK-CBIN0280808-514959262699-U PI,0000514959262699,0.0,1000.0,10408.19
29/05/25,IMPS,IMPS-514920374000-M MADHU YADAV-KKBK-XXX XXX7813-CASH,0000514920374000,0.0,3500.0,6908.19
30/05/25,UPI,UPI-UZMA BEGUM-PAYTM.S1BANCS@PTY-YESB0MC HUPI-515025090202-UPI,0000515025090202,0.0,40.0,6868.19
30/05/25,NEFT,NEFT CR-ICIC0SF0002-FDPL FINANCE PRIVATE LIMITED-MMADHUYADAV-ICICN42025053051535,ICICN42025053051,7292.0,0.0,14160.19
30/05/25,IMPS,IMPS-515013530675-BRANCH INTERNATIONAL-I CIC-XXXXXXXX0890-51890160 CF,0000515013530675,4705.0,0.0,18865.19
30/05/25,UPI,UPI-SHEKER NAIKOTI-Q749996981@YBL-YESB0 YBLUPI-551617731987-UPI,0000551617731987,0.0,1000.0,17865.19
30/05/25,UPI,UPI-MOHD AHMED ALI-AQUA.AHMED98@AXL-UTIB 0001808-976065900274-PAYMENT FROM PHONE,0000976065900274,160.0,0.0,18025.19
30/05/25,IMPS,IMPS-515020308177-M MADHU YADAV-KKBK-XXX XXX7813-CASH,0000515020308177,0.0,4000.0,14025.19
31/05/25,UPI,UPI-MOHD SHAFEEQ HUSSAIN-PAYTMQR66YL2Z@P TYS-YESB0PTMUPI-551701157713-UPI,0000551701157713,0.0,70.0,13955.19
31/05/25,UPI,UPI-MR MARYPEDDY YADAIAH-PAYTMQR12M8KT7Q ZP@PAYTM-YESB0PTMUPI-551758257166-UPI,0000551758257166,0.0,30.0,13925.19
31/05/25,UPI,UPI-K S CONSTRUCTIONS-9393995648-2@AXL-A UBL0002591-497423473367-PAYMENT FROM PHO NE,0000497423473367,20000.0,0.0,33925.19
31/05/25,UPI,UPI-VALLEPU SADANAND-9492569700@AXL-UBIN 0805335-870864008436-PAYMENT FROM PHONE,0000870864008436,0.0,24000.0,9925.19
31/05/25,,BHDFSUG0M9MZWU/BILLDKRATNAKARBANKLI,0002515185758536,0.0,6855.0,3070.19
31/05/25,UPI,UPI-AKSHAY CHINTALA-9849868607@YESCRED- CNRB0000033-551703353483-PAID VIA CRED,0000551703353483,1215.0,0.0,4285.19
31/05/25,UPI,UPI-MARGAM VANI-VANIMARGAM510@OKAXIS-SB IN0021100-551794212042-UPI,0000551794212042,50000.0,0.0,54285.19
31/05/25,UPI,UPI-MARGAM VANI-VANIMARGAM510@OKAXIS-SB IN0021100-551744514565-UPI,0000551744514565,49000.0,0.0,103285.19
31/05/25,UPI,UPI-VADICHERLA PRADEEP K-9293555325-3@YB L-HDFC0001635-509195733657-PAYMENT FROM PHONE,0000509195733657,0.0,1300.0,101985.19
31/05/25,UPI,UPI-LIBERTYSRIHARIOKICIC-LIBERTYSRIHARI@ OKICICI-BKID0008627-515157516367-UPI,0000515157516367,0.0,1300.0,100685.19
31/05/25,UPI,UPI-LIBERTYSRIHARIOKICIC-LIBERTYSRIHARI@ OKICICI-BKID0008627-515117814189-UPI,0000515117814189,0.0,650.0,100035.19
31/05/25,IMPS,IMPS-515121356818-M MADHU YADAV-KKBK-XXX XXX7813-CASH,0000515121356818,0.0,10000.0,90035.19
31/05/25,UPI,UPI-LAKSHMI APPALA-LAKSHME1202@OKSBI-SB IN0005895-515103723314-UPI,0000515103723314,2520.0,0.0,92555.19
01/06/25,UPI,UPI-ABBOJU HARISH-9110749456@YBL-SBIN00 20128-374856777733-PAYMENT FROM PHONE,0000374856777733,1395.0,0.0,93950.19
01/06/25,UPI,UPI-MURALIKRISHNA VEGETA-GPAY-1125407554 1@OKBIZAXIS-UTIB0000553-515256111022-UPI,0000515256111022,0.0,420.0,93530.19
01/06/25,UPI,UPI-SHAIK RAZIA BEGUM-BHARATPE.900604871 52@FBPE-FDRL0001382-515212511758-PAY TO BHARATPE ME,0000515212511758,0.0,50.0,93480.19
01/06/25,UPI,UPI-PANYAM MANJULA-MANJUPANYAM@OKSBI-SB IN0007641-515208176069-MILK,0000515208176069,2520.0,0.0,96000.19
01/06/25,UPI,UPI-K S CONSTRUCTIONS-9393995648-2@AXL-A UBL0002591-566870921978-PAYMENT FROM PHO NE,0000566870921978,4000.0,0.0,100000.19
01/06/25,UPI,UPI-8309617327PTYES-8309617327@PTYES-FDR L0001332-515224141784-UPI,0000515224141784,0.0,500.0,99500.19
01/06/25,UPI,UPI-BHUMIREDDY SIVA SANK-6303989848@AXL- KKBK0007455-056577308930-PAYMENT FROM PH ONE,0000056577308930,1000.0,0.0,100500.19
01/06/25,UPI,UPI-RAPARTI SRIHARI-LIBERTYSRIHARI@OKICI CI-BKID0008627-245262400946-PAYMENT FROM PHONE,0000245262400946,0.0,13000.0,87500.19
01/06/25,UPI,UPI-SRIRAGHAVENDRATIFFIN-PAYTMQR17U07CIZ 21@PAYTM-YESB0PTMUPI-515237556964-UPI,0000515237556964,0.0,12.0,87488.19
01/06/25,UPI,UPI-BUDUMURU BHARGAVI-BHARGAVIBUDUMURU@I BL-CNRB0000033-131102140443-PAYMENT FROM PHONE,0000131102140443,1575.0,0.0,89063.19
01/06/25,UPI,UPI-MAHENDAR KUMAR BAHET-MAHENDAR.BAHETI @OKICICI-ICIC0000040-515242863942-MILK,0000515242863942,2340.0,0.0,91403.19
01/06/25,UPI,UPI-MR JURRU RAHUL YADA-Q758292524@YBL- YESB0YBLUPI-515212953432-UPI,0000515212953432,0.0,120.0,91283.19
01/06/25,UPI,UPI-TORAN-PAYTMQR68KEWK@PTYS-YESB0PTMUPI -515290765600-UPI,0000515290765600,0.0,20.0,91263.19
01/06/25,UPI,UPI-M MADHU YADAV-9985065404-2@AXL-SBIN 0006645-458809819463-PAYMENT FROM PHONE,0000458809819463,2500.0,0.0,93763.19
01/06/25,UPI,UPI-K S CONSTRUCTIONS-9393995648-2@AXL-A UBL0002591-875270273832-MASON SANJAY PAY ME,0000875270273832,5000.0,0.0,98763.19
01/06/25,UPI,UPI-SANJAY UIKEY-7997088152@AXL-SBIN000 6962-976811082543-PAYMENT FROM PHONE,0000976811082543,0.0,5000.0,93763.19
01/06/25,UPI,UPI-ANGEL LTD NSE-ANGELONENSE@HDFCBANK-H DFC0MERUPI-515212761064-PAYINGANGELONE,0000515212761064,0.0,70000.0,23763.19
01/06/25,UPI,UPI-ZERODHA BROKING LTD-ZERODHABROKING@H DFCBANK-HDFC0MERUPI-515203567685-9696899 976989457 Z,0000515203567685,0.0,10500.0,13263.19
01/06/25,UPI,UPI-KEERTHI NEELI-SAI.TAANYA26@OKAXIS-BA RB0BARKAT-515296901911-UPI,0000515296901911,1900.0,0.0,15163.19
02/06/25,UPI,UPI-KOUR H-HARDEEPKOUR24@OKICICI-HSBC050 0002-515345699190-UPI,0000515345699190,1350.0,0.0,16513.19
02/06/25,UPI,UPI-MUKKERLA GEETA SUDHA-GEETHAMUKKERLA- 1@OKAXIS-KKBK0007463-515378486275-UPI,0000515378486275,0.0,6000.0,10513.19
02/06/25,UPI,UPI-RAPARTI SRIHARI-9493207195@YBL-BKID0 008627-658314539897-PAYMENT FROM PHONE,0000658314539897,0.0,10000.0,513.19
02/06/25,UPI,UPI-MADHU SUDHAN GHODKE-MADHUSUDHANGHOD KE@AXL-SBIN0005895-629569581303-PAYMENT FROM PHONE,0000629569581303,0.0,200.0,313.19
02/06/25,UPI,UPI-MARGAM VANI-VANIMARGAM510@OKSBI-SBI N0021100-515385332013-UPI,0000515385332013,41000.0,0.0,41313.19
02/06/25,UPI,UPI-FREO PAY-FREOPAY.PAYU@ICICI-ICIC0DC0 099-551964413528-UPIINTENT,0000551964413528,0.0,2213.02,39100.17
02/06/25,UPI,UPI-SAMUDHRALA MANASA-MANASA31961@AXL-SB IN0RRDCGB-331574682884-PAYMENT FROM PHON E,0000331574682884,2925.0,0.0,42025.17
02/06/25,UPI,UPI-MOHD PASHA MIYA-8074523914@YBL-LAVB0 000572-412081421090-PAYMENT FROM PHONE,0000412081421090,0.0,600.0,41425.17
02/06/25,UPI,UPI-PAWAN KUMAR BASANT-9903315499@AXISB- UBIN0825522-515329154667-PAID VIA CRED,0000515329154667,2400.0,0.0,43825.17
02/06/25,UPI,UPI-SASHIKALA BHANDARI-9032117972@AXL-S BIN0005895-665384064337-PAYMENT FROM PHO NE,0000665384064337,3375.0,0.0,47200.17
02/06/25,UPI,UPI-JIO RECHARGE-JIOINAPPDIRECT1@YBL-YES B0YBLUPI-814290870462-PAYMENT FROM PHONE,0000814290870462,0.0,352.0,46848.17
02/06/25,IMPS,IMPS-515316335086-M MADHU YADAV-KKBK-XXX XXX7813-CASH,0000515316335086,0.0,4000.0,42848.17
02/06/25,UPI,UPI-GOGA ELECTRONICS-9849436607@AXL-APMC 0000006-661446102523-PAYMENT FROM PHONE,0000661446102523,4600.0,0.0,47448.17
02/06/25,UPI,UPI-MR SHAMBHU YADAV-009975358104@IBL-ID IB000H599-197047227056-PAYMENT FROM PHON E,0000197047227056,1600.0,0.0,49048.17
02/06/25,UPI,UPI-VARTHYAVATH THIRUPA-THIRUPATI1981NA IK-1@OKSBI-SBIN0021009-515395016339-UPI,0000515395016339,2025.0,0.0,51073.17
02/06/25,UPI,UPI-BHAGWAN DAS MARDA-7816018341@YBL-KVB L0001443-433453570253-PAYMENT FROM PHONE,0000433453570253,1170.0,0.0,52243.17
02/06/25,UPI,UPI-MOHD AHMED ALI-AQUA.AHMED98@AXL-UTIB 0001808-413170076976-PAYMENT FROM PHONE,0000413170076976,270.0,0.0,52513.17
02/06/25,UPI,UPI-GOLLA MANIKANTA-SAIRAM70320537101@Y BL-SBIN0020650-212345196325-PAYMENT FROM PHONE,0000212345196325,1700.0,0.0,54213.17
02/06/25,UPI,UPI-GOLLA MANIKANTA-SAIRAM70320537101@Y BL-SBIN0020650-806059771691-PAYMENT FROM PHONE,0000806059771691,2000.0,0.0,56213.17
02/06/25,UPI,UPI-MADHU SUDHAN GHODKE-MADHUSUDHANGHOD KE@AXL-SBIN0005895-456869578973-PAYMENT FROM PHONE,0000456869578973,600.0,0.0,56813.17
02/06/25,UPI,UPI-KATEPALLY KSHEERAJA-KSHEERAJA96@OKIC ICI-ICIC0001122-551937636311-UPI,0000551937636311,1260.0,0.0,58073.17
02/06/25,NEFT,NEFT CR-ICIC0099999-ANGEL ONE LIMITED-MU KKERLA MADHU YADAV-ICICN220250602065958,ICICN22025060206,10000.0,0.0,68073.17
02/06/25,UPI,UPI-NAGRAJ-MUKKERLANAGRAJ@OKAXIS-UBIN080 3219-515329879601-UPI,0000515329879601,2600.0,0.0,70673.17
02/06/25,IMPS,IMPS-515321369235-M MADHU YADAV-KKBK-XXX XXX7813-CASH,0000515321369235,0.0,650.0,70023.17
02/06/25,UPI,UPI-ABSIPURAM KARUNAKAR-9000103377@YBL- SBIN0020083-680322939560-PAYMENT FROM PH ONE,0000680322939560,1720.0,0.0,71743.17
03/06/25,NEFT,NEFT CR-YESB0000001-ZERODHA BROKING LTD- DSCNB A/C-MUKKERLA MADHU YADAV-YESBN1202,YESBN12025060301,2000.0,0.0,73743.17
03/06/25,UPI,UPI-ABSIPURAM PRASOONA-9948434877@IBL-S BIN0020083-025284872493-PAYMENT FROM PHO NE,0000025284872493,1720.0,0.0,75463.17
03/06/25,UPI,UPI-SUHAS MADHUKAR CHAUD-DRSUHAS2003@OKH DFCBANK-KKBK0001367-105833233901-UPI,0000105833233901,2340.0,0.0,77803.17
03/06/25,UPI,UPI-MRS R VANDANA-Q021206969@YBL-YESB0Y BLUPI-552091554992-UPI,0000552091554992,0.0,45.0,77758.17
03/06/25,UPI,UPI-ANGEL LTD NSE-ANGELONENSE@HDFCBANK-H DFC0MERUPI-552031749698-PAYINGANGELONE,0000552031749698,0.0,19000.0,58758.17
03/06/25,UPI,UPI-ZERODHA BROKING LTD-ZERODHABROKING@H DFCBANK-HDFC0MERUPI-552007951111-5089540 478441195 Z,0000552007951111,0.0,11000.0,47758.17
03/06/25,UPI,UPI-SAKIR ANSARI-6305974760@AXL-BKID0008 606-090296865213-PAYMENT FROM PHONE,0000090296865213,0.0,300.0,47458.17
03/06/25,UPI,UPI-ZERODHA BROKING LTD-ZERODHABROKING@H DFCBANK-HDFC0MERUPI-552096756626-2727319 331048662 Z,0000552096756626,0.0,10000.0,37458.17
03/06/25,UPI,UPI-ABSIPURAM KARUNAKAR-KREYSUN@OKSBI-S BIN0020083-789535976041-PAYMENT FROM PHO NE,0000789535976041,0.0,1720.0,35738.17
03/06/25,UPI,UPI-RAPARTI SRIHARI-LIBERTYSRIHARI@OKICI CI-BKID0008627-904481526689-PAYMENT FROM PHONE,0000904481526689,0.0,10000.0,25738.17
03/06/25,UPI,UPI-GANTA SUJATHA-SUJATHAGANAT13@OKSBI- SBIN0005895-552061773560-UPI,0000552061773560,0.0,5000.0,20738.17
03/06/25,UPI,UPI-JOB PARIYAR-8074247480@IBL-SBIN0062 233-160540701036-PAYMENT FROM PHONE,0000160540701036,2865.0,0.0,23603.17
03/06/25,UPI,UPI-MOHD SAIF-PAYTMQRFGZRP91W8H@PAYTM-YE SB0PTMUPI-552096462388-UPI,0000552096462388,0.0,335.0,23268.17
03/06/25,UPI,UPI-RENU MANOJ-Q061921112@YBL-YESB0YBLUP I-552015161552-UPI,0000552015161552,0.0,23.0,23245.17
03/06/25,UPI,UPI-B SHIRISHA-SIRISHA0413@YBL-UBIN08007 67-865838504211-PAYMENT FROM PHONE,0000865838504211,2250.0,0.0,25495.17
03/06/25,UPI,UPI-MADHU SUDHAN GHODKE-MADHUSUDHANGHOD KE@YBL-SBIN0005895-121703575867-PAYMENT FROM PHONE,0000121703575867,1000.0,0.0,26495.17
03/06/25,UPI,UPI-G RAVINDER REDDY-SAFETYPACKAGING69@O KHDFCBANK-KKBK0007473-552091873144-UPI,0000552091873144,0.0,2050.0,24445.17
03/06/25,UPI,UPI-MOHAMMED HUSSAIN-MUHAMMED.HUSSAIN7@ IBL-SBIN0020335-227914052718-PAYMENT FRO M PHONE,0000227914052718,1800.0,0.0,26245.17
03/06/25,UPI,UPI-MUKKERLA GEETA SUDHA-GEETHAMUKKERLA- 1@OKAXIS-KKBK0007463-552037473258-UPI,0000552037473258,0.0,2300.0,23945.17
03/06/25,UPI,UPI-MOHD PASHA MIYA-8074523914@YBL-LAVB0 000572-798236377174-PAYMENT FROM PHONE,0000798236377174,0.0,600.0,23345.17
03/06/25,UPI,UPI-AIRTEL RECHARGE-AIRTELPREDIRECT2@AXL -UTIB0AXLUPI-335280625448-PAYMENT FROM P HONE,0000335280625448,0.0,492.0,22853.17
03/06/25,UPI,UPI-MEERPETI MURALI-PAYTMQR6F46PJ@PTYS-Y ESB0PTMUPI-552033799184-UPI,0000552033799184,0.0,760.0,22093.17
03/06/25,UPI,UPI-NAGRAJ-MUKKERLANAGRAJ@OKAXIS-UBIN080 3219-552037038310-UPI,0000552037038310,4000.0,0.0,26093.17
03/06/25,IMPS,IMPS-515420366494-M MADHU YADAV-KKBK-XXX XXX7813-CASH,0000515420366494,0.0,4000.0,22093.17
03/06/25,NEFT,NEFT CR-ICIC0099999-ANGEL ONE LIMITED-MU KKERLA MADHU YADAV-ICICN220250603079218,ICICN22025060307,20000.0,0.0,42093.17
04/06/25,NEFT,NEFT CR-YESB0000001-ZERODHA BROKING LTD- DSCNB A/C-MUKKERLA MADHU YADAV-YESBN1202 788941 5060401788941,YESBN12025060401,9500.0,0.0,51593.17
04/06/25,UPI,UPI-TIRIVISETTY SATYANAR-Q628175389@YBL- YESB0YBLUPI-515575114616-UPI,0000515575114616,0.0,30.0,51563.17
04/06/25,UPI,UPI-MONEYVIEW-MONEYVIEW.ESBZ@ICICI-ICIC0 DC0099-515513726428-PAY,0000515513726428,0.0,7460.0,44103.17
04/06/25,,ACH D- PROTIUM FINANCE LIMI-CW61KAEYV247,0000009093600599,0.0,28475.0,15628.17
04/06/25,UPI,UPI-NEELAM SETHI-NEELAMSETHI741@OKSBI-UB IN0534773-515500509641-UPI,0000515500509641,2080.0,0.0,17708.17
04/06/25,UPI,UPI-RAPARTI SRIHARI-LIBERTYSRIHARI@OKICI CI-BKID0008627-453292922721-PAYMENT FROM PHONE,0000453292922721,0.0,10000.0,7708.17
04/06/25,UPI,UPI-RAJESH C PATEL-CNKRAJESHPATEL@OKAXIS -KKBK0008052-552113794992-MAY MILK BILL,0000552113794992,1690.0,0.0,9398.17
04/06/25,UPI,UPI-RONAK NEELESH RUPARA-KUMARRONAK7@OKA XIS-HDFC0000545-515554414821-UPI,0000515554414821,950.0,0.0,10348.17
04/06/25,UPI,UPI-MR RAVI TEJA POTHAR-RAVITEJAYADAV95 28@OKHDFCBANK-CBIN0280808-515570749842-U PI,0000515570749842,0.0,1000.0,9348.17
04/06/25,UPI,UPI-MADHU SUDHAN GHODKE-MADHUSUDHANGHOD KE@AXL-SBIN0005895-397141285425-PAYMENT FROM PHONE,0000397141285425,500.0,0.0,9848.17
04/06/25,UPI,UPI-MOHIT SETHIA-MOHITSJ.1995@OKICICI- KKBK0007452-515576769291-UPI,0000515576769291,1010.0,0.0,10858.17
04/06/25,UPI,UPI-KOLLAPURAM MALLIKARJ-MALLIKARJUNKOLA PURAM@OKSBI-HDFC0000218-515519946880-UPI,0000515519946880,0.0,200.0,10658.17
04/06/25,UPI,UPI-VADICHERLA PRADEEP K-9293555325@AXL- UBIN0800619-355178118882-PAYMENT FROM PH ONE,0000355178118882,0.0,1300.0,9358.17
04/06/25,UPI,UPI-LIBERTYSRIHARIOKICIC-LIBERTYSRIHARI@ OKICICI-BKID0008627-515515560436-UPI,0000515515560436,0.0,1300.0,8058.17
04/06/25,NEFT,NEFT CR-ICIC0099999-ANGEL ONE LIMITED-MU KKERLA MADHU YADAV-ICICN220250604089803,ICICN22025060408,20000.0,0.0,28058.17
04/06/25,UPI,UPI-NEELAM SETHI-NEELAMSETHI741@OKAXIS-U BIN0534773-515585722450-UPI,0000515585722450,4540.0,0.0,32598.17
04/06/25,UPI,UPI-BHAGYA LAKSHIMI WINE-PAYTM.S19K5D0@P TY-YESB0MCHUPI-515594278008-UPI,0000515594278008,0.0,340.0,32258.17
05/06/25,NEFT,NEFT CR-YESB0000001-ZERODHA BROKING LTD- DSCNB A/C-MUKKERLA MADHU YADAV-YESBN1202,YESBN12025060501,10000.0,0.0,42258.17
05/06/25,UPI,UPI-CHAVALI LAVANYA-9490255943@YBL-CNRB0 000000-260805473468-PAYMENT FROM PHONE,0000260805473468,3740.0,0.0,45998.17
05/06/25,,ACH D- IKF HOME FINANCE LTD-050620250516,0000009173677882,0.0,22875.0,23123.17
05/06/25,UPI,UPI-B VINOD KUMAR-BALERAOVINOD077@OKSBI- CNRB0000033-552283913465-UPI,0000552283913465,0.0,5000.0,18123.17
05/06/25,UPI,UPI-BILLA S-9700452204-2@YBL-HSBC0500002 -713113586815-PAYMENT FROM PHONE,0000713113586815,1200.0,0.0,19323.17
05/06/25,UPI,UPI-G PRASHANTH-7702920675@AXL-UTIB00008 81-661625630241-PAYMENT FROM PHONE,0000661625630241,0.0,5000.0,14323.17
05/06/25,UPI,UPI-MARGAM VANI-VANIMARGAM510@OKSBI-SBI N0021100-515656680220-UPI,0000515656680220,50000.0,0.0,64323.17
05/06/25,,IB BILLPAY DR-HDFC92-434155XXXXXX1025,MB05152126647T17,0.0,10651.0,53672.17
05/06/25,UPI,UPI-MOHAMMED RASHEED-PAYTMQR64Y0US@PTYS- YESB0PTMUPI-552263304734-UPI,0000552263304734,0.0,28.0,53644.17
05/06/25,UPI,UPI-BALA KASHYAP-BALA.KASHYAP1@YBL-HDFC0 000126-631114376220-PAYMENT FROM PHONE,0000631114376220,840.0,0.0,54484.17
05/06/25,UPI,UPI-MOHD AHMED ALI-AQUA.AHMED98@AXL-UTIB 0001808-929479215786-PAYMENT FROM PHONE,0000929479215786,180.0,0.0,54664.17
05/06/25,UPI,UPI-MR RAVI TEJA POTHAR-RAVITEJAYADAV95 28@OKHDFCBANK-CBIN0280808-552237320565-U PI,0000552237320565,0.0,2000.0,52664.17
05/06/25,UPI,UPI-VADICHARLA LAVANYA-9293555325-2@YBL- UTIB0003574-112221759614-PAYMENT FROM PH ONE,0000112221759614,0.0,1300.0,51364.17
05/06/25,UPI,UPI-LIBERTYSRIHARIOKICIC-LIBERTYSRIHARI@ OKICICI-BKID0008627-552200119412-UPI,0000552200119412,0.0,1300.0,50064.17
05/06/25,UPI,UPI-LIBERTYSRIHARIOKICIC-LIBERTYSRIHARI@ OKICICI-BKID0008627-552251823836-UPI,0000552251823836,0.0,650.0,49414.17
05/06/25,UPI,UPI-MADHURI MARAM-LIPIKAMARAM@OKICICI-IC IC0000008-552204422430-UPI,0000552204422430,4230.0,0.0,53644.17
05/06/25,IMPS,IMPS-515620388597-M MADHU YADAV-KKBK-XXX XXX7813-CASH,0000515620388597,0.0,3500.0,50144.17
05/06/25,IMPS,IMPS-515620394650-M MADHU YADAV-KKBK-XXX XXX7813-CASH,0000515620394650,0.0,10000.0,40144.17
05/06/25,NEFT,NEFT CR-ICIC0099999-ANGEL ONE LIMITED-MU KKERLA MADHU YADAV-ICICN220250605101573,ICICN22025060510,10000.0,0.0,50144.17
05/06/25,UPI,UPI-ANGEL LTD NSE-ANGELONENSE@HDFCBANK-H DFC0MERUPI-552234639905-PAYINGANGELONE,0000552234639905,0.0,30000.0,20144.17
06/06/25,NEFT,NEFT CR-YESB0000001-ZERODHA BROKING LTD- DSCNB A/C-MUKKERLA MADHU YADAV-YESBN1202,YESBN12025060601,3000.0,0.0,23144.17
06/06/25,UPI,UPI-DAMODAR NAYAK-PAYTMQR6EC6Y9@PTYS-YES B0PTMUPI-552374044595-UPI,0000552374044595,0.0,290.0,22854.17
06/06/25,UPI,UPI-UZMA BEGUM-PAYTM.S1HF3D6@PTY-YESB0MC HUPI-552313748121-UPI,0000552313748121,0.0,40.0,22814.17
06/06/25,UPI,UPI-M ANIL YADAV-ANILYADAV63473-1@OKHDFC BANK-UBIN0803219-106002403260-UPI,0000106002403260,6460.0,0.0,29274.17
06/06/25,UPI,UPI-M ANIL YADAV-ANILYADAV63473-1@OKSBI- UBIN0803219-552394952322-UPI,0000552394952322,0.0,200.0,29074.17
06/06/25,UPI,UPI-ZERODHA BROKING LTD-ZERODHABROKING@H DFCBANK-HDFC0MERUPI-552346056032-8131625 505754830 Z,0000552346056032,0.0,1000.0,28074.17
06/06/25,UPI,UPI-JANARDHAN FILL POINT-BPCLJANARDHANFI LLKACHIGUDA0008@YBL-YESB0YBLUPI-55239825 8781-UPI,0000552398258781,0.0,350.0,27724.17
06/06/25,UPI,UPI-MOHAMMED ALI KHAN-Q256549944@YBL-YES B0YBLUPI-552312861083-UPI,0000552312861083,0.0,40.0,27684.17
06/06/25,UPI,UPI-BHARATHI BHARATHI-BHARTHI9573@YBL-S BIN0020701-552337073049-UPI,0000552337073049,0.0,6000.0,21684.17
06/06/25,UPI,UPI-RAPARTI SRIHARI-LIBERTYSRIHARI@OKICI CI-BKID0008627-235980613969-PAYMENT FROM PHONE,0000235980613969,0.0,1500.0,20184.17
06/06/25,UPI,UPI-KHALED SAIF ULLAH SI-9182049585@AXL- FINO0000001-156952418069-PAYMENT FROM PH ONE,0000156952418069,0.0,5000.0,15184.17
06/06/25,IMPS,IMPS-515718323037-M MADHU YADAV-KKBK-XXX XXX7813-CASH,0000515718323037,0.0,5000.0,10184.17
06/06/25,IMPS,IMPS-515727241760-R K BANSAL FINANCE PRI VATE LIM-RATN-XXXXXXXX8321-RKBANSALFINAN CEPLTDFUND,0000515727241760,17640.0,0.0,27824.17
06/06/25,IMPS,IMPS-515720371415-M MADHU YADAV-KKBK-XXX XXX7813-CASH,0000515720371415,0.0,3000.0,24824.17
06/06/25,NEFT,NEFT CR-ICIC0099999-ANGEL ONE LIMITED-MU KKERLA MADHU YADAV-ICICN220250606119212,ICICN22025060611,25000.0,0.0,49824.17
06/06/25,UPI,UPI-MARGAM VANI-VANIMARGAM510@OKAXIS-SB IN0021100-552330570098-UPI,0000552330570098,60000.0,0.0,109824.17
07/06/25,UPI,UPI-ABHIRUCHI YESHWANT P-ABHIRUCHIPATKI2 204-YAHOO.CO.IN-1@OKAXIS-UTIB0000048-552 410898026-UPI,0000552410898026,101.0,0.0,109925.17
07/06/25,UPI,UPI-MOHD SHAFEEQ HUSSAIN-PAYTMQR66YL2Z@P TYS-YESB0PTMUPI-515865422061-UPI,0000515865422061,0.0,72.0,109853.17
07/06/25,UPI,UPI-MR MARYPEDDY YADAIAH-PAYTMQR12M8KT7Q ZP@PAYTM-YESB0PTMUPI-515805712721-UPI,0000515805712721,0.0,150.0,109703.17
07/06/25,UPI,UPI-KOLLAPURAM MALLIKARJ-MALLIKARJUNKOLA PURAM@OKSBI-HDFC0000218-515892043569-UPI,0000515892043569,0.0,1000.0,108703.17
07/06/25,UPI,UPI-SWISSCASTLEBAKERY NA-VYAPAR.17198633 3553@HDFCBANK-HDFC0MERUPI-515858755591-U PI,0000515858755591,0.0,272.0,108431.17
07/06/25,UPI,UPI-LIBERTYSRIHARIOKICIC-LIBERTYSRIHARI@ OKICICI-BKID0008627-515881777580-UPI,0000515881777580,0.0,1300.0,107131.17
07/06/25,UPI,UPI-LIBERTYSRIHARIOKICIC-LIBERTYSRIHARI@ OKICICI-BKID0008627-515819671140-UPI,0000515819671140,0.0,650.0,106481.17
07/06/25,UPI,UPI-VADICHERLA PRADEEP K-9293555325-3@YB L-HDFC0001635-605671507462-PAYMENT FROM PHONE,0000605671507462,0.0,1300.0,105181.17
08/06/25,UPI,UPI-MOHD AHMED ALI-AQUA.AHMED98@AXL-UTIB 0001808-845325982730-PAYMENT FROM PHONE,0000845325982730,180.0,0.0,105361.17
08/06/25,UPI,UPI-K S CONSTRUCTIONS-ASHWINYADAV85-1@OK SBI-AUBL0002591-418839866542-PAYMENT FRO M PHONE,0000418839866542,0.0,10000.0,95361.17
08/06/25,UPI,UPI-BHARATHI BHARATHI-BHARTHI9573@YBL-S BIN0020701-515926783616-UPI,0000515926783616,0.0,6000.0,89361.17
08/06/25,UPI,UPI-MUKKERLA GEETA SUDHA-GEETHAMUKKERLA- 1@OKAXIS-KKBK0007463-679156355403-PAYMEN T FROM PHONE,0000679156355403,0.0,50000.0,39361.17
08/06/25,UPI,UPI-VADICHERLA PRADEEP K-9293555325-3@YB L-HDFC0001635-717455164026-PAYMENT FROM PHONE,0000717455164026,0.0,1300.0,38061.17
08/06/25,,IB BILLPAY DR-HDFC92-434155XXXXXX1025,MB08124843944T22,0.0,2500.0,35561.17
08/06/25,UPI,UPI-MOHD PASHA MIYA-8074523914@YBL-LAVB0 000572-113563491605-PAYMENT FROM PHONE,0000113563491605,0.0,800.0,34761.17
08/06/25,UPI,UPI-ORUGANTI SRINIVAS RE-OSRINIVAS555@OK AXIS-UTIB0000426-552568810169-UPI,0000552568810169,1120.0,0.0,35881.17
08/06/25,UPI,UPI-MR RAVI TEJA POTHAR-RAVITEJAYADAV95 28@OKHDFCBANK-CBIN0280808-552563408016-U PI,0000552563408016,0.0,2000.0,33881.17
08/06/25,POS,CASH DEPOSIT-XXXXXXXXXX1847-KACHIGUDA,0000000000008484,19200.0,0.0,53081.17
08/06/25,POS,CASH DEPOSIT-XXXXXXXXXX1847-KACHIGUDA,0000000000008487,23000.0,0.0,76081.17
08/06/25,POS,CASH DEPOSIT-XXXXXXXXXX1847-KACHIGUDA,0000000000008490,8000.0,0.0,84081.17
08/06/25,IMPS,IMPS-515919316693-M MADHU YADAV-KKBK-XXX XXX7813-CASH,0000515919316693,0.0,56500.0,27581.17
09/06/25,UPI,UPI-MR JURRU RAHUL YADA-Q758292524@YBL- YESB0YBLUPI-552611335667-UPI,0000552611335667,0.0,60.0,27521.17
09/06/25,UPI,UPI-MECHARLA VENKATESH-MECHARLAVENKATE SH4@OKAXIS-KKBK0008362-552656748851-UPI,0000552656748851,1000.0,0.0,28521.17
09/06/25,UPI,UPI-TIRIVISETTY SATYANA-SATHISHREDDY648 61@AXL-SBIN0002731-552631330355-UPI,0000552631330355,0.0,30.0,28491.17
09/06/25,UPI,UPI-SOMALWAR SHRINIVAS-SOMALWAR73@OKSBI -SBIN0010356-516066700234-UPI,0000516066700234,2480.0,0.0,30971.17
09/06/25,UPI,UPI-ANGEL ONE LIMITED-ANGELONENSE@ICICI- ICIC0DC0099-552697753390-PAYINGANGELONE,0000552697753390,0.0,5000.0,25971.17
09/06/25,UPI,UPI-TRUE CREDITS PVT LTD-TRUECREDITS.PAY U@ICICI-ICIC0DC0099-552637445328-UPIINTE NT,0000552637445328,0.0,6821.0,19150.17
09/06/25,UPI,UPI-GANTA SUJATHA-SUJATHAGANAT13@OKSBI- SBIN0005895-552658965943-UPI,0000552658965943,0.0,6000.0,13150.17
09/06/25,UPI,UPI-SANTOSH DAS-8511790764@AXL-SBIN0012 917-552646771571-UPI,0000552646771571,0.0,60.0,13090.17
09/06/25,UPI,UPI-BHARATHI BHARATHI-BHARTHI9573@YBL-S BIN0020701-552603988289-UPI,0000552603988289,0.0,3000.0,10090.17
09/06/25,UPI,UPI-MOHD AHMED ALI-AQUA.AHMED98@AXL-UTIB 0001808-699476947181-PAYMENT FROM PHONE,0000699476947181,180.0,0.0,10270.17
09/06/25,UPI,UPI-JAYPRAKASH SAH-7903248774@PTHDFC-CNR B0000033-516001300936-UPI,0000516001300936,0.0,3000.0,7270.17
09/06/25,UPI,UPI-VADICHERLA PRADEEP K-9293555325@AXL- UBIN0800619-729672263581-PAYMENT FROM PH ONE,0000729672263581,0.0,1300.0,5970.17
09/06/25,UPI,UPI-MADHU SUDHAN GHODKE-MADHUSUDHANGHOD KE-2@OKSBI-SBIN0005895-552631185491-UPI,0000552631185491,0.0,250.0,5720.17
09/06/25,UPI,UPI-TORAN-PAYTMQR68KEWK@PTYS-YESB0PTMUPI -552651698336-UPI,0000552651698336,0.0,210.0,5510.17
09/06/25,UPI,UPI-LIBERTYSRIHARIOKICIC-LIBERTYSRIHARI@ OKICICI-BKID0008627-516018809501-UPI,0000516018809501,0.0,1300.0,4210.17
09/06/25,IMPS,IMPS-516021301072-M MADHU YADAV-KKBK-XXX XXX7813-CASH,0000516021301072,0.0,650.0,3560.17
10/06/25,NEFT,NEFT CR-FDRL0009993-BHARATPEPPG-M MADHU YADAV-FDRLN52025061033666997,FDRLN52025061033,10000.0,0.0,13560.17
10/06/25,UPI,UPI-TIRIVISETTY SATYANA-SATHISHREDDY648 61@AXL-SBIN0002731-516108537348-UPI,0000516108537348,0.0,30.0,13530.17
10/06/25,UPI,UPI-RAMINI LAXMAN-PAYTMQR6F3VN1@PTYS-YES B0PTMUPI-516111115623-UPI,0000516111115623,0.0,42.0,13488.17
10/06/25,,ANGEL ONE LIMI-256730229,0000506107520817,362.68,0.0,13850.85
10/06/25,UPI,UPI-BHARATHI BHARATHI-BHARTHI9573@YBL-S BIN0020701-516114031749-UPI,0000516114031749,0.0,6000.0,7850.85
10/06/25,UPI,UPI-GANTA SUJATHA-SUJATHAGANAT13@OKSBI- SBIN0005895-516179933895-UPI,0000516179933895,0.0,4000.0,3850.85
10/06/25,UPI,UPI-MR RAVI TEJA POTHAR-RAVITEJAYADAV95 28@OKHDFCBANK-CBIN0280808-516181254681-U PI,0000516181254681,0.0,1000.0,2850.85
10/06/25,UPI,UPI-JIO RECHARGE-JIOINAPPDIRECT1@AXL-UTI B0AXLUPI-144401484270-PAYMENT FROM PHONE,0000144401484270,0.0,19.0,2831.85
10/06/25,UPI,UPI-KARRA SATHISH-9293555325-7@AXL-BKID0 005707-064737563512-PAYMENT FROM PHONE,0000064737563512,0.0,1300.0,1531.85
10/06/25,UPI,UPI-LIBERTYSRIHARIOKICIC-LIBERTYSRIHARI@ OKICICI-BKID0008627-516170569632-UPI,0000516170569632,0.0,1300.0,231.85
11/06/25,UPI,UPI-MUKKERLA GEETA SUDHA-GEETHAMUKKERLA- 1@OKAXIS-KKBK0007463-552862516903-UPI,0000552862516903,25000.0,0.0,25231.85
11/06/25,UPI,UPI-LIBERTYSRIHARIOKICIC-LIBERTYSRIHARI@ OKICICI-BKID0008627-516249967002-UPI,0000516249967002,0.0,650.0,24581.85
11/06/25,UPI,UPI-M ANIL YADAV-ANILYADAV63473-1@OKSBI- UBIN0803219-516292768838-UPI,0000516292768838,0.0,600.0,23981.85
11/06/25,UPI,UPI-MOHD PASHA MIYA-8074523914@YBL-LAVB0 000572-674223721069-PAYMENT FROM PHONE,0000674223721069,0.0,600.0,23381.85
11/06/25,UPI,UPI-VADICHERLA BHARATHAM-99484335@YBL-HD FC0001635-433444125763-PAYMENT FROM PHON E,0000433444125763,60000.0,0.0,83381.85
11/06/25,UPI,UPI-SRI BALAJI BAKERY-PAYTMQR6EC847@PTYS -YESB0PTMUPI-516286789257-UPI,0000516286789257,0.0,55.0,83326.85
11/06/25,UPI,UPI-TUNIKI DEEPAK KUMAR-DEEPURAJAK24@AXL -HDFC0002657-852186253151-PAYMENT FROM P HONE,0000852186253151,50000.0,0.0,133326.85
11/06/25,UPI,UPI-MOHAMMAD AHMED-AHMEDPAILWAN1@YBL-HDF C0001635-516257690463-UPI,0000516257690463,0.0,15000.0,118326.85
11/06/25,UPI,UPI-ANGEL LTD NSE-ANGELONENSE@HDFCBANK-H DFC0MERUPI-516274578540-PAYINGANGELONE,0000516274578540,0.0,80000.0,38326.85
11/06/25,UPI,UPI-B RAYUDU-RAYUDU10-1@OKHDFCBANK-HDFC0 000042-106284062421-MILK AMT,0000106284062421,1050.0,0.0,39376.85
11/06/25,UPI,UPI-MEHFIL-PAYTM-75000139@PTYS-YESB0PTMU PI-516285391409-UPI,0000516285391409,0.0,176.0,39200.85
11/06/25,,NWD-416021XXXXXX2657-00916173-HYDERABAD,0000516214009394,0.0,1500.0,37700.85
11/06/25,UPI,UPI-RATNADEEP SUPERMARKE-PAYTM-64471141@ PTYS-YESB0PTMUPI-516263495112-UPI,0000516263495112,0.0,254.0,37446.85
11/06/25,UPI,UPI-K SHIVA VEGETABLES-BAJAJPAY.6879729. ATNVRPVJ@INDUS-INDB0MERCHA-552862405502- UPI,0000552862405502,0.0,75.0,37371.85
11/06/25,UPI,UPI-B SUMAN GOUD-9553484848@AXL-KKBK000 7451-451562790844-PAYMENT FROM PHONE,0000451562790844,0.0,6000.0,31371.85
11/06/25,UPI,UPI-VADICHERLA PRADEEP K-9293555325-3@YB L-HDFC0001635-362956053463-PAYMENT FROM PHONE,0000362956053463,0.0,1800.0,29571.85
11/06/25,UPI,UPI-A PAVANI YADAV-PAVANIYADAU39406@OKS BI-SBIN0020068-516201017895-UPI,0000516201017895,45000.0,0.0,74571.85
11/06/25,UPI,UPI-KOLLAPURAM MALLIKARJ-MALLIKARJUNKOLA PURAM@OKSBI-HDFC0000218-552867618597-UPI,0000552867618597,0.0,200.0,74371.85
11/06/25,UPI,UPI-MR MADHU SUDHAN GHO-MADHUSUDHANGHOD KE2@AXL-MAHB0000383-120200360940-PAYMENT FROM PHONE,0000120200360940,500.0,0.0,74871.85
11/06/25,UPI,UPI-A NARESH KUMAR-Q749466560@YBL-YESB0Y BLUPI-552859331677-UPI,0000552859331677,0.0,25.0,74846.85
11/06/25,UPI,UPI-LIBERTYSRIHARIOKICIC-LIBERTYSRIHARI@ OKICICI-BKID0008627-552811722803-UPI,0000552811722803,0.0,1300.0,73546.85
11/06/25,IMPS,IMPS-516221322415-M MADHU YADAV-KKBK-XXX XXX7813-CASH,0000516221322415,0.0,1000.0,72546.85
12/06/25,UPI,UPI-MR JURRU RAHUL YADA-Q758292524@YBL- YESB0YBLUPI-552927938897-UPI,0000552927938897,0.0,180.0,72366.85
12/06/25,UPI,UPI-MANE NAVNEETHA-PAYTMQR66O8TP@PTYS-YE SB0PTMUPI-552986427394-UPI,0000552986427394,0.0,30.0,72336.85
12/06/25,UPI,UPI-MUKKERLA GEETA SUDHA-GEETHAMUKKERLA- 1@OKAXIS-KKBK0007463-552904040205-UPI,0000552904040205,0.0,45000.0,27336.85
12/06/25,UPI,UPI-SRI BALAJI BAKERY-PAYTMQR6EC847@PTYS -YESB0PTMUPI-552974735892-UPI,0000552974735892,0.0,10.0,27326.85
12/06/25,UPI,UPI-MUKKERLA GEETA SUDHA-GEETHAMUKKERLA- 1@OKAXIS-KKBK0007463-552954455871-UPI,0000552954455871,0.0,15000.0,12326.85
12/06/25,UPI,UPI-MUKKERLA GEETA SUDHA-GEETHAMUKKERLA- 1@OKAXIS-KKBK0007463-516313508784-UPI,0000516313508784,900.0,0.0,13226.85
12/06/25,UPI,UPI-RAPARTI SRIHARI-LIBERTYSRIHARI@OKICI CI-BKID0008627-725225492570-PAYMENT FROM PHONE,0000725225492570,0.0,13000.0,226.85
12/06/25,UPI,UPI-YENNU VARUN KUMAR-PAYTMQRHE6JBRA242@ PAYTM-YESB0PTMUPI-552901456723-UPI,0000552901456723,0.0,40.0,186.85
12/06/25,UPI,UPI-SK ZEESHAN ALI-8919865492@NAVIAXIS-S BIN0061785-516386247072-PAID VIA NAVI UP I,0000516386247072,10.0,0.0,196.85
12/06/25,NEFT,NEFT CR-ICIC0099999-ANGEL ONE LIMITED-MU KKERLA MADHU YADAV-ICICN220250612190703,ICICN22025061219,55000.0,0.0,55196.85
12/06/25,UPI,UPI-VADICHERLA PRADEEP K-9293555325@AXL- UBIN0800619-501547990874-PAYMENT FROM PH ONE,0000501547990874,0.0,300.0,54896.85
12/06/25,UPI,UPI-VPKYADAV28OKICICI-VPKYADAV28@OKICICI -UBIN0800619-552935584155-UPI,0000552935584155,0.0,1500.0,53396.85
12/06/25,UPI,UPI-LIBERTYSRIHARIOKICIC-LIBERTYSRIHARI@ OKICICI-BKID0008627-552962689641-UPI,0000552962689641,0.0,650.0,52746.85
12/06/25,UPI,UPI-LIBERTYSRIHARIOKICIC-LIBERTYSRIHARI@ OKICICI-BKID0008627-552957376855-UPI,0000552957376855,0.0,1300.0,51446.85
12/06/25,UPI,UPI-SURENDER SHARMA-8688113062@YBL-SBIN 0020335-751136318873-PAYMENT FROM PHONE,0000751136318873,20000.0,0.0,71446.85
13/06/25,UPI,UPI-RAJENDRA PRASAD GHA-RAJGHANKOT11-1@ OKHDFCBANK-IOBA0001180-553050888375-UPI,0000553050888375,0.0,20690.0,50756.85
13/06/25,UPI,UPI-NARESH KUMAR YADAV-NARESHKUMARYADAV5 9426@YBL-UBIN0544884-553007696012-UPI,0000553007696012,0.0,500.0,50256.85
13/06/25,UPI,UPI-MR JURRU RAHUL YADA-Q758292524@YBL- YESB0YBLUPI-516460400446-UPI,0000516460400446,0.0,240.0,50016.85
13/06/25,UPI,UPI-MANE NAVNEETHA-PAYTMQR66O8TP@PTYS-YE SB0PTMUPI-553048586758-UPI,0000553048586758,0.0,40.0,49976.85
13/06/25,UPI,UPI-SRI BALAJI BAKERY-PAYTMQR6EC847@PTYS -YESB0PTMUPI-553016689396-UPI,0000553016689396,0.0,10.0,49966.85
13/06/25,UPI,UPI-GUNDU MANISH-Q972337083@YBL-YESB0YBL UPI-516426215773-UPI,0000516426215773,0.0,60.0,49906.85
13/06/25,UPI,UPI-RAMINI LAXMAN-PAYTMQR6F3VN1@PTYS-YES B0PTMUPI-516447827681-UPI,0000516447827681,0.0,10.0,49896.85
13/06/25,UPI,UPI-MADHU SUDHAN GHODKE-MADHUSUDHANGHOD KE@AXL-SBIN0005895-516452327907-UPI,0000516452327907,0.0,500.0,49396.85
13/06/25,UPI,UPI-MOHD PASHA MIYA-8074523914@YBL-LAVB0 000572-729834266616-PAYMENT FROM PHONE,0000729834266616,0.0,600.0,48796.85
13/06/25,UPI,UPI-MOHD AHMED ALI-AQUA.AHMED98@AXL-UTIB 0001808-830246544752-PAYMENT FROM PHONE,0000830246544752,360.0,0.0,49156.85
13/06/25,UPI,UPI-SASHIKALA BHANDARI-9032117972@YBL-S BIN0005895-959968648124-PAYMENT FROM PHO NE,0000959968648124,1500.0,0.0,50656.85
13/06/25,UPI,UPI-MAHENDAR KUMAR BAHET-7331185865@YESC RED-ICIC0000040-553019399146-MAHENDAR,0000553019399146,4000.0,0.0,54656.85
13/06/25,UPI,UPI-VPKYADAV28OKICICI-VPKYADAV28@OKICICI -UBIN0800619-516487643035-UPI,0000516487643035,0.0,1500.0,53156.85
13/06/25,UPI,UPI-VADICHERLA PRADEEP K-9293555325@AXL- UBIN0800619-639781827699-PAYMENT FROM PH ONE,0000639781827699,0.0,300.0,52856.85
13/06/25,UPI,UPI-M PRABHAKAR-Q435661641@YBL-YESB0YBLU PI-516405535189-UPI,0000516405535189,0.0,50.0,52806.85
13/06/25,UPI,UPI-KOLLAPURAM MALLIKARJ-MALLIKARJUNKOLA PURAM@OKSBI-HDFC0000218-516427833021-UPI,0000516427833021,0.0,400.0,52406.85
13/06/25,UPI,UPI-SRI BALAJI BAKERY-PAYTMQR6EC847@PTYS -YESB0PTMUPI-516463528156-UPI,0000516463528156,0.0,20.0,52386.85
13/06/25,UPI,UPI-LIBERTYSRIHARIOKICIC-LIBERTYSRIHARI@ OKICICI-BKID0008627-516484848354-UPI,0000516484848354,0.0,1300.0,51086.85
13/06/25,UPI,UPI-LIBERTYSRIHARIOKICIC-LIBERTYSRIHARI@ OKICICI-BKID0008627-516410533016-UPI,0000516410533016,0.0,650.0,50436.85
13/06/25,NEFT,NEFT CR-ICIC0099999-ANGEL ONE LIMITED-MU KKERLA MADHU YADAV-ICICN220250613200725,ICICN22025061320,900.0,0.0,51336.85
14/06/25,UPI,UPI-NARESH KUMAR YADAV S-8712314023@UPI- BKID0005862-516536349926-UPI,0000516536349926,0.0,800.0,50536.85
14/06/25,UPI,UPI-MR JURRU RAHUL YADA-Q758292524@YBL- YESB0YBLUPI-516571861991-UPI,0000516571861991,0.0,240.0,50296.85
14/06/25,UPI,UPI-TIRIVISETTY SATYANA-SATHISHREDDY648 61@AXL-SBIN0002731-516526361109-UPI,0000516526361109,0.0,30.0,50266.85
14/06/25,UPI,UPI-MANE NAVNEETHA-PAYTMQR66FHIY@PTYS-YE SB0PTMUPI-516593960508-UPI,0000516593960508,0.0,30.0,50236.85
14/06/25,UPI,UPI-MRS B BHARATHI-Q594782917@YBL-YESB0 YBLUPI-516589256358-UPI,0000516589256358,0.0,20.0,50216.85
14/06/25,UPI,UPI-MR MARYPEDDY YADAIAH-PAYTMQR12M8KT7Q ZP@PAYTM-YESB0PTMUPI-516503061454-UPI,0000516503061454,0.0,30.0,50186.85
14/06/25,UPI,UPI-P NAND KISHOR-BHARATPE.90069295183@F BPE-FDRL0001382-516540379004-PAY TO BHAR ATPE ME,0000516540379004,0.0,50.0,50136.85
14/06/25,UPI,UPI-PANYAM MANJULA-MANJUPANYAM@OKSBI-SB IN0007641-516533445826-UPI,0000516533445826,2000.0,0.0,52136.85
14/06/25,UPI,UPI-MARGAM VANI-VANIMARGAM510@OKAXIS-SB IN0021100-553119296513-UPI,0000553119296513,45000.0,0.0,97136.85
14/06/25,,ATW-416021XXXXXX2657-P3ENTS55-HYDERABAD,0000000000007129,0.0,20000.0,77136.85
14/06/25,,ATW-416021XXXXXX2657-P3ENTS55-HYDERABAD,0000000000007130,0.0,20000.0,57136.85
14/06/25,,ATW-416021XXXXXX2657-P3ENTS55-HYDERABAD,0000000000007131,0.0,10000.0,47136.85
14/06/25,UPI,UPI-A NARESH KUMAR-Q749466560@YBL-YESB0Y BLUPI-516525869972-UPI,0000516525869972,0.0,90.0,47046.85
14/06/25,UPI,UPI-K S CONSTRUCTIONS-ASHWINYADAV85-1@OK SBI-AUBL0002591-516564080574-UPI,0000516564080574,0.0,30000.0,17046.85
14/06/25,UPI,UPI-K S CONSTRUCTIONS-9393995648-2@IBL-A UBL0002591-927592933242-PAYMENT FROM PHO NE,0000927592933242,5000.0,0.0,22046.85
14/06/25,UPI,UPI-MADHU SUDHAN GHODKE-MADHUSUDHANGHOD KE@AXL-SBIN0005895-525816894171-PAYMENT FROM PHONE,0000525816894171,500.0,0.0,22546.85
14/06/25,UPI,UPI-SANJAY UIKEY-7997088152@AXL-SBIN000 6962-250726548417-PAYMENT FROM PHONE,0000250726548417,0.0,5000.0,17546.85
14/06/25,IMPS,IMPS-516520312675-M MADHU YADAV-KKBK-XXX XXX7813-CASH,0000516520312675,0.0,4000.0,13546.85
14/06/25,UPI,UPI-VADICHERLA PRADEEP K-9293555325-3@YB L-HDFC0001635-055871767561-PAYMENT FROM PHONE,0000055871767561,3500.0,0.0,17046.85
15/06/25,UPI,UPI-MR JURRU RAHUL YADA-Q758292524@YBL- YESB0YBLUPI-553249609513-UPI,0000553249609513,0.0,270.0,16776.85
15/06/25,UPI,UPI-MURALIKRISHNA VEGETA-GPAY-1124438713 1@OKBIZAXIS-UTIB0000553-553201128211-UPI,0000553201128211,0.0,250.0,16526.85
15/06/25,UPI,UPI-AVENUE SUPERMARTS LT-INNOVDMARTTS@IC ICI-ICIC0DC0099-553257428257-UPI,0000553257428257,0.0,867.0,15659.85
15/06/25,,ACH D- LIC OF INDIA-6577926590625,0000008025718166,0.0,2488.0,13171.85
15/06/25,UPI,UPI-G KRISHNA VENI-G.KRISHNAVENI1979@OK HDFCBANK-SBIN0001765-553218322258-UPI,0000553218322258,0.0,200.0,12971.85
15/06/25,UPI,UPI-A NARESH KUMAR-Q749466560@YBL-YESB0Y BLUPI-553272728374-UPI,0000553272728374,0.0,90.0,12881.85
15/06/25,UPI,UPI-A NARESH KUMAR-Q749466560@YBL-YESB0Y BLUPI-553221142244-UPI,0000553221142244,0.0,17.0,12864.85
15/06/25,UPI,UPI-MRS B BHARATHI-Q594782917@YBL-YESB0 YBLUPI-553261443084-UPI,0000553261443084,0.0,10.0,12854.85
15/06/25,UPI,UPI-MOHD AHMED ALI-AQUA.AHMED98@AXL-UTIB 0001808-052936157692-PAYMENT FROM PHONE,0000052936157692,6500.0,0.0,19354.85
15/06/25,UPI,UPI-LAKSHMI APPALA-LAKSHME1202@OKAXIS-S BIN0005895-516607782226-UPI,0000516607782226,1500.0,0.0,20854.85
15/06/25,UPI,UPI-MUNTHA RAMESH YADAV-RAMEESHM6666@YBL -BKID0008604-461085633736-PAYMENT FROM P HONE,0000461085633736,0.0,6000.0,14854.85
15/06/25,UPI,UPI-VADICHERLA PRADEEP K-9293555325-3@YB L-HDFC0001635-761169982859-PAYMENT FROM PHONE,0000761169982859,0.0,300.0,14554.85
15/06/25,UPI,UPI-VPKYADAV28OKICICI-VPKYADAV28@OKICICI -UBIN0800619-553278373086-UPI,0000553278373086,0.0,1500.0,13054.85
15/06/25,UPI,UPI-HP PETROL PUMP PETR-Q561100586@YBL- YESB0YBLUPI-553238062882-UPI,0000553238062882,0.0,500.0,12554.85
15/06/25,UPI,UPI-MADHU SUDHAN GHODKE-MADHUSUDHANGHOD KE@AXL-SBIN0005895-628942059696-PAYMENT FROM PHONE,0000628942059696,200.0,0.0,12754.85
15/06/25,UPI,UPI-LIBERTYSRIHARIOKICIC-LIBERTYSRIHARI@ OKICICI-BKID0008627-553222876119-UPI,0000553222876119,0.0,1300.0,11454.85
15/06/25,UPI,UPI-LIBERTYSRIHARIOKICIC-LIBERTYSRIHARI@ OKICICI-BKID0008627-553281481999-UPI,0000553281481999,0.0,650.0,10804.85
16/06/25,UPI,UPI-JURRU RAHUL YADAV-9963019626@YBL-SB IN0007641-124232274425-PAYMENT FROM PHON E,0000124232274425,20000.0,0.0,30804.85
16/06/25,UPI,UPI-MR JURRU RAHUL YADA-Q758292524@YBL- YESB0YBLUPI-553382884165-UPI,0000553382884165,0.0,180.0,30624.85
16/06/25,UPI,UPI-B VINOD KUMAR-BALERAOVINOD077@OKSBI- CNRB0000033-553396684944-UPI,0000553396684944,0.0,7000.0,23624.85
16/06/25,UPI,UPI-TIRIVISETTY SATYANA-SATHISHREDDY648 61@AXL-SBIN0002731-553389489669-UPI,0000553389489669,0.0,1030.0,22594.85
16/06/25,UPI,UPI-ANGEL LTD NSE-ANGELONENSE@HDFCBANK-H DFC0MERUPI-516737203104-PAYINGANGELONE,0000516737203104,0.0,10000.0,12594.85
16/06/25,UPI,UPI-ANGEL LTD NSE-ANGELONENSE@HDFCBANK-H DFC0MERUPI-553323392661-PAYINGANGELONE,0000553323392661,0.0,8000.0,4594.85
16/06/25,UPI,UPI-MOHIT SETHIA-MOHITSJ.1995@OKICICI- KKBK0007452-516736132738-UPI,0000516736132738,1500.0,0.0,6094.85
16/06/25,NEFT,NEFT CR-YESB0000001-ZERODHA BROKING LTD- DSCNB A/C-MUKKERLA MADHU YADAV-YESBN1202,YESBN12025061605,250.0,0.0,6344.85
16/06/25,UPI,UPI-SRI SAI RESTAURANT A-PAYTM-80610737@ PTYS-YESB0PTMUPI-516781618719-UPI,0000516781618719,0.0,26.0,6318.85
16/06/25,UPI,UPI-UPENDER CHAKRALA-9618452019@AXL-SBI N0015882-516797140535-UPI,0000516797140535,0.0,10.0,6308.85
16/06/25,UPI,UPI-VADICHERLA PRADEEP K-9293555325-3@YB L-HDFC0001635-642909404790-PAYMENT FROM PHONE,0000642909404790,0.0,300.0,6008.85
16/06/25,UPI,UPI-LIBERTYSRIHARIOKICIC-LIBERTYSRIHARI@ OKICICI-BKID0008627-516744240753-UPI,0000516744240753,0.0,1300.0,4708.85
16/06/25,UPI,UPI-LIBERTYSRIHARIOKICIC-LIBERTYSRIHARI@ OKICICI-BKID0008627-516724233403-UPI,0000516724233403,0.0,650.0,4058.85
16/06/25,IMPS,IMPS-516721362255-M MADHU YADAV-KKBK-XXX XXX7813-CASH,0000516721362255,0.0,1500.0,2558.85
17/06/25,UPI,UPI-MR JURRU RAHUL YADA-Q758292524@YBL- YESB0YBLUPI-516815948281-UPI,0000516815948281,0.0,330.0,2228.85
17/06/25,UPI,UPI-MOHD PASHA MIYA-8074523914@YBL-LAVB0 000572-721788764579-PAYMENT FROM PHONE,0000721788764579,0.0,600.0,1628.85
17/06/25,UPI,UPI-ANJAPPA-ANJIMOSADKARANJI1@YBL-SBIN00 21629-516840659220-UPI,0000516840659220,0.0,140.0,1488.85
17/06/25,UPI,UPI-ANGEL LTD NSE-ANGELONENSE@HDFCBANK-H DFC0MERUPI-516820867570-PAYINGANGELONE,0000516820867570,0.0,850.0,638.85
17/06/25,UPI,UPI-NAGRAJ-MUKKERLANAGRAJ@OKAXIS-UBIN080 3219-516884639558-UPI,0000516884639558,3000.0,0.0,3638.85
17/06/25,UPI,UPI-ANGEL LTD NSE-ANGELONENSE@HDFCBANK-H DFC0MERUPI-516842748245-PAYINGANGELONE,0000516842748245,0.0,3000.0,638.85
17/06/25,UPI,UPI-ANGEL LTD NSE-ANGELONENSE@HDFCBANK-H DFC0MERUPI-516857340073-PAYINGANGELONE,0000516857340073,0.0,600.0,38.85
17/06/25,UPI,UPI-BUDUMURU BHARGAVI-6303219486-3@AXL-C NRB0000033-138864812338-PAYMENT FROM PHO NE,0000138864812338,1500.0,0.0,1538.85
17/06/25,UPI,UPI-MADHURI MARAM-LIPIKAMARAM@OKICICI-IC IC0000008-516856070987-UPI,0000516856070987,2000.0,0.0,3538.85
17/06/25,UPI,UPI-SANTHOSHA ARRA-SANTHU.SANTHOSHA2004@ OKHDFCBANK-HDFC0000562-106602947085-UPI,0000106602947085,1000.0,0.0,4538.85
17/06/25,UPI,UPI-VENKATESHWARA ELECTR-GPAY-1125248086 9@OKBIZAXIS-UTIB0000553-516817356915-UPI,0000516817356915,0.0,3575.0,963.85
17/06/25,UPI,UPI-MUKKERLA GEETA SUDHA-GEETHAMUKKERLA- 1@OKAXIS-KKBK0007463-516840073209-UPI,0000516840073209,950.0,0.0,1913.85
17/06/25,UPI,UPI-MRS B BHARATHI-Q594782917@YBL-YESB0 YBLUPI-516829567734-UPI,0000516829567734,0.0,10.0,1903.85
17/06/25,UPI,UPI-ABSIPURAM PRASOONA-9948434877@IBL-S BIN0020083-661925853013-PAYMENT FROM PHO NE,0000661925853013,1500.0,0.0,3403.85
17/06/25,UPI,UPI-MR RAJ KUMAR MEGHWAL-Q438004319@YBL- YESB0YBLUPI-516846789657-UPI,0000516846789657,0.0,15.0,3388.85
17/06/25,UPI,UPI-HANSABEN VRAJLAL DEV-PAYTMQR6AZMSC@P TYS-YESB0PTMUPI-516853881145-UPI,0000516853881145,0.0,20.0,3368.85
17/06/25,UPI,UPI-CHAVALI LAVANYA-9490255943@YBL-CNRB0 000000-669252747436-PAYMENT FROM PHONE,0000669252747436,1500.0,0.0,4868.85
17/06/25,IMPS,IMPS-516821366336-M MADHU YADAV-KKBK-XXX XXX7813-CASH,0000516821366336,0.0,4000.0,868.85
18/06/25,UPI,UPI-MR JURRU RAHUL YADA-Q758292524@YBL- YESB0YBLUPI-553501801727-UPI,0000553501801727,0.0,330.0,538.85
18/06/25,UPI,UPI-MANE NAVNEETHA-PAYTMQR66O8TP@PTYS-YE SB0PTMUPI-553561606680-UPI,0000553561606680,0.0,30.0,508.85
18/06/25,IMPS,IMPS-516933027647-MUTHOOTFINCORPLTD-UTIB -XXXXXXXXXXX6541-TREASURYDISBURSAL,0000516933027647,7194.0,0.0,7702.85
18/06/25,UPI,UPI-MOHD AHMED ALI-AQUA.AHMED98@AXL-UTIB 0001808-845369339575-PAYMENT FROM PHONE,0000845369339575,3500.0,0.0,11202.85
18/06/25,UPI,UPI-BHARATHI BHARATHI-BHARTHI9573@YBL-S BIN0020701-553502135652-UPI,0000553502135652,0.0,6000.0,5202.85
18/06/25,IMPS,IMPS-516914345070-M MADHU YADAV-KKBK-XXX XXX7813-CASH,0000516914345070,0.0,5000.0,202.85
18/06/25,UPI,UPI-PAWAN KUMAR BASANT-9903315499@AXISB- IDFB0040101-516944618173-PAID VIA CRED,0000516944618173,1500.0,0.0,1702.85
18/06/25,POS,CASH DEPOSIT-XXXXXXXXXX1847-BARKATPURA,0000000000008605,25500.0,0.0,27202.85
18/06/25,POS,CASH DEPOSIT-XXXXXXXXXX1847-BARKATPURA,0000000000008608,6500.0,0.0,33702.85
18/06/25,IMPS,IMPS-516919330848-M MADHU YADAV-KKBK-XXX XXX7813-CASH,0000516919330848,0.0,33000.0,702.85
19/06/25,UPI,UPI-MANE NAVNEETHA-PAYTMQR66O8TP@PTYS-YE SB0PTMUPI-553634882635-UPI,0000553634882635,0.0,30.0,672.85
19/06/25,UPI,UPI-K S CONSTRUCTIONS-9393995648-2@AXL-A UBL0002591-568618339067-PAYMENT FROM PHO NE,0000568618339067,20000.0,0.0,20672.85
19/06/25,UPI,UPI-MR JONNA KANTI SRIK-Q131493680@YBL- YESB0YBLUPI-517059706145-UPI,0000517059706145,0.0,230.0,20442.85
19/06/25,UPI,UPI-BADI UZZAMAN-ABS.CENTRE@AXL-KKBK000 7451-997448896675-PAYMENT FROM PHONE,0000997448896675,1000.0,0.0,21442.85
19/06/25,UPI,UPI-NORTHERN ARC-NORTHERNARC495902.RZP@A XISBANK-UTIB0000100-927334631705-POWERED BY SMARTCO,0000927334631705,0.0,6330.54,15112.31
19/06/25,UPI,UPI-KADAVATH DEVARAM NAY-9603164559@YBL- SBIN0020898-157234412290-PAYMENT FROM PH ONE,0000157234412290,1000.0,0.0,16112.31
19/06/25,UPI,UPI-HANSABEN VRAJLAL DEV-PAYTMQR6HZR0K@P TYS-YESB0PTMUPI-517019416746-UPI,0000517019416746,0.0,20.0,16092.31
19/06/25,UPI,UPI-G VINOD-VINODGOUDE0071@OKAXIS-KKBK0 007461-517029926980-UPI,0000517029926980,2035.0,0.0,18127.31
19/06/25,UPI,UPI-VADICHERLA PRADEEP K-9293555325-3@YB L-HDFC0001635-774215827459-PAYMENT FROM PHONE,0000774215827459,0.0,300.0,17827.31
19/06/25,UPI,UPI-VPKYADAV28OKICICI-VPKYADAV28@OKICICI -UBIN0800619-517024216630-UPI,0000517024216630,0.0,1500.0,16327.31
19/06/25,UPI,UPI-LIBERTYSRIHARIOKICIC-LIBERTYSRIHARI@ OKICICI-BKID0008627-517034022349-UPI,0000517034022349,0.0,1300.0,15027.31
19/06/25,UPI,UPI-LIBERTYSRIHARIOKICIC-LIBERTYSRIHARI@ OKICICI-BKID0008627-517085428301-UPI,0000517085428301,0.0,650.0,14377.31
19/06/25,UPI,UPI-BILLA S-9700452204-2@AXL-HSBC0500002 -303054372717-PAYMENT FROM PHONE,0000303054372717,1200.0,0.0,15577.31
19/06/25,UPI,UPI-CH GIRIDHAR NETHA-VISHNUVARDANNETHA@ OKICICI-ANDB0000321-517047730206-NAGARAJ U YADAV,0000517047730206,30000.0,0.0,45577.31
19/06/25,UPI,UPI-NAGRAJ-MUKKERLANAGRAJ@OKAXIS-UBIN080 3219-517005950067-UPI,0000517005950067,600.0,0.0,46177.31
19/06/25,UPI,UPI-MOHAMMED ALI-AMOHD4038@OKHDFCBANK-UB IN0820644-517061527713-UPI,0000517061527713,0.0,100.0,46077.31
20/06/25,,ATW-416021XXXXXX2657-S1AWHY59-HYDERABAD,0000000000000224,0.0,20000.0,26077.31
20/06/25,,ATW-416021XXXXXX2657-S1AWHY59-HYDERABAD,0000000000000224,0.0,-20000.0,46077.31
20/06/25,,ATW-416021XXXXXX2657-S1AWHY59-HYDERABAD,0000000000000225,0.0,20000.0,26077.31
20/06/25,,ATW-416021XXXXXX2657-S1AWHY59-HYDERABAD,0000000000000225,0.0,-20000.0,46077.31
20/06/25,,ATW-416021XXXXXX2657-COHYD021-HYDERABAD,0000000000005784,0.0,4000.0,42077.31
20/06/25,,ATW-416021XXXXXX2657-S1ANHD25-HYDERABAD,0000000000006212,0.0,20000.0,22077.31
20/06/25,,ATW-416021XXXXXX2657-S1AWHY59-HYDERABAD,0000000000000226,0.0,20000.0,2077.31
20/06/25,,ATW-416021XXXXXX2657-S1AWHY59-HYDERABAD,0000000000000226,0.0,-20000.0,22077.31
20/06/25,,ATW-416021XXXXXX2657-S1ANHD25-HYDERABAD,0000000000006213,0.0,20000.0,2077.31
20/06/25,UPI,UPI-SRI BALAJI BAKERY-PAYTMQR6EC847@PTYS -YESB0PTMUPI-517194445264-UPI,0000517194445264,0.0,20.0,2057.31
20/06/25,UPI,UPI-M ANIL YADAV-ANILYADAV63473-1@OKSBI- UBIN0803219-517163244530-UPI,0000517163244530,0.0,600.0,1457.31
20/06/25,UPI,UPI-RAMINI LAXMAN-PAYTMQR6F3VN1@PTYS-YES B0PTMUPI-517118745217-UPI,0000517118745217,0.0,10.0,1447.31
20/06/25,UPI,UPI-DOMAKONDA MAHESH-Q718219968@YBL-YESB 0YBLUPI-517109659381-UPI,0000517109659381,0.0,6.0,1441.31
20/06/25,UPI,UPI-SANTHOSH KUMAR CHIKA-SANTHOSHCH0011@ OKHDFCBANK-HDFC0004480-106764645713-UPI,0000106764645713,18000.0,0.0,19441.31
20/06/25,UPI,UPI-GSN LIQUOR MART-Q723336071@YBL-YESB0 YBLUPI-517185469591-UPI,0000517185469591,0.0,370.0,19071.31
20/06/25,UPI,UPI-MADHU SUDHAN GHODKE-MADHUSUDHANGHOD KE@AXL-SBIN0005895-287363459698-PAYMENT FROM PHONE,0000287363459698,200.0,0.0,19271.31
20/06/25,UPI,UPI-DESHMUKH YADAGIRI R-YADAGIRIDESHMUK H@OKSBI-SBIN0020568-517180184895-UPI,0000517180184895,0.0,500.0,18771.31
20/06/25,UPI,UPI-VADICHERLA PRADEEP K-9293555325@AXL- UBIN0800619-760665022456-PAYMENT FROM PH ONE,0000760665022456,0.0,300.0,18471.31
20/06/25,UPI,UPI-MOHD PASHA MIYA-8074523914@YBL-LAVB0 000572-833469828054-PAYMENT FROM PHONE,0000833469828054,0.0,600.0,17871.31
20/06/25,UPI,UPI-VADICHERLA PRADEEP K-9293555325@YBL- UBIN0800619-553741104450-UPI,0000553741104450,0.0,1500.0,16371.31
20/06/25,IMPS,IMPS-517120352571-M MADHU YADAV-KKBK-XXX XXX7813-CASH,0000517120352571,0.0,2000.0,14371.31
20/06/25,UPI,UPI-WASEEM MOHD-WASEEMMOHAMEED9640-1@OK AXIS-SBIN0020062-553708219126-UPI,0000553708219126,3000.0,0.0,17371.31
21/06/25,UPI,UPI-RANGA RANJITH KUMAR-RANJITH.ACEIT-2@ OKICICI-ICIC0003801-553841519163-PACHUAM OUNT,0000553841519163,13900.0,0.0,31271.31
21/06/25,UPI,UPI-MR JURRU RAHUL YADA-Q758292524@YBL- YESB0YBLUPI-553803110694-UPI,0000553803110694,0.0,150.0,31121.31
21/06/25,UPI,UPI-HIMAYATNAGAR SERVICE-Q957427366@YBL- YESB0YBLUPI-553899415926-UPI,0000553899415926,0.0,350.0,30771.31
21/06/25,UPI,UPI-TIRIVISETTY SATYANA-SATHISHREDDY648 61@AXL-SBIN0002731-553895303758-UPI,0000553895303758,0.0,230.0,30541.31
21/06/25,UPI,UPI-SRI BALAJI BAKERY-PAYTMQR6EC847@PTYS -YESB0PTMUPI-553851517910-UPI,0000553851517910,0.0,55.0,30486.31
21/06/25,UPI,UPI-SRI BALAJI BAKERY-PAYTMQR6EC847@PTYS -YESB0PTMUPI-553897319192-UPI,0000553897319192,0.0,20.0,30466.31
21/06/25,UPI,UPI-MR MARYPEDDY YADAIAH-PAYTMQR12M8KT7Q ZP@PAYTM-YESB0PTMUPI-553865227523-UPI,0000553865227523,0.0,30.0,30436.31
21/06/25,UPI,UPI-P YASH-6302228022@IBL-IOBA0000336-5 53891337887-UPI,0000553891337887,0.0,50.0,30386.31
21/06/25,,NWD-416021XXXXXX2657-00847550-HIMAYATHNA GAR,0000517211024027,0.0,500.0,29886.31
21/06/25,UPI,UPI-DEVI 70MM-VYAPAR.171407491848@HDFCBA NK-HDFC0MERUPI-553846424759-UPI,0000553846424759,0.0,175.0,29711.31
21/06/25,UPI,UPI-JURRU RAHUL YADAV-JRAHULYADAV29@OKS BI-SBIN0007641-553856426762-UPI,0000553856426762,0.0,500.0,29211.31
21/06/25,UPI,UPI-MOHAMMED SADDAM-Q136075869@YBL-YESB 0YBLUPI-553890729650-UPI,0000553890729650,0.0,90.0,29121.31
21/06/25,UPI,UPI-BHARATHI BHARATHI-BHARTHI9573@YBL-S BIN0020701-553846537242-UPI,0000553846537242,0.0,6000.0,23121.31
21/06/25,UPI,UPI-KOLLAPURAM MALLIKARJ-MALLIKARJUNKOLA PURAM@OKSBI-HDFC0000218-553866350258-UPI,0000553866350258,0.0,200.0,22921.31
21/06/25,UPI,UPI-INOKADWALE SONY-BHARATPE9Y0K7J3J0Z2 43207@YESBANKLTD-YESB0YESUPI-55383436037 9-PAY TO BHARATPE ME,0000553834360379,0.0,50.0,22871.31
21/06/25,UPI,UPI-JAYADEEPA M S-BHARATPE.90069770319@F BPE-FDRL0001382-553868772717-PAY TO BHAR ATPE ME,0000553868772717,0.0,30.0,22841.31
21/06/25,UPI,UPI-VADICHERLA PRADEEP K-9293555325-3@YB L-HDFC0001635-553835473337-UPI,0000553835473337,0.0,1500.0,21341.31
21/06/25,IMPS,IMPS-517220350034-M MADHU YADAV-KKBK-XXX XXX7813-CASH,0000517220350034,0.0,2500.0,18841.31
22/06/25,UPI,UPI-NARESH KUMAR YADAV-NARESHKUMARYADAV5 9426@YBL-UBIN0544884-553995480823-UPI,0000553995480823,0.0,100.0,18741.31
22/06/25,UPI,UPI-MR JURRU RAHUL YADA-Q758292524@YBL- YESB0YBLUPI-553986578020-UPI,0000553986578020,0.0,270.0,18471.31
22/06/25,UPI,UPI-MOHD PASHA MIYA-8074523914@YBL-LAVB0 000572-736916285531-PAYMENT FROM PHONE,0000736916285531,0.0,800.0,17671.31
22/06/25,UPI,UPI-KOLLAPURAM MALLIKARJ-MALLIKARJUNKOLA PURAM@OKSBI-HDFC0000218-553903079371-UPI,0000553903079371,0.0,250.0,17421.31
22/06/25,UPI,UPI-GADDAMEDI SRINIVAS-Q823829553@YBL-YE SB0YBLUPI-553920585178-UPI,0000553920585178,0.0,270.0,17151.31
22/06/25,UPI,UPI-KALYANKAR VITTAHAL R-Q721204730@YBL- YESB0YBLUPI-553939579533-UPI,0000553939579533,0.0,280.0,16871.31
22/06/25,UPI,UPI-AKSHAY CHINTALA-9849868607@YESCRED- CNRB0000033-553913574295-PAID VIA CRED,0000553913574295,1000.0,0.0,17871.31
22/06/25,UPI,UPI-RAPARTI SRIHARI-LIBERTYSRIHARI@OKICI CI-BKID0008627-012176460333-PAYMENT FROM PHONE,0000012176460333,0.0,13000.0,4871.31
22/06/25,UPI,UPI-DHACHEPALLY VENKATE-Q972681352@YBL- YESB0YBLUPI-553957093193-UPI,0000553957093193,0.0,105.0,4766.31
22/06/25,UPI,UPI-BOYAPALLI MAHENDAR-8500928242@YBL-IO BA0001696-517335608114-UPI,0000517335608114,0.0,500.0,4266.31
22/06/25,UPI,UPI-MOHD AHMED ALI-AQUA.AHMED98@AXL-UTIB 0001808-902821235063-PAYMENT FROM PHONE,0000902821235063,180.0,0.0,4446.31
22/06/25,UPI,UPI-MR BHAIRAVA SRIKANTH-9293555325-5@YB L-CBIN0284811-853783274749-PAYMENT FROM PHONE,0000853783274749,0.0,500.0,3946.31
22/06/25,UPI,UPI-MR BHAIRAVA SRIKANTH-9293555325-5@YB L-CBIN0284811-517303932949-UPI,0000517303932949,0.0,1500.0,2446.31
22/06/25,UPI,UPI-AJAY KUMAR SINGH-Q843638414@YBL-YESB 0YBLUPI-517327926854-UPI,0000517327926854,0.0,20.0,2426.31
22/06/25,UPI,UPI-SANTHOSHA ARRA-SANTHU.SANTHOSHA2004@ OKHDFCBANK-HDFC0000562-517390522745-UPI,0000517390522745,0.0,1000.0,1426.31
22/06/25,UPI,UPI-MR MADHU SUDHAN GHO-MADHUSUDHANGHOD KE2@AXL-MAHB0000383-782150675676-PAYMENT FROM PHONE,0000782150675676,300.0,0.0,1726.31
22/06/25,IMPS,IMPS-517321367717-M MADHU YADAV-KKBK-XXX XXX7813-CASH,0000517321367717,0.0,1700.0,26.31
23/06/25,POS,CASH DEPOSIT-XXXXXXXXXX1847-HIMAYATNAGAR,0000000000006523,8000.0,0.0,8026.31
23/06/25,UPI,UPI-LIBERTYSRIHARIOKICIC-LIBERTYSRIHARI@ OKICICI-BKID0008627-517424045723-UPI,0000517424045723,0.0,650.0,7376.31
23/06/25,UPI,UPI-MANE NAVNEETHA-PAYTMQR66O8TP@PTYS-YE SB0PTMUPI-517446352531-UPI,0000517446352531,0.0,30.0,7346.31
23/06/25,UPI,UPI-SRI BALAJI BAKERY-PAYTMQR6EC847@PTYS -YESB0PTMUPI-517483057447-UPI,0000517483057447,0.0,10.0,7336.31
23/06/25,UPI,UPI-P NAND KISHOR-BHARATPE.90069295183@F BPE-FDRL0001382-517443767087-PAY TO BHAR ATPE ME,0000517443767087,0.0,50.0,7286.31
23/06/25,UPI,UPI-AMIT CHARAN-PAYTMQR6CYVFT@PTYS-YESB0 PTMUPI-517433458174-UPI,0000517433458174,0.0,20.0,7266.31
23/06/25,UPI,UPI-K S CONSTRUCTIONS-9393995648-2@YBL-A UBL0002591-516854475388-PAYMENT FROM PHO NE,0000516854475388,100.0,0.0,7366.31
23/06/25,UPI,UPI-M MADHU YADAV-9985065404-2@YBL-SBIN 0006645-690071064699-PAYMENT FROM PHONE,0000690071064699,4000.0,0.0,11366.31
23/06/25,UPI,UPI-RAPARTI SRIHARI-LIBERTYSRIHARI@OKICI CI-BKID0008627-488881794212-PAYMENT FROM PHONE,0000488881794212,0.0,10000.0,1366.31
23/06/25,UPI,UPI-GAJVINKAR KARAN-AMZN0001342405@APL- SBIN0005895-517472768507-UPI,0000517472768507,0.0,30.0,1336.31
23/06/25,UPI,UPI-KATEPALLY VINAY KUM-VINAYKUMARKATEP ALLY@OKSBI-SBIN0003086-517462943014-UPI,0000517462943014,1000.0,0.0,2336.31
23/06/25,UPI,UPI-VEMURI RAMESH-6303777798@IBL-UBIN082 7541-795749192658-PAYMENT FROM PHONE,0000795749192658,800.0,0.0,3136.31
23/06/25,IMPS,IMPS-517419323484-M MADHU YADAV-KKBK-XXX XXX7813-CASH,0000517419323484,0.0,3100.0,36.31
23/06/25,UPI,UPI-JAYADEEPA M S-BHARATPE.90069770319@F BPE-FDRL0001382-554061707987-PAY TO BHAR ATPE ME,0000554061707987,0.0,20.0,16.31
23/06/25,UPI,UPI-GANTA SUJATHA-SUJATHAGANAT13@OKAXIS -SBIN0005895-554064632088-UPI,0000554064632088,1050.0,0.0,1066.31
23/06/25,IMPS,IMPS-517421367431-M MADHU YADAV-KKBK-XXX XXX7813-CASH,0000517421367431,0.0,200.0,866.31
23/06/25,IMPS,IMPS-517421369087-M MADHU YADAV-KKBK-XXX XXX7813-CASH,0000517421369087,0.0,200.0,666.31
23/06/25,UPI,UPI-NEELAM SETHI-NEELAMSETHI741@OKAXIS-U BIN0534773-554085640308-UPI,0000554085640308,2000.0,0.0,2666.31
24/06/25,UPI,UPI-NARESH KUMAR YADAV-NARESHKUMARYADAV5 9426@YBL-UBIN0544884-554124124027-UPI,0000554124124027,0.0,500.0,2166.31
24/06/25,UPI,UPI-MR JURRU RAHUL YADA-Q758292524@YBL- YESB0YBLUPI-554190805632-UPI,0000554190805632,0.0,140.0,2026.31
24/06/25,UPI,UPI-MRS R VANDANA-Q021206969@YBL-YESB0Y BLUPI-554192324494-UPI,0000554192324494,0.0,25.0,2001.31
24/06/25,UPI,UPI-KOUR H-HARDEEPKOUR24@OKAXIS-HSBC0500 002-554121687802-UPI,0000554121687802,1000.0,0.0,3001.31
24/06/25,UPI,UPI-MR MADHU SUDHAN GHO-MADHUSUDHANGHOD KE2@IBL-MAHB0000383-499932011720-PAYMENT FROM PHONE,0000499932011720,1000.0,0.0,4001.31
24/06/25,UPI,UPI-VADICHERLA PRADEEP K-VPKYADAV28-2@OK HDFCBANK-UBIN0800619-554141164468-UPI,0000554141164468,0.0,1500.0,2501.31
24/06/25,UPI,UPI-LIBERTYSRIHARIOKICIC-LIBERTYSRIHARI@ OKICICI-BKID0008627-554195862886-UPI,0000554195862886,0.0,1300.0,1201.31
24/06/25,UPI,UPI-LIBERTYSRIHARIOKICIC-LIBERTYSRIHARI@ OKICICI-BKID0008627-554154047421-UPI,0000554154047421,0.0,650.0,551.31
24/06/25,IMPS,IMPS-517518300374-M MADHU YADAV-KKBK-XXX XXX7813-CASH,0000517518300374,0.0,500.0,51.31
24/06/25,UPI,UPI-OMBKAADD626441FO1ONO-OMBK.AADD626441 FO1ONOUDFX@MBK-PPIW0881822-554185367725- UPI,0000554185367725,0.0,20.0,31.31
24/06/25,UPI,UPI-RONAK NEELESH RUPARA-KUMARRONAK7@OKA XIS-HDFC0000545-517531916696-MILK BILL A DVANCE,0000517531916696,1000.0,0.0,1031.31
24/06/25,UPI,UPI-SAVITHA TEDEWALE-8886220809-2@IBL-S BIN0001880-766325264415-PAYMENT FROM PHO NE,0000766325264415,95000.0,0.0,96031.31
24/06/25,UPI,UPI-ANGEL LTD NSE-ANGELONENSE@HDFCBANK-H DFC0MERUPI-554180064786-PAYINGANGELONE,0000554180064786,0.0,10000.0,86031.31
24/06/25,IMPS,IMPS-517522369647-M MADHU YADAV-KKBK-XXX XXX7813-CASH,0000517522369647,0.0,46000.0,40031.31
24/06/25,UPI,UPI-JB PAPER PRODUCT-9052220908-4@YBL-HD FC0000081-164547802505-PAYMENT FROM PHON E,0000164547802505,25000.0,0.0,65031.31
24/06/25,UPI,UPI-ANGEL LTD NSE-ANGELONENSE@HDFCBANK-H DFC0MERUPI-554112767267-PAYINGANGELONE,0000554112767267,0.0,10000.0,55031.31
25/06/25,UPI,UPI-MR JURRU RAHUL YADA-Q758292524@YBL- YESB0YBLUPI-554254578376-UPI,0000554254578376,0.0,180.0,54851.31
25/06/25,UPI,UPI-B VINOD KUMAR-BALERAOVINOD077@OKSBI- CNRB0000033-554269179013-UPI,0000554269179013,0.0,5000.0,49851.31
25/06/25,UPI,UPI-TIRIVISETTY SATYANA-SATHISHREDDY648 61@AXL-SBIN0002731-554278877147-UPI,0000554278877147,0.0,130.0,49721.31
25/06/25,,ATW-416021XXXXXX2657-P3ENTS55-HYDERABAD,0000000000008860,0.0,10000.0,39721.31
25/06/25,,ATW-416021XXXXXX2657-P3ENTS55-HYDERABAD,0000000000008862,0.0,5000.0,34721.31
25/06/25,UPI,UPI-MANE NAVNEETHA-PAYTMQR66FHIY@PTYS-YE SB0PTMUPI-554289782668-UPI,0000554289782668,0.0,30.0,34691.31
25/06/25,UPI,UPI-ANGEL LTD NSE-ANGELONENSE@HDFCBANK-H DFC0MERUPI-554210981848-PAYINGANGELONE,0000554210981848,0.0,10000.0,24691.31
25/06/25,UPI,UPI-MADHU SUDHAN GHODKE-MADHUSUDHANGHOD KE@AXL-SBIN0005895-514615888756-PAYMENT FROM PHONE,0000514615888756,0.0,1000.0,23691.31
25/06/25,IMPS,IMPS-517615359039-M MADHU YADAV-KKBK-XXX XXX7813-CASH,0000517615359039,0.0,5000.0,18691.31
25/06/25,UPI,UPI-PHONEPE-BBPSBP@YBL-YESB0YBLUPI-09529 4041866-PAYMENT FROM PHONE,0000095294041866,0.0,4783.5,13907.81
25/06/25,UPI,UPI-RESHMA BEGUM-9573686388@AXL-SBIN002 0309-305474908743-PAYMENT FROM PHONE,0000305474908743,3600.0,0.0,17507.81
25/06/25,UPI,UPI-MOHD AHMED ALI-AQUA.AHMED98@AXL-UTIB 0001808-401028351463-PAYMENT FROM PHONE,0000401028351463,270.0,0.0,17777.81
25/06/25,IMPS,IMPS-517619322323-M MADHU YADAV-KKBK-XXX XXX7813-CASH,0000517619322323,0.0,4000.0,13777.81
25/06/25,UPI,UPI-MADHU SUDHAN GHODKE-MADHUSUDHANGHOD KE@AXL-SBIN0005895-603320737506-PAYMENT FROM PHONE,0000603320737506,200.0,0.0,13977.81
25/06/25,UPI,UPI-AIRTEL RECHARGE-AIRTELPREDIRECT2@AXL -UTIB0AXLUPI-891564306561-PAYMENT FROM P HONE,0000891564306561,0.0,202.0,13775.81
25/06/25,UPI,UPI-PHONEPE-BBPSBP@AXL-UTIB0AXLUPI-34632 4323247-PAYMENT FROM PHONE,0000346324323247,0.0,905.0,12870.81
25/06/25,IMPS,IMPS-517621374810-M MADHU YADAV-KKBK-XXX XXX7813-CASH,0000517621374810,0.0,500.0,12370.81
26/06/25,UPI,UPI-NARESH KUMAR YADAV-NARESHKUMARYADAV5 9426@YBL-UBIN0544884-517752648961-UPI,0000517752648961,0.0,500.0,11870.81
26/06/25,UPI,UPI-MR JURRU RAHUL YADA-Q758292524@YBL- YESB0YBLUPI-517764155471-UPI,0000517764155471,0.0,180.0,11690.81
26/06/25,UPI,UPI-TIRIVISETTY SATYANA-SATHISHREDDY648 61@AXL-SBIN0002731-517761144986-UPI,0000517761144986,0.0,1120.0,10570.81
26/06/25,UPI,UPI-NAGRAJ-MUKKERLANAGRAJ@OKAXIS-UBIN080 3219-517711489123-UPI,0000517711489123,180.0,0.0,10750.81
26/06/25,UPI,UPI-JANARDHAN FILL POINT-PAYTM.D14688511 995@PTY-YESB0MCHUPI-517782755939-UPI,0000517782755939,0.0,350.0,10400.81
26/06/25,UPI,UPI-JAI SANTHOSHI MATHA-GPAY-11256386643 @OKBIZAXIS-UTIB0000553-517783140133-UPI,0000517783140133,0.0,10.0,10390.81
26/06/25,NEFT,NEFT CR-FDRL0009993-IKF HOME FINANCE LIM ITED-MUKKERLA MADHU-FDRLN520250626423676,FDRLN52025062642,224917.0,0.0,235307.81
26/06/25,UPI,UPI-GANTA SUJATHA-SUJATHAGANAT13@OKSBI- SBIN0005895-517702359337-UPI,0000517702359337,0.0,10000.0,225307.81
26/06/25,IMPS,IMPS-517715384180-SRIDEVI JT1-ICIC-XXXXX XXX3198-CASH,0000517715384180,0.0,14000.0,211307.81
26/06/25,IMPS,IMPS-517715380942-MUKKERLA MADHU-SBIN-XX XXXXX5940-CASH,0000517715380942,0.0,100000.0,111307.81
26/06/25,UPI,UPI-JIO RECHARGE-JIOINAPPDIRECT@YBL-YESB 0YBLUPI-989482154284-PAYMENT FROM PHONE,0000989482154284,0.0,352.0,110955.81
26/06/25,UPI,UPI-MARGAM VANI-VANIMARGAM510-1@OKHDFCB ANK-SBIN0021100-517738377129-UPI,0000517738377129,0.0,50000.0,60955.81
26/06/25,IMPS,IMPS-517716306458-M MADHU YADAV-KKBK-XXX XXX7813-CASH,0000517716306458,0.0,30000.0,30955.81
26/06/25,UPI,UPI-GROWCAP CREDITWISE P-GROWCAPCREDITWI 723531.RZP@RXAXIS-UTIB0000RZP-5177739804 28-EMIPAYMENT,0000517773980428,0.0,20808.0,10147.81
26/06/25,NEFT,NEFT CR-YESB0000001-TYCOON CREDIT AND P ORTFOLIOS LIMIT-MUKKERLAMADHUYADAV-YESBN,YESBN12025062606,17206.4,0.0,27354.21
26/06/25,UPI,UPI-RAPARTI SRIHARI-LIBERTYSRIHARI@OKSBI -BKID0008627-517734401750-UPI,0000517734401750,50000.0,0.0,77354.21
26/06/25,IMPS,IMPS-517720378343-M MADHU YADAV-KKBK-XXX XXX7813-CASH,0000517720378343,0.0,30000.0,47354.21
26/06/25,NEFT,NEFT CR-ICIC0099999-ANGEL ONE LIMITED-MU KKERLA MADHU YADAV-ICICN220250626298519,ICICN22025062629,133.94,0.0,47488.15
27/06/25,UPI,UPI-NARESH KUMAR YADAV-NARESHKUMARYADAV5 9426@YBL-UBIN0544884-554408525596-UPI,0000554408525596,0.0,500.0,46988.15
27/06/25,UPI,UPI-MR JURRU RAHUL YADA-Q758292524@YBL- YESB0YBLUPI-554481211304-UPI,0000554481211304,0.0,180.0,46808.15
27/06/25,UPI,UPI-MUNTHA RAMESH YADAV-RAMEESHM6666@YBL -BKID0008604-615786668895-PAYMENT FROM P HONE,0000615786668895,0.0,8000.0,38808.15
27/06/25,UPI,UPI-PADALALAKSHMI-Q525257353@YBL-YESB0YB LUPI-517822391473-UPI,0000517822391473,0.0,30.0,38778.15
27/06/25,UPI,UPI-MANE NAVNEETHA-PAYTMQR66FHIY@PTYS-YE SB0PTMUPI-517865396954-UPI,0000517865396954,0.0,30.0,38748.15
27/06/25,UPI,UPI-MOHD ABDUL WASEEM-GPAY-11259121323@O KBIZAXIS-UTIB0000553-554499709759-UPI,0000554499709759,0.0,20.0,38728.15
27/06/25,UPI,UPI-BRANCH-CF.BRANCH@CASHFREENSDLPB-NSPB 0000011-554474003339-BRANCH PAYMENT,0000554474003339,0.0,1772.0,36956.15
27/06/25,UPI,UPI-MANINDER REDDY M-PAYTMQR6EW5I6@PTYS- YESB0PTMUPI-554485106956-UPI,0000554485106956,0.0,20.0,36936.15
27/06/25,UPI,UPI-MANINDER REDDY M-PAYTMQR6EW5I6@PTYS- YESB0PTMUPI-554491513972-UPI,0000554491513972,0.0,20.0,36916.15
27/06/25,UPI,UPI-LAXMI NARAYAN-BHOLENATHGAMING73-2@OK AXIS-BKID0006610-652030379686-PAYMENT FR OM PHONE,0000652030379686,0.0,1000.0,35916.15
27/06/25,UPI,UPI-M ANIL YADAV-9966254742@YBL-ANDB0000 321-554446926762-UPI,0000554446926762,0.0,600.0,35316.15
27/06/25,UPI,UPI-MRS BHAIRAVA MANASA-9701220087@YBL- CBIN0284811-497533720974-PAYMENT FROM PH ONE,0000497533720974,1000.0,0.0,36316.15
27/06/25,UPI,UPI-MRS SARITHA SARITH-Q188068020@YBL- YESB0YBLUPI-554472048586-UPI,0000554472048586,0.0,230.0,36086.15
28/06/25,UPI,UPI-MR JURRU RAHUL YADA-Q758292524@YBL- YESB0YBLUPI-554548174138-UPI,0000554548174138,0.0,90.0,35996.15
28/06/25,UPI,UPI-PADALALAKSHMI-Q525257353@YBL-YESB0YB LUPI-554507863954-UPI,0000554507863954,0.0,30.0,35966.15
28/06/25,UPI,UPI-MR MARYPEDDY YADAIAH-PAYTMQR5WD1F4@P TYS-YESB0PTMUPI-554571475625-UPI,0000554571475625,0.0,45.0,35921.15
28/06/25,UPI,UPI-RAMINI LAXMAN-PAYTMQR6F3VN1@PTYS-YES B0PTMUPI-554562473643-UPI,0000554562473643,0.0,36.0,35885.15
28/06/25,UPI,UPI-PARWARE VIJAY-9912136122-3@YBL-SBIN 0007640-341749087729-PAYMENT FROM PHONE,0000341749087729,0.0,50.0,35835.15
28/06/25,,K4SX24ELAB72HNG3CY/PAYUAMAZON,0002517988115361,0.0,443.0,35392.15
28/06/25,UPI,UPI-HP PETROL PUMP PETR-Q236046549@YBL- YESB0YBLUPI-554520985784-UPI,0000554520985784,0.0,250.0,35142.15
28/06/25,UPI,UPI-KAJAL DEVI-Q545597107@YBL-YESB0YBLUP I-517978214666-UPI,0000517978214666,0.0,20.0,35122.15
28/06/25,UPI,UPI-GANTA SUJATHA-SUJATHAGANAT13@OKSBI- SBIN0005895-517946708832-UPI,0000517946708832,0.0,5000.0,30122.15
28/06/25,UPI,UPI-KOLLAPURAM MALLIKARJ-MALLIKARJUNKOLA PURAM@OKSBI-HDFC0000218-517924119331-UPI,0000517924119331,0.0,100.0,30022.15
28/06/25,IMPS,IMPS-517921362969-M MADHU YADAV-KKBK-XXX XXX7813-CASH,0000517921362969,0.0,5000.0,25022.15
29/06/25,UPI,UPI-MR JURRU RAHUL YADA-Q758292524@YBL- YESB0YBLUPI-518069725008-UPI,0000518069725008,0.0,150.0,24872.15
29/06/25,UPI,UPI-DAMODAR NAYAK-PAYTMQR3WBWCQEK4N@PAYT M-YESB0PTMUPI-518040029576-UPI,0000518040029576,0.0,140.0,24732.15
29/06/25,UPI,UPI-A LAXMI-Q655807646@YBL-YESB0YBLUPI-5 18045639335-UPI,0000518045639335,0.0,20.0,24712.15
29/06/25,UPI,UPI-SRI BALAJI BAKERY-PAYTMQR6EC847@PTYS -YESB0PTMUPI-518078527938-UPI,0000518078527938,0.0,20.0,24692.15
29/06/25,UPI,UPI-LAXMI NARAYAN-BHOLENATHGAMING73-2@OK AXIS-BKID0006610-741430300948-PAYMENT FR OM PHONE,0000741430300948,0.0,1000.0,23692.15
29/06/25,UPI,UPI-SRI GOOD DAY BAR RE-PAYTMQR19ULEN4X A3@PAYTM-YESB0PTMUPI-518045548817-UPI,0000518045548817,0.0,500.0,23192.15
29/06/25,UPI,UPI-MOHD AHMED ALI-AQUA.AHMED98@AXL-UTIB 0001808-277681289349-PAYMENT FROM PHONE,0000277681289349,180.0,0.0,23372.15
29/06/25,UPI,UPI-BABU YADAV-Q564410470@YBL-YESB0YBLUP I-518084462352-UPI,0000518084462352,0.0,70.0,23302.15
29/06/25,UPI,UPI-JB PAPER PRODUCT-9052220908-4@IBL-HD FC0000081-242924686914-PAYMENT FROM PHON E,0000242924686914,100000.0,0.0,123302.15
29/06/25,UPI,UPI-VADICHERLA PRADEEP K-9293555325-3@YB L-HDFC0001635-177671807952-PAYMENT FROM PHONE,0000177671807952,0.0,500.0,122802.15
29/06/25,UPI,UPI-LIBERTYSRIHARIOKICIC-LIBERTYSRIHARI@ OKICICI-BKID0008627-518063368830-UPI,0000518063368830,0.0,1300.0,121502.15
29/06/25,UPI,UPI-LIBERTYSRIHARIOKICIC-LIBERTYSRIHARI@ OKICICI-BKID0008627-518079077508-UPI,0000518079077508,0.0,650.0,120852.15
29/06/25,UPI,UPI-ANGEL LTD NSE-ANGELONENSE@HDFCBANK-H DFC0MERUPI-518074873632-PAYINGANGELONE,0000518074873632,0.0,40000.0,80852.15
29/06/25,UPI,UPI-RULOANS FINANCIAL SE-RFSPL.ESBZ@ICIC I-ICIC0DC0099-518045769730-PAY,0000518045769730,0.0,25936.18,54915.97
29/06/25,IMPS,IMPS-518021491399-AURO FINTECH PRIVATE L IMITED-NSPB-XXXXXXXX6355-PENNY DROP,0000518021491399,1.0,0.0,54916.97
29/06/25,UPI,UPI-FDPL FINANCE-FDPLFINANCE@ICICI-ICIC0 DC0099-518093975793-UPI,0000518093975793,0.0,8224.22,46692.75
29/06/25,IMPS,IMPS-518021312002-M MADHU YADAV-KKBK-XXX XXX7813-CASH,0000518021312002,0.0,26000.0,20692.75
29/06/25,UPI,UPI-ZERODHA BROKING LTD-ZERODHABROKING@H DFCBANK-HDFC0MERUPI-518084188288-7482089 430350616 Z,0000518084188288,0.0,15000.0,5692.75
30/06/25,IMPS,IMPS-518106356930-M MADHU YADAV-KKBK-XXX XXX7813-CASH,0000518106356930,0.0,1000.0,4692.75
30/06/25,NEFT,NEFT CR-YESB0000001-RULOANS FINANCIAL SE RVICES PVT LTD -M MADHU YADAV-YESBN12025,YESBN12025063005,21460.0,0.0,26152.75
30/06/25,IMPS,IMPS-518114360652-M MADHU YADAV-KKBK-XXX XXX7813-CASH,0000518114360652,0.0,20000.0,6152.75
30/06/25,NEFT,NEFT CR-ICIC0SF0002-FDPL FINANCE PRIVATE LIMITED-MMADHUYADAV-ICICN42025063058476,ICICN42025063058,7292.0,0.0,13444.75
30/06/25,IMPS,IMPS-518116348128-M MADHU YADAV-KKBK-XXX XXX7813-CASH,0000518116348128,0.0,5100.0,8344.75
30/06/25,UPI,UPI-MR MADHU SUDHAN GHO-MADHUSUDHANGHOD KE2@YBL-MAHB0000383-308855936512-PAYMENT FROM PHONE,0000308855936512,200.0,0.0,8544.75
30/06/25,UPI,UPI-MR MADHU SUDHAN GHO-MADHUSUDHANGHOD KE2@AXL-MAHB0000383-134744368519-PAYMENT FROM PHONE,0000134744368519,150.0,0.0,8694.75
30/06/25,NEFT,NEFT CR-ICIC0099999-ANGEL ONE LIMITED-MU KKERLA MADHU YADAV-ICICN220250630336737,ICICN22025063033,6000.0,0.0,14694.75
30/06/25,UPI,UPI-SANDHYA SINGH-8919937047@AXL-UTIB00 00192-888238647290-PAYMENT FROM PHONE,0000888238647290,30000.0,0.0,44694.75
30/06/25,UPI,UPI-NIKITHA T-NIKI13048-1@OKICICI-ICIC00 00202-554751148997-UPI,0000554751148997,1.0,0.0,44695.75
30/06/25,UPI,UPI-SAVITHA TEDEWALE-8886220809-2@IBL-S BIN0001880-642995615652-PAYMENT FROM PHO NE,0000642995615652,10000.0,0.0,54695.75
30/06/25,IMPS,IMPS-518121329015-M MADHU YADAV-KKBK-XXX XXX7813-CASH,0000518121329015,0.0,2000.0,52695.75
30/06/25,UPI,UPI-RK BANSAL FINANCE-RKBANSALFINANCE588 995.RZP@RXAXIS-UTIB0000RZP-554795230792- REPAYMENTLOANAMOUN,0000554795230792,0.0,24800.0,27895.75
30/06/25,,BHDFV0L0OZ4RDT/BILLDKRATNAKARBANKLI,0002518188328744,0.0,6857.0,21038.75
30/06/25,UPI,UPI-NIKITHA T-NIKI13048-1@OKICICI-ICIC00 00202-554753439293-UPI,0000554753439293,99999.0,0.0,121037.75
30/06/25,IMPS,IMPS-518125610775-R K BANSAL FINANCE PRI VATE LIM-RATN-XXXXXXXX8321-RKBANSALFINAN CEPLTDFUND,0000518125610775,17640.0,0.0,138677.75
30/06/25,UPI,UPI-ZERODHA BROKING LTD-ZERODHABROKING@H DFCBANK-HDFC0MERUPI-554726249902-6458964 336679149 Z,0000554726249902,0.0,15000.0,123677.75
30/06/25,IMPS,IMPS-518122361572-M MADHU YADAV-KKBK-XXX XXX7813-CASH,0000518122361572,0.0,46000.0,77677.75
30/06/25,UPI,UPI-MRS BHAIRAVA MANASA-9701220087@AXL- CBIN0284811-447427721024-PAYMENT FROM PH ONE,0000447427721024,1000.0,0.0,78677.75
01/07/25,,INTEREST PAID TILL 30-JUN-2025,000000000000000,208.0,0.0,78885.75
01/07/25,NEFT,NEFT CR-YESB0000001-ZERODHA BROKING LTD- DSCNB A/C-MUKKERLA MADHU YADAV-YESBN1202,YESBN12025070101,5000.0,0.0,83885.75
01/07/25,UPI,UPI-MUKKERLA GEETA SUDHA-GEETHAMUKKERLA- 1@OKAXIS-KKBK0007463-554817549116-UPI,0000554817549116,0.0,6000.0,77885.75
01/07/25,UPI,UPI-NARESH KUMAR YADAV-NARESHKUMARYADAV5 9426@YBL-UBIN0544884-554898250474-UPI,0000554898250474,0.0,200.0,77685.75
01/07/25,UPI,UPI-MR JURRU RAHUL YADA-Q758292524@YBL- YESB0YBLUPI-554815240464-UPI,0000554815240464,0.0,180.0,77505.75
01/07/25,UPI,UPI-ANGEL LTD NSE-ANGELONENSE@HDFCBANK-H DFC0MERUPI-554877049141-PAYINGANGELONE,0000554877049141,0.0,50000.0,27505.75
01/07/25,UPI,UPI-NAGRAJ-MUKKERLANAGRAJ@OKAXIS-UBIN080 3219-518266061878-UPI,0000518266061878,319.0,0.0,27824.75
01/07/25,UPI,UPI-DAMODAR NAYAK-PAYTMQR3WBWCQEK4N@PAYT M-YESB0PTMUPI-554872643845-UPI,0000554872643845,0.0,35.0,27789.75
01/07/25,UPI,UPI-MANE NAVNEETHA-PAYTMQR66FHIY@PTYS-YE SB0PTMUPI-554876154088-UPI,0000554876154088,0.0,40.0,27749.75
01/07/25,UPI,UPI-SAMUDHRALA MANASA-MANASA31961@AXL-SB IN0RRDCGB-461398635086-PAYMENT FROM PHON E,0000461398635086,2700.0,0.0,30449.75
01/07/25,UPI,UPI-MR BIKSHAPATHI BIKS-Q791228448@YBL- ALI-AQUA.AHMED98@YBL-UTIB 0001808-876874645495-PAYMENT FROM PHONE,0000554867854439,0.0,10.0,30439.75
01/07/25,UPI,UPI-MAHENDRA JALA-JALAMAHENDRA@OKAXIS-K KBK0007466-554857565534-UPI,0000554857565534,0.0,16000.0,14439.75
01/07/25,UPI,UPI-MRS R VANDANA-Q021206969@YBL-YESB0Y BLUPI-554838752480-UPI,0000554838752480,0.0,50.0,14389.75
01/07/25,UPI,UPI-ZERODHA BROKING LTD-ZERODHABROKING@H DFCBANK-HDFC0MERUPI-554802866110-5621161 721594360 Z,0000554802866110,0.0,1800.0,12589.75
01/07/25,UPI,UPI-MOHD PASHA MIYA-8074523914@YBL-LAVB0 000572-805470117434-PAYMENT FROM PHONE,0000805470117434,0.0,600.0,11989.75
01/07/25,UPI,UPI-FREO PAY-FREOPAY.PAYU@ICICI-ICIC0DC0 099-554884580852-UPIINTENT,0000554884580852,0.0,1202.02,10787.73
01/07/25,IMPS,IMPS-518225560063-TAPSTART CAPITAL PVT L TD-RATN-XXXXXXXX6589-WITHDRAWAL,0000518225560063,3572.55,0.0,14360.28
01/07/25,UPI,UPI-MR JURRU RAHUL YADA-Q758292524@YBL- YESB0YBLUPI-554893989393-UPI,0000554893989393,0.0,200.0,14160.28
01/07/25,UPI,UPI-MOHD AHMED ALI-AQUA.AHMED98@AXL-UTIB 0001808-207292782381-PAYMENT FROM PHONE,0000207292782381,180.0,0.0,14340.28
01/07/25,IMPS,IMPS-518220373457-M MADHU YADAV-KKBK-XXX XXX7813-CASH,0000518220373457,0.0,2500.0,11840.28
02/07/25,UPI,UPI-LAKSHMI APPALA-LAKSHME1202@OKAXIS-S BIN0005895-554946737750-UPI,0000554946737750,900.0,0.0,12740.28
02/07/25,UPI,UPI-MR JURRU RAHUL YADA-Q758292524@YBL- YESB0YBLUPI-518348504739-UPI,0000518348504739,0.0,360.0,12380.28
02/07/25,UPI,UPI-GOGIKAR DEEPIKA APPALA-LAKSHME1202@OKSBI-SB IN0005895-506120957734-UPI,0000518375312853,0.0,700.0,11680.28
02/07/25,,ANGEL ONE LIMI-260422959,0000507020532927,18000.0,0.0,29680.28
02/07/25,UPI,UPI-PANYAM MANJULA-MANJUPANYAM@OKSBI-SB IN0007641-518309027053-MILK,0000518309027053,2040.0,0.0,31720.28
02/07/25,UPI,UPI-MUKKERLA GEETA SUDHA-GEETHAMUKKERLA- 1@OKAXIS-KKBK0007463-518358408787-UPI,0000518358408787,0.0,25600.0,6120.28
02/07/25,UPI,UPI-MUKKERLA GEETA SUDHA-GEETHAMUKKERLA- 1@OKAXIS-KKBK0007463-554960956256-UPI,0000554960956256,50000.0,0.0,56120.28
02/07/25,UPI,UPI-ABSIPURAM KARUNAKAR-9000103377@YBL- SBIN0020083-922147499089-PAYMENT FROM PH ONE,0000922147499089,2560.0,0.0,58680.28
02/07/25,UPI,UPI-AKSHAY CHINTALA-9849868607@YESCRED- CNRB0000033-554931006071-PAID VIA CRED,0000554931006071,170.0,0.0,58850.28
02/07/25,UPI,UPI-DISHA BANSAL-BANSALDISHA918@OKICIC I-KKBK0007463-518382121070-UPI,0000518382121070,2160.0,0.0,61010.28
02/07/25,UPI,UPI-VARTHYAVATH THIRUPA-THIRUPATI1981NA IK-1@OKSBI-SBIN0021009-518322368032-UPI,0000518322368032,2250.0,0.0,63260.28
02/07/25,UPI,UPI-ANGEL LTD NSE-ANGELONENSE@HDFCBANK-H DFC0MERUPI-518335636242-PAYINGANGELONE,0000518335636242,0.0,18000.0,45260.28
02/07/25,UPI,UPI-ANGEL LTD NSE-ANGELONENSE@HDFCBANK-H DFC0MERUPI-518343635973-PAYINGANGELONE,0000518343635973,0.0,500.0,44760.28
02/07/25,UPI,UPI-RAJESH C YADAV-Q758292524@YBL-YE SB0YBLUPI-542855087088-UPI,0000554905872702,1625.0,0.0,46385.28
02/07/25,UPI,UPI-RAPARTI SRIHARI-LIBERTYSRIHARI@OKICI CI-BKID0008627-334850855728-PAYMENT FROM PHONE,0000334850855728,0.0,10000.0,36385.28
02/07/25,UPI,UPI-RAPARTI SRIHARI-LIBERTYSRIHARI@OKICI CI-BKID0008627-253925017689-PAYMENT FROM PHONE,0000253925017689,0.0,13000.0,23385.28
02/07/25,UPI,UPI-ORUGANTI SRINIVAS RE-OSRINIVAS555@OK AXIS-UTIB0000426-518371002734-UPI,0000518371002734,1500.0,0.0,24885.28
02/07/25,UPI,UPI-SASHIKALA BHANDARI-9032117972@YBL-S BIN0005895-626206955335-PAYMENT FROM PHO NE,0000626206955335,1425.0,0.0,26310.28
02/07/25,NEFT,NEFT CR-ICIC0099999-ANGEL ONE LIMITED-MU KKERLA MADHU YADAV-ICICN220250702365555,ICICN22025070236,25000.0,0.0,51310.28
02/07/25,UPI,UPI-BHARGAVI BUDUMURU-6303219486@AXL-SB IN0020784-237674514654-PAYMENT FROM PHON E,0000237674514654,460.0,0.0,51770.28
02/07/25,IMPS,IMPS-518320382565-M MADHU YADAV-KKBK-XXX XXX7813-CASH,0000518320382565,0.0,3000.0,48770.28
03/07/25,UPI,UPI-MR JURRU RAHUL YADA-Q758292524@YBL- YESB0YBLUPI-518405375205-UPI,0000518405375205,0.0,300.0,48470.28
03/07/25,UPI,UPI-DEEP SHIKHA GUPTA-AKG03071965@OKSBI- BARB0HIMHYD-518435986244-UPI,0000518435986244,0.0,1500.0,46970.28
03/07/25,UPI,UPI-SRI BALAJI BAKERY-PAYTMQR6EC847@PTYS -YESB0PTMUPI-518408486994-UPI,0000518408486994,0.0,75.0,46895.28
03/07/25,UPI,UPI-SANGARAJ,0000518466579214,0.0,50.0,46845.28
03/07/25,UPI,UPI-KOUR H-HARDEEPKOUR24@OKAXIS-HSBC0500 002-518402247957-UPI,0000518402247957,350.0,0.0,47195.28
03/07/25,UPI,UPI-GOGA ELECTRONICS-9849436607@YBL-APMC 0000006-609315529392-PAYMENT FROM PHONE,0000609315529392,4950.0,0.0,52145.28
03/07/25,UPI,UPI-MR SUHAS MADHUKAR CH-DRSUHAS2003@OKI CICI-IDIB000M238-518419894213-UPI,0000518419894213,2520.0,0.0,54665.28
03/07/25,UPI,UPI-PAWAN KUMAR BASANT-9903315499@AXISB- IDFB0040101-518464520713-PAID VIA CRED,0000518464520713,820.0,0.0,55485.28
03/07/25,UPI,UPI-ANGEL LTD NSE-ANGELONENSE@HDFCBANK-H DFC0MERUPI-518421688133-PAYINGANGELONE,0000518421688133,0.0,6200.0,49285.28
03/07/25,POS,CASH DEPOSIT-416021XXXXXX2657-BARKATPURA,0000000000001612,9100.0,0.0,58385.28
03/07/25,UPI,UPI-M MADHU YADAV-9985065404-2@AXL-SBIN 0006645-323980385013-PAYMENT FROM PHONE,0000323980385013,4800.0,0.0,63185.28
03/07/25,UPI,UPI-LIBERTYSRIHARIOKICIC-LIBERTYSRIHARI@ OKICICI-BKID0008627-555033909018-UPI,0000555033909018,0.0,59800.0,3385.28
03/07/25,UPI,UPI-AYUB KHAN-9581654678@YBL-KKBK000744 6-555017515528-UPI,0000555017515528,0.0,80.0,3305.28
03/07/25,UPI,UPI-K S CONSTRUCTIONS-9393995648-2@YBL-A UBL0002591-622924030856-PAYMENT FROM PHO NE,0000622924030856,300.0,0.0,3605.28
03/07/25,UPI,UPI-MR MOHAMMED ZAHEER-MOHAMMEDZAHEER511 -1@OKICICI-IDIB000T601-555094110720-UPI,0000555094110720,2300.0,0.0,5905.28
03/07/25,NEFT,NEFT CR-ICIC0099999-ANGEL ONE LIMITED-MU KKERLA MADHU YADAV-ICICN220250703376524,ICICN22025070337,20000.0,0.0,25905.28
03/07/25,UPI,UPI-RAPARTHI SRI HARI-LIBERTYSRIHARI-1@O KAXIS-KKBK0000563-555093913340-NEW 1 LAK H AMOUNT,0000555093913340,50000.0,0.0,75905.28
03/07/25,UPI,UPI-RAPARTI SRIHARI-LIBERTYSRIHARI@OKAXI S-BKID0008627-555036411736-DAILY 1300 IN TO 1,0000555036411736,50000.0,0.0,125905.28
03/07/25,IMPS,IMPS-518421312286-M MADHU YADAV-KKBK-XXX XXX7813-CASH,0000518421312286,0.0,30000.0,95905.28
03/07/25,UPI,UPI-ANGEL LTD NSE-ANGELONENSE@HDFCBANK-H DFC0MERUPI-555074038859-PAYINGANGELONE,0000555074038859,0.0,20000.0,75905.28
04/07/25,NEFT,NEFT CR-UNBA000BHPE-BHARAT PE-M MADHU YA DAV-UNBAN52025070497685833,UNBAN52025070497,200.0,0.0,76105.28
04/07/25,UPI,UPI-MONEYVIEW-MONEYVIEW.EASEBUZZ@KOTAK-K KBK0000958-555151951295-PAY,0000555151951295,0.0,7460.0,68645.28
04/07/25,UPI,UPI-MR JURRU RAHUL YADA-Q758292524@YBL- YESB0YBLUPI-555173137060-UPI,0000555173137060,0.0,300.0,68345.28
04/07/25,UPI,UPI-MUKKERLA GEETA SUDHA-GEETHAMUKKERLA- 1@OKAXIS-KKBK0007463-555193155177-UPI,0000555193155177,0.0,3000.0,65345.28
04/07/25,UPI,UPI-SOMALWAR SHRINIVAS-SOMALWAR73@OKSBI -SBIN0010356-518513559959-UPI,0000518513559959,2400.0,0.0,67745.28
04/07/25,,ACH D- PROTIUM FINANCE LIMI-OU8UJ99DUUZA,0000000372252340,0.0,28475.0,39270.28
04/07/25,UPI,UPI-RAPARTI SRIHARI-LIBERTYSRIHARI@OKICI 008627-082270876227-PAYMENT FROM PHONE,0000472080261614,0.0,10000.0,29270.28
04/07/25,,ANGEL ONE LIMI-W24CZ4YKTNHJO1,0000507046239643,29000.0,0.0,58270.28
04/07/25,UPI,UPI-PREMLATA MARDA-8639436017@PNB-PUNB00 50201-518559519814-PAY REQUEST,0000518559519814,350.0,0.0,58620.28
04/07/25,UPI,UPI-MADHURI MARAM-LIPIKAMARAM@OKICICI-IC IC0000008-555132386567-UPI,0000555132386567,3000.0,0.0,61620.28
04/07/25,UPI,UPI-M MADHU YADAV-9985065404-2@AXL-SBIN 0006645-421881886870-PAYMENT FROM PHONE,0000421881886870,5500.0,0.0,67120.28
04/07/25,UPI,UPI-RAPARTI SRIHARI-LIBERTYSRIHARI@OKICI CI-BKID0008627-262479073771-PAYMENT FROM PHONE,0000262479073771,0.0,65000.0,2120.28
04/07/25,UPI,UPI-MUKKERLA GEETA SUDHA-GEETHAMUKKERLA- 1@OKAXIS-KKBK0007463-518517815020-UPI,0000518517815020,0.0,500.0,1620.28
04/07/25,UPI,UPI-KARRA SATHISH-VPKYADAV28-5@OKHDFCBAN K-BKID0005707-518542207530-UPI,0000518542207530,0.0,1500.0,120.28
04/07/25,UPI,UPI-RAPARTHI SRI HARI-9493207195-2@YBL-K KBK0000563-894023853794-PAYMENT FROM PHO NE,0000894023853794,50000.0,0.0,50120.28
04/07/25,UPI,UPI-RAPARTI SRIHARI-9493207195@YBL-BKID0 008627-097998533867-PAYMENT FROM PHONE,0000097998533867,5000.0,0.0,55120.28
04/07/25,UPI,UPI-RAPARTI SRIHARI-9493207195@YBL-BKID0 008627-343421093736-PAYMENT FROM PHONE,0000343421093736,45000.0,0.0,100120.28
04/07/25,UPI,UPI-LIBERTYSRIHARIOKICIC-LIBERTYSRIHARI@ OKICICI-BKID0008627-518544312109-UPI,0000518544312109,0.0,650.0,99470.28
04/07/25,UPI,UPI-LIBERTYSRIHARIOKICIC-LIBERTYSRIHARI@ OKICICI-BKID0008627-555115098756-UPI,0000555115098756,0.0,1300.0,98170.28
05/07/25,NEFT,NEFT CR-UNBA000BHPE-BHARAT PE-M MADHU 2336175-PAYMENT FROM PHONE,UNBAN52025070599,500.0,0.0,98670.28
05/07/25,UPI,UPI-MR JURRU RAHUL YADA-Q758292524@YBL- YESB0YBLUPI-518665624712-UPI,0000518665624712,0.0,240.0,98430.28
05/07/25,POS,CASH DEPOSIT-XXXXXXXXXX1847-HIMAYATNAGAR,0000000000009567,8500.0,0.0,106930.28
05/07/25,UPI,UPI-MURALIKRISHNA VEGETA-GPAY-1124438713 1@OKBIZAXIS-UTIB0000553-518642517504-UPI,0000518642517504,0.0,400.0,106530.28
05/07/25,,ANGEL ONE LIMI-1046933212,0000507057889871,441.55,0.0,106971.83
05/07/25,IMPS,IMPS-518609323568-M MADHU YADAV-KKBK-XXX XXX7813-CASH,0000518609323568,0.0,30000.0,76971.83
05/07/25,UPI,UPI-AMIT CHARAN-PAYTMQR6CYVFT@PTYS-YESB0 PTMUPI-518690626006-UPI,0000518690626006,0.0,25.0,76946.83
05/07/25,,ACH D- IKF HOME FINANCE LTD-050720250517,0000000453221334,0.0,23828.0,53118.83
05/07/25,UPI,UPI-M ANIL YADAV-9966254742@YBL-ANDB0000 321-518609145408-UPI,0000518609145408,0.0,600.0,52518.83
05/07/25,UPI,UPI-BHAIRAVA YADAV-SRIKANTHBHAIRAVA16-2@ OKSBI-TGRB0000001-518644151244-UPI,0000518644151244,0.0,2000.0,50518.83
05/07/25,IMPS,IMPS-518616397727-M MADHU YADAV-KKBK-XXX XXX7813-CASH,0000518616397727,0.0,30000.0,20518.83
05/07/25,UPI,UPI-B SHIRISHA-SIRISHA0413@YBL-UBIN08007 67-813605859980-PAYMENT FROM PHONE,0000813605859980,2250.0,0.0,22768.83
05/07/25,UPI,UPI-SIR MOUHAR-GURJARMANTRAM524@OKHDFCBA NK-BARB0TARHAT-518651258063-UPI,0000518651258063,0.0,400.0,22368.83
05/07/25,UPI,UPI-CHATAMONI KRISHNAIAH-BAJAJPAY.687972 UBIN0803219-543026032115-UPI,0000518690661617,0.0,30.0,22338.83
05/07/25,UPI,UPI-MUKELRA VANI-VANIRAJESHYADAV@OKAXIS- BARB0MALKAJ-518627564977-UPI,0000518627564977,0.0,30.0,22308.83
05/07/25,UPI,UPI-MOHD AHMED ALI-AQUA.AHMED98@AXL-UTIB 0001808-333586900208-PAYMENT FROM PHONE,0000333586900208,180.0,0.0,22488.83
05/07/25,UPI,UPI-KARRA SATHISH-9293555325-7@AXL-BKID0 005707-518609774835-UPI,0000518609774835,0.0,1500.0,20988.83
05/07/25,IMPS,IMPS-518621320932-M MADHU YADAV-KKBK-XXX XXX7813-CASH,0000518621320932,0.0,3000.0,17988.83
05/07/25,,IB BILLPAY DR-HDFC92-434155XXXXXX1025,MB05211151950T41,0.0,10741.0,7247.83
06/07/25,NEFT,NEFT CR-UNBA000BHPE-BHARAT PE-M MADHU YA DAV-UNBAN52025070600641108,UNBAN52025070600,400.0,0.0,7647.83
06/07/25,UPI,UPI-NARESH KUMAR YADAV S-8712314023@UPI- BKID0005862-518743386890-UPI,0000518743386890,0.0,200.0,7447.83
06/07/25,UPI,UPI-CHAVALI LAVANYA-9490255943@YBL-CNRB0 000000-587541032050-PAYMENT FROM PHONE,0000587541032050,1900.0,0.0,9347.83
06/07/25,UPI,UPI-M ANIL YADAV-ANILYADAV63473-2@OKAXIS -UBIN0803219-555312420983-UPI,0000555312420983,9785.0,0.0,19132.83
06/07/25,UPI,UPI-M ANIL YADAV-ANILYADAV63473-2@OKAXIS -UBIN0803219-518758199830-UPI,0000518758199830,0.0,1.0,19131.83
06/07/25,UPI,UPI-M ANIL YADAV-53933315@YBL-UBIN080321 9-762328679875-PAYMENT FROM PHONE,0000762328679875,1.0,0.0,19132.83
06/07/25,UPI,UPI-MUNTHA RAMESH YADAV-RAMEESHM6666@YBL ALI-AQUA.AHMED98@AXL-UTIB 0001808-547827734485-PAYMENT FROM PHONE,0000882672928748,0.0,10000.0,9132.83
06/07/25,UPI,UPI-M ANIL YADAV-53933315@YBL-UBIN080321 9-604849200558-PAYMENT FROM PHONE,0000604849200558,1.0,0.0,9133.83
06/07/25,UPI,UPI-MAHAVIR SETHI-9392489604@AXL-SBIN00 05895-334547313805-PAYMENT FROM PHONE,0000334547313805,1175.0,0.0,10308.83
06/07/25,UPI,UPI-RAPARTI SRIHARI-LIBERTYSRIHARI@OKICI CI-BKID0008627-811391663556-PAYMENT FROM PHONE,0000811391663556,0.0,1500.0,8808.83
06/07/25,UPI,UPI-BALA KASHYAP-BALA.KASHYAP1@YBL-HDFC0 000126-800199545085-PAYMENT FROM PHONE,0000800199545085,910.0,0.0,9718.83
06/07/25,UPI,UPI-LIBERTYSRIHARIOKICIC-LIBERTYSRIHARI@ OKICICI-BKID0008627-555305039674-UPI,0000555305039674,0.0,650.0,9068.83
06/07/25,UPI,UPI-RONAK NEELESH RUPARA-KUMARRONAK7@OKA XIS-HDFC0000545-555384685506-REMAINING B ALANCE,0000555384685506,58.0,0.0,9126.83
07/07/25,UPI,UPI-MR JURRU RAHUL YADA-Q758292524@YBL- YESB0YBLUPI-555436159580-UPI,0000555436159580,0.0,300.0,8826.83
07/07/25,UPI,UPI-LAGADAPATI CHANDRA S-Q410941234@YBL- YESB0YBLUPI-555414649307-UPI,0000555414649307,0.0,45.0,8781.83
07/07/25,UPI,UPI-RAVI MANE-PAYTM.S1HP9L9@PTY-YESB0MCH UPI-555461036207-UPI,0000555461036207,0.0,40.0,8741.83
07/07/25,UPI,UPI-MR MADHU SUDHAN GHOD-MADHUSUDHANGHOD KE-2@OKHDFCBANK-MAHB0000383-107668399883 -UPI,0000107668399883,200.0,0.0,8941.83
07/07/25,UPI,UPI-KATEPALLY VINAY KUM-VINAYKUMARKATEP E,0000518894231995,170.0,0.0,9111.83
07/07/25,UPI,UPI-CHATAMONI KRISHNAIAH-BAJAJPAY.687972 9.05882152@INDUS-INDB0MERCHA-55546686423 3-UPI,0000555466864233,0.0,45.0,9066.83
07/07/25,UPI,UPI-RATNADEEP SUPERMARKE-PAYTM-64471141@ PTYS-YESB0PTMUPI-555411370633-UPI,0000555411370633,0.0,411.1,8655.73
07/07/25,UPI,UPI-MOHD PASHA MIYA-8074523914@YBL-LAVB0 000572-789780155317-PAYMENT FROM PHONE,0000789780155317,0.0,600.0,8055.73
07/07/25,UPI,UPI-MOHD AHMED ALI-AQUA.AHMED98@AXL-UTIB 0001808-449324616020-PAYMENT FROM PHONE,0000449324616020,180.0,0.0,8235.73
07/07/25,UPI,UPI-MUKELRA VANI-VANIRAJESHYADAV@OKAXIS- BARB0MALKAJ-555496788211-UPI,0000555496788211,0.0,1000.0,7235.73
07/07/25,UPI,UPI-LIBERTYSRIHARIOKICIC-LIBERTYSRIHARI@ OKICICI-BKID0008627-555443299000-UPI,0000555443299000,0.0,1300.0,5935.73
07/07/25,UPI,UPI-LIBERTYSRIHARIOKICIC-LIBERTYSRIHARI@ OKICICI-BKID0008627-518899408123-UPI,0000518899408123,0.0,650.0,5285.73
07/07/25,UPI,UPI-KARRA SATHISH-9293555325-7@AXL-BKID0 005707-518847818793-UPI,0000518847818793,0.0,1500.0,3785.73
07/07/25,IMPS,IMPS-518821380131-M MADHU YADAV-KKBK-XXX XXX7813-CASH,0000518821380131,0.0,150.0,3635.73
08/07/25,NEFT,NEFT CR-UTIB0000206-RESILIENT INNOVATION S PRIVATE LIMITED- NODAL ACCO-M MADHU YA DAV-UTIBN62025070845105256,UTIBN62025070845,1000.0,0.0,4635.73
08/07/25,UPI,UPI-MR JURRU RAHUL YADA-Q758292524@YBL- YESB0YBLUPI-518959820258-UPI,0000518959820258,0.0,270.0,4365.73
08/07/25,UPI,UPI-RAFI AHMED KHAN-PAYTM.S1AR3QF@PTY-YE SB0MCHUPI-518927421424-UPI,0000518927421424,0.0,10.0,4355.73
08/07/25,UPI,UPI-NAGIRAPU DURGA PRAS-9908814316@YBL- SBIN0000836-205315082769-PAYMENT FROM PH ONE,0000205315082769,2000.0,0.0,6355.73
08/07/25,UPI,UPI-B RAYUDU-RAYUDU10-1@OKHDFCBANK-HDFC0 000042-107740774230-UPI,0000107740774230,1200.0,0.0,7555.73
08/07/25,UPI,UPI-BHARATHI BHARATHI-BHARTHI9573@YBL-S BIN0020701-518966527782-UPI,0000518966527782,0.0,6000.0,1555.73
08/07/25,UPI,UPI-VARMA TIFFINS-GPAY-11256985679@OKBIZ AXIS-UTIB0000553-518942625694-UPI,0000518942625694,0.0,70.0,1485.73
08/07/25,UPI,UPI-JANARDHAN FILL POINT-PAYTM.D14688511 995@PTY-YESB0MCHUPI-518939537650-UPI,0000518939537650,0.0,250.0,1235.73
08/07/25,UPI,UPI-ARJUNA RAO SARA-9394889503@AXL-SBIN 0011661-819654022161-PAYMENT FROM PHONE,0000819654022161,4000.0,0.0,5235.73
08/07/25,UPI,UPI-PHONEPE-BBPSBP@YBL-YESB0YBLUPI-51135 5369842-PAYMENT FROM PHONE,0000511355369842,0.0,5058.67,177.06
09/07/25,NEFT,NEFT CR-UTIB0000206-RESILIENT INNOVATION S PRIVATE LIMITED- NODAL ACCO-M MADHU YA DAV-UTIBN62025070960036409,UTIBN62025070960,200.0,0.0,377.06
09/07/25,UPI,UPI-MR JURRU RAHUL YADA-Q758292524@YBL- YESB0YBLUPI-519002087579-UPI,0000519002087579,0.0,240.0,137.06
09/07/25,UPI,UPI-RAVI MANE-PAYTM.S1HP9L9@PTY-YESB0MCH UPI-519089892571-UPI,0000519089892571,0.0,70.0,67.06
09/07/25,UPI,UPI-MOHD ILYAS-BHARATPE.90067696653@FBPE -FDRL0001382-555623924105-PAY TO BHARATP SB0YBLUPI-543436827939-UPI,0000555623924105,0.0,15.0,52.06
09/07/25,UPI,UPI-NAGRAJ-MUKKERLANAGRAJ@OKAXIS-UBIN080 3219-519077031830-UPI,0000519077031830,80.0,0.0,132.06
10/07/25,UPI,UPI-RAVI MANE-PAYTM.S1HP9L9@PTY-YESB0MCH UPI-555767157017-UPI,0000555767157017,0.0,40.0,92.06
10/07/25,,ACH D- YES BANK-ENACH3798393147267251910,0000000730080393,0.0,6821.0,-6728.94
10/07/25,,ACH D- YES BANK-ENACH3798393147267251910,0000000730080393,6821.0,0.0,92.06
10/07/25,UPI,UPI-TORAN-PAYTMQR68KEWK@PTYS-YESB0PTMUPI -519152515821-UPI,0000519152515821,0.0,12.0,80.06
10/07/25,UPI,UPI-M MADHU YADAV-9985065404-2@YBL-SBIN 0006645-328093674076-PAYMENT FROM PHONE,0000328093674076,15000.0,0.0,15080.06
10/07/25,UPI,UPI-M MADHU YADAV-9985065404-2@AXL-SBIN 0006645-972683584161-PAYMENT FROM PHONE,0000972683584161,5000.0,0.0,20080.06
11/07/25,UPI,UPI-NARESH KUMAR YADAV-NARESHKUMARYADAV5 9426@YBL-UBIN0544884-519278354306-UPI,0000519278354306,0.0,200.0,19880.06
11/07/25,UPI,UPI-MR JURRU RAHUL YADA-Q758292524@YBL- YESB0YBLUPI-519276849410-UPI,0000519276849410,0.0,210.0,19670.06
11/07/25,UPI,UPI-M MADHU YADAV-9985065404-2@AXL-SBIN 0006645-626358958656-PAYMENT FROM PHONE,0000626358958656,2000.0,0.0,21670.06
11/07/25,,ATW-416021XXXXXX2657-S1AWHE01-HYDERABAD,0000000000001426,0.0,10000.0,11670.06
11/07/25,,ATW-416021XXXXXX2657-S1AWHE01-HYDERABAD,0000000000001427,0.0,10000.0,1670.06
11/07/25,,NWD-416021XXXXXX2657-00847039-HYDERABAD,0000519211003600,0.0,500.0,1170.06
11/07/25,UPI,UPI-PASHA NLAXMAIAH BRO-Q365575621@YBL- YESB0YBLUPI-519265466456-UPI,0000519265466456,0.0,360.0,810.06
11/07/25,UPI,UPI-KOLLAPURAM MALLIKARJ-6302581775@AXL- HDFC0000218-519268772334-UPI,0000519268772334,0.0,70.0,740.06
11/07/25,UPI,UPI-ENGLE VANDNA-SK1131864-4@OKSBI-SBIN 0005895-519211364023-UPI RAJ-ARVINDRAJ57964-1@OKHDFC BANK-HDFC0000512-101191091901-UPI,0000519211364023,0.0,400.0,340.06
11/07/25,UPI,UPI-MOHD AHMED ALI-AQUA.AHMED98@AXL-UTIB 0001808-885648960306-PAYMENT FROM PHONE,0000885648960306,360.0,0.0,700.06
11/07/25,UPI,UPI-KOLLAPURAM MALLIKARJ-6302581775@AXL- HDFC0000218-519265382313-UPI,0000519265382313,0.0,200.0,500.06
11/07/25,UPI,UPI-ANIL SO SHISHPAL-Q047206811@YBL-YESB 0YBLUPI-555829000878-UPI,0000555829000878,0.0,150.0,350.06
12/07/25,NEFT,NEFT CR-UTIB0000206-RESILIENT INNOVATION S PRIVATE LIMITED- NODAL ACCO-M MADHU YA DAV-UTIBN62025071292458942,UTIBN62025071292,2350.0,0.0,2700.06
12/07/25,UPI,UPI-MR JURRU RAHUL YADA-Q758292524@YBL- YESB0YBLUPI-555915816851-UPI,0000555915816851,0.0,210.0,2490.06
12/07/25,UPI,UPI-MR MARYPEDDY YADAIAH-PAYTMQR12M8KT7Q ZP@PAYTM-YESB0PTMUPI-555936617190-UPI,0000555936617190,0.0,30.0,2460.06
12/07/25,UPI,UPI-PARWARE VIJAY-PAYTM.S1K6V7H@PTY-YESB 0MCHUPI-555912826767-UPI,0000555912826767,0.0,50.0,2410.06
12/07/25,UPI,UPI-AMIT CHARAN-PAYTMQR6I043F@PTYS-YESB0 PTMUPI-555903940130-UPI,0000555903940130,0.0,25.0,2385.06
12/07/25,UPI,UPI-BHAIRAVA YADAV-SRIKANTHBHAIRAVA16-2@ OKSBI-TGRB0000001-519348424058-UPI,0000519348424058,2000.0,0.0,4385.06
12/07/25,UPI,UPI-M MADHU YADAV-9985065404-2@YBL-SBIN 0006645-610173491061-PAYMENT FROM PHONE,0000610173491061,15000.0,0.0,19385.06
12/07/25,,ATW-416021XXXXXX2657-P3ENTS55-HYDERABAD,0000000000002136,0.0,10000.0,9385.06
12/07/25,,ATW-416021XXXXXX2657-P3ENTS55-HYDERABAD,0000000000002137,0.0,2500.0,6885.06
12/07/25,UPI,UPI-MOHD PASHA MIYA-8074523914@YBL-LAVB0,0000828757998876,0.0,600.0,6285.06
12/07/25,UPI,UPI-MUKELRA VANI-VANIRAJESHYADAV@OKAXIS- BARB0MALKAJ-555987556939-UPI,0000555987556939,0.0,500.0,5785.06
12/07/25,UPI,UPI-MADHU SUDHAN GHODKE-MADHUSUDHANGHOD KE@IBL-SBIN0005895-555945156044-UPI,0000555945156044,0.0,1000.0,4785.06
12/07/25,UPI,UPI-MADHU SUDHAN GHODKE-MADHUSUDHANGHOD KE@AXL-SBIN0005895-204260655019-PAYMENT FROM PHONE,0000204260655019,1000.0,0.0,5785.06
12/07/25,UPI,UPI-MUKKERLA RAJESH YADA-9676788355@YBL- KKBK0007473-094923218386-PAYMENT FROM PH ONE,0000094923218386,500.0,0.0,6285.06
12/07/25,UPI,UPI-SANTHOSHA ARRA-SANTHU.SANTHOSHA2004@ OKHDFCBANK-HDFC0000562-555946473035-UPI,0000555946473035,0.0,2000.0,4285.06
12/07/25,UPI,UPI-HARDIK FOOT WEAR-Q852367690@YBL-YESB 0YBLUPI-555980779287-UPI,0000555980779287,0.0,300.0,3985.06
12/07/25,UPI,UPI-LIBERTYSRIHARIOKICIC-LIBERTYSRIHARI@ OKICICI-BKID0008627-555973987567-UPI,0000555973987567,0.0,1300.0,2685.06
12/07/25,UPI,UPI-LIBERTYSRIHARIOKICIC-LIBERTYSRIHARI@ OKICICI-BKID0008627-555991288047-UPI,0000555991288047,0.0,650.0,2035.06
12/07/25,UPI,UPI-KARRA SATHISH-9293555325-7@YBL-BKID0 005707-921674767254-PAYMENT FROM PHONE,0000921674767254,0.0,500.0,1535.06
13/07/25,UPI,UPI-MR JURRU RAHUL YADA-Q758292524@YBL- YESB0YBLUPI-519409102524-UPI,0000519409102524,0.0,240.0,1295.06
13/07/25,UPI,UPI-GADDAMEDI SRINIVAS-Q823829553@YBL-YE SB0YBLUPI-519490100262-UPI,0000519490100262,0.0,360.0,935.06
13/07/25,UPI,UPI-A LAXMI-Q655807646@YBL-YESB0YBLUPI-5 19416700149-UPI,0000519416700149,0.0,20.0,915.06
13/07/25,UPI,UPI-DAMODAR NAYAK-PAYTMQR3WBWCQEK4N@PAYT M-YESB0PTMUPI-519493012072-UPI,0000519493012072,0.0,135.0,780.06
13/07/25,UPI,UPI-MUKKERLA RAJESH YADA-9676788355@YBL- KKBK0007473-519437248750-UPI,0000519437248750,0.0,150.0,630.06
14/07/25,NEFT,NEFT CR-UTIB0000206-RESILIENT INNOVATION S PRIVATE LIMITED- NODAL ACCO-M MADHU YA DAV-UTIBN62025071413726746,UTIBN62025071413,730.0,0.0,1360.06
14/07/25,UPI,UPI-MR JURRU RAHUL YADA-Q758292524@YBL- YESB0YBLUPI-519595358822-UPI,0000519595358822,0.0,300.0,1060.06
14/07/25,UPI,UPI-BHUPESH V-Q636326232@YBL-YESB0YBL UPI-519595088008-UPI,0000519595088008,0.0,30.0,1030.06
14/07/25,UPI,UPI-RAVI MANE-PAYTM.S1HP9L9@PTY-YESB0MCH UPI-519540160871-UPI,0000519540160871,0.0,30.0,1000.06
14/07/25,UPI,UPI-RAVI KUMAR WAKLE-6305412279@AXL-KKBK 0007489-651329870091-PAYMENT FROM PHONE,0000651329870091,0.0,200.0,800.06
14/07/25,UPI,UPI-MRS B BHARATHI-Q594782917@YBL-YESB0 YBLUPI-556151008671-UPI,0000556151008671,0.0,10.0,790.06
14/07/25,UPI,UPI-MUKELRA VANI-VANIRAJESHYADAV@OKAXIS- BARB0MALKAJ-556150315122-UPI,0000556150315122,0.0,150.0,640.06
14/07/25,UPI,UPI-MUKKERLA RAJESH YADA-9676788355@YBL- KKBK0007473-556178331040-UPI,0000556178331040,0.0,150.0,490.06
14/07/25,UPI,UPI-8309617327PTYES-8309617327@PTYES-FDR L0001332-556164130994-UPI,0000556164130994,0.0,250.0,240.06
14/07/25,UPI,UPI-JAYADEEPA M S-BHARATPE.90069770319@F BPE-FDRL0001382-556172240263-PAY TO BHAR ATPE ME,0000556172240263,0.0,130.0,110.06
14/07/25,UPI,UPI-RAVI KUMAR WAKLE-6305412279@YBL-KKBK 0007489-336868124081-PAYMENT FROM PHONE,0000336868124081,0.0,100.0,10.06
15/07/25,NEFT,NEFT CR-UTIB0000206-RESILIENT INNOVATION S PRIVATE LIMITED- NODAL ACCO-M MADHU YA DAV-UTIBN62025071524173709,UTIBN62025071524,800.0,0.0,810.06
15/07/25,,ACH D- LIC OF INDIA-6577926590725,0000008019870196,0.0,2488.0,-1677.94
15/07/25,,ACH D- LIC OF INDIA-6577926590725,0000008019870196,2488.0,0.0,810.06
15/07/25,UPI,UPI-GOJAGAI SANJEEV KUMA-PAYTMQR62P6VB@P TYS-YESB0PTMUPI-556285852050-UPI,0000556285852050,0.0,30.0,780.06
15/07/25,UPI,UPI-RAJU BAKERY-Q380095316@YBL-YESB0YBLU PI-556222748508-UPI,0000556222748508,0.0,20.0,760.06
15/07/25,UPI,UPI-CHATAMONI KRISHNAIAH-BAJAJPAY.687972 9.05882152@INDUS-INDB0MERCHA-55622906605 8-UPI,0000556229066058,0.0,65.0,695.06
15/07/25,UPI,UPI-MUKKERLA GEETA SUDHA-GEETHAMUKKERLA- 1@OKAXIS-KKBK0007463-556224871319-UPI,0000556224871319,0.0,250.0,445.06
15/07/25,UPI,UPI-MUKKERLA RAJESH YADA-9676788355@YBL- KKBK0007473-556260788291-UPI,0000556260788291,0.0,150.0,295.06
15/07/25,UPI,UPI-MUKELRA VANI-VANIRAJESHYADAV@OKAXIS- BARB0MALKAJ-556292589121-UPI,0000556292589121,0.0,150.0,145.06
15/07/25,UPI,UPI-M MADHU YADAV-9985065404-2@AXL-SBIN UBIN0803219-507252006135-UPI,0000294315181516,20000.0,0.0,20145.06
15/07/25,UPI,UPI-ANGEL LTD NSE-ANGELONENSE@HDFCBANK-H DFC0MERUPI-556289599627-PAYINGANGELONE,0000556289599627,0.0,15000.0,5145.06
16/07/25,NEFT,NEFT CR-UTIB0000206-RESILIENT INNOVATION S PRIVATE LIMITED- NODAL ACCO-M MADHU YA DAV-UTIBN62025071635255464,UTIBN62025071635,1000.0,0.0,6145.06
16/07/25,UPI,UPI-RAVI MANE-PAYTM.S1HP9L9@PTY-YESB0MCH UPI-519743006453-UPI,0000519743006453,0.0,40.0,6105.06
16/07/25,UPI,UPI-MUKKERLA GEETA SUDHA-GEETHAMUKKERLA- 1@OKAXIS-KKBK0007463-519734503899-UPI,0000519734503899,0.0,100.0,6005.06
16/07/25,UPI,UPI-ANDALA MAHESH YADAV-8019560564@YBL-K KBK0007462-023561764364-PAYMENT FROM PHO NE,0000023561764364,20000.0,0.0,26005.06
16/07/25,UPI,UPI-MANDAL ABHI SHEK-CASHBULLABHISHEK-1@ OKAXIS-UTIB0000008-519716134799-UPI,0000519716134799,0.0,100.0,25905.06
16/07/25,UPI,UPI-MADHU SUDHAN GHODKE-MADHUSUDHANGHOD KE@AXL-SBIN0005895-519739333076-UPI,0000519739333076,0.0,100.0,25805.06
16/07/25,UPI,UPI-RAPARTI SRIHARI-LIBERTYSRIHARI@OKICI CI-BKID0008627-915518403938-PAYMENT FROM PHONE,0000915518403938,0.0,13000.0,12805.06
16/07/25,UPI,UPI-MOHD AHMED ALI-AQUA.AHMED98@AXL-UTIB 0001808-289312297062-PAYMENT FROM PHONE,0000289312297062,180.0,0.0,12985.06
16/07/25,UPI,NEFT CR-ICIC0099999-ANGEL ONE LIMITED-MU KKERLA MADHU YADAV-ICICN220250716049291 B0PTMUPI-507323146303-UPI,ICICN22025071604,3000.0,0.0,15985.06
16/07/25,UPI,UPI-M MADHU YADAV-9985065404-2@AXL-SBIN 0006645-512386729136-PAYMENT FROM PHONE,0000512386729136,1400.0,0.0,17385.06
16/07/25,UPI,UPI-ANGEL LTD NSE-ANGELONENSE@HDFCBANK-H DFC0MERUPI-519730081009-PAYINGANGELONE,0000519730081009,0.0,8000.0,9385.06
16/07/25,UPI,UPI-MUKELRA VANI-VANIRAJESHYADAV@OKAXIS- BARB0MALKAJ-519791657302-UPI,0000519791657302,0.0,150.0,9235.06
16/07/25,UPI,UPI-MUKKERLA RAJESH YADA-9676788355@YBL- KKBK0007473-519797867892-UPI,0000519797867892,0.0,150.0,9085.06
16/07/25,UPI,UPI-SANJAY AVULA-AVULASANJAYYADAV@AXL-HD FC0001996-519733763114-UPI,0000519733763114,0.0,200.0,8885.06
16/07/25,UPI,UPI-CHILUKALA VAMSHI YAD-VAMSHIY764-1@OK HDFCBANK-HDFC0000318-519771469983-UPI,0000519771469983,0.0,200.0,8685.06
16/07/25,UPI,UPI-SANJAY AVULA-AVULASANJAYYADAV@AXL-HD FC0001996-519739067790-UPI,0000519739067790,0.0,300.0,8385.06
17/07/25,NEFT,NEFT CR-UTIB0000206-RESILIENT INNOVATION S PRIVATE LIMITED- NODAL ACCO-M MADHU YA DAV-UTIBN62025071747041199,UTIBN62025071747,1500.0,0.0,9885.06
17/07/25,UPI,UPI-MR JURRU RAHUL YADA-Q758292524@YBL- YESB0YBLUPI-519805670879-UPI,0000519805670879,0.0,330.0,9555.06
17/07/25,UPI,UPI-TIRIVISETTY SATYANAR-Q000107328@YBL- YESB0YBLUPI-519823888317-UPI,0000519823888317,0.0,120.0,9435.06
17/07/25,UPI,UPI-RAVI MANE-PAYTM.S1HP9L9@PTY-YESB0MCH UPI-519800582759-UPI MOHIUDDIN-Q654287932@YBL-YESB0Y BLUPI-544122751612-UPI,0000519800582759,0.0,40.0,9395.06
17/07/25,UPI,UPI-CHILUKALA VAMSHI YAD-VAMSHIY764-1@OK HDFCBANK-HDFC0000318-519877182515-UPI,0000519877182515,0.0,500.0,8895.06
17/07/25,UPI,UPI-HANSABEN VRAJLAL DEV-PAYTMQR6HZR0K@P TYS-YESB0PTMUPI-556422615890-UPI,0000556422615890,0.0,20.0,8875.06
17/07/25,UPI,UPI-NAYAKOTI SHEKAR-LATHASHEKHAR50-1@OKH DFCBANK-CNRB0000033-556472524562-UPI,0000556472524562,0.0,100.0,8775.06
17/07/25,UPI,UPI-MUKELRA VANI-VANIRAJESHYADAV@OKAXIS- BARB0MALKAJ-556416511424-UPI,0000556416511424,0.0,100.0,8675.06
17/07/25,UPI,UPI-MUKKERLA RAJESH YADA-9676788355@YBL- KKBK0007473-556476215950-UPI,0000556476215950,0.0,100.0,8575.06
17/07/25,UPI,UPI-MUKKERLA RAJESH YADA-9676788355@YBL- KKBK0007473-556473427176-UPI,0000556473427176,0.0,100.0,8475.06
17/07/25,UPI,UPI-MUKERLA VANI-7997764206@KOTAK811-KKB K0000958-983710140234-PAYMENT FROM PHONE,0000983710140234,0.0,10.0,8465.06
17/07/25,NEFT,NEFT CR-ICIC0099999-ANGEL ONE LIMITED-MU KKERLA MADHU YADAV-ICICN220250717058480,ICICN22025071705,8000.0,0.0,16465.06
17/07/25,UPI,UPI-KOLLAPURAM MALLIKARJ-MALLIKARJUNKOLA PURAM@OKSBI-HDFC0000218-556424638172-UPI,0000556424638172,0.0,100.0,16365.06
17/07/25,UPI,UPI-SBIBHIMINSTANT928542-SBIBHIM.INSTANT 92854251365997150@SBIPAY-SBIP0123456-556 486040246-STATICQR,0000556486040246,0.0,100.0,16265.06
17/07/25,UPI,UPI-8309617327PTYES-8309617327@PTYES-FDR L0001332-556445651025-UPI S-YESB0PTMUPI-507794857432-UPI,0000556445651025,0.0,100.0,16165.06
17/07/25,UPI,UPI-SANJAY AVULA-AVULASANJAYYADAV@AXL-HD FC0001996-556468653245-UPI,0000556468653245,0.0,500.0,15665.06
17/07/25,UPI,UPI-MUKKERLA GEETA SUDHA-GEETHAMUKKERLA- 1@OKAXIS-KKBK0007463-556481521297-UPI,0000556481521297,0.0,100.0,15565.06
17/07/25,UPI,UPI-VADICHERLA PRADEEP K-9293555325-3@IB L-HDFC0001635-556400138172-UPI,0000556400138172,0.0,1500.0,14065.06
17/07/25,UPI,UPI-LIBERTYSRIHARIOKICIC-LIBERTYSRIHARI@ OKICICI-BKID0008627-556412733603-UPI,0000556412733603,0.0,1300.0,12765.06
17/07/25,UPI,UPI-LIBERTYSRIHARIOKICIC-LIBERTYSRIHARI@ OKICICI-BKID0008627-556464437683-UPI,0000556464437683,0.0,650.0,12115.06
17/07/25,UPI,UPI-VADICHERLA PRADEEP K-9293555325-3@YB L-HDFC0001635-882869152009-PAYMENT FROM PHONE,0000882869152009,0.0,500.0,11615.06
18/07/25,NEFT,NEFT CR-YESB0000001-RESILIENT INNOVATION S PVT LTD SETTL-M MADHU YADAV-YESBN12025,YESBN12025071801,1700.0,0.0,13315.06
18/07/25,UPI,UPI-MR JURRU RAHUL YADA-Q758292524@YBL- YESB0YBLUPI-556568662556-UPI,0000556568662556,0.0,330.0,12985.06
18/07/25,UPI,UPI-TIRIVISETTY SATYANAR-Q000107328@YBL- YESB0YBLUPI-556547541769-UPI,0000556547541769,0.0,270.0,12715.06
18/07/25,UPI,UPI-8309617327PTYES-8309617327@PTYES-FDR L0001332-556552670013-UPI,0000556552670013,0.0,200.0,12515.06
18/07/25,UPI,UPI-CHILUKALA VAMSHI YAD-VAMSHIY764-1@OK HDFCBANK-HDFC0000318-556544876056-UPI,0000556544876056,0.0,200.0,12315.06
18/07/25,UPI,UPI-RAVI KUMAR WAKLE-6305412279@IBL-KKBK 0007489-556571180326-UPI,0000556571180326,0.0,1000.0,11315.06
18/07/25,UPI,UPI-PARAS XXX7813-CASH,0000519993204988,0.0,275.0,11040.06
18/07/25,UPI,UPI-SANJAY KUMAR-Q599361382@YBL-YESB0YBL UPI-519958801972-UPI,0000519958801972,0.0,100.0,10940.06
18/07/25,UPI,UPI-CHIMMULA MALLIKARJUN-PAYTMQR6EC7S7@P TYS-YESB0PTMUPI-556591099390-UPI,0000556591099390,0.0,40.0,10900.06
18/07/25,UPI,UPI-BHARATHI BHARATHI-BHARTHI9573@YBL-S BIN0020701-519919409388-UPI,0000519919409388,0.0,6000.0,4900.06
18/07/25,UPI,UPI-LIBERTYSRIHARIOKICIC-LIBERTYSRIHARI@ OKICICI-BKID0008627-519908120431-UPI,0000519908120431,0.0,1300.0,3600.06
18/07/25,UPI,UPI-LIBERTYSRIHARIOKICIC-LIBERTYSRIHARI@ OKICICI-BKID0008627-519912501034-UPI,0000519912501034,0.0,650.0,2950.06
18/07/25,UPI,UPI-VADICHERLA PRADEEP K-9293555325-3@IB L-HDFC0001635-519977305288-UPI,0000519977305288,0.0,1500.0,1450.06
18/07/25,UPI,UPI-VADICHERLA PRADEEP K-9293555325@AXL- UBIN0800619-108554143823-PAYMENT FROM PH ONE,0000108554143823,0.0,500.0,950.06
18/07/25,NEFT,NEFT CR-ICIC0099999-ANGEL ONE LIMITED-MU KKERLA MADHU YADAV-ICICN220250718066476,ICICN22025071806,14000.0,0.0,14950.06
19/07/25,NEFT,NEFT CR-UTIB0000206-RESILIENT INNOVATION S PRIVATE LIMITED- NODAL ACCO-M MADHU YA DAV-UTIBN62025071969534977,UTIBN62025071969,1097.59,0.0,16047.65
19/07/25,UPI,UPI-MR JURRU RAHUL YADA-Q758292524@YBL- YESB0YBLUPI-520027819903-UPI,0000520027819903,0.0,390.0,15657.65
19/07/25,UPI,UPI-MOHD PASHA MIYA-8074523914@YBL-LAVB0 000572-640602249580-PAYMENT FROM PHONE,0000640602249580,0.0,800.0,14857.65
19/07/25,UPI,UPI-MR MARYPEDDY YADAIAH-PAYTMQR5WD1F4@P TYS-YESB0PTMUPI-520047019321-UPI,0000520047019321,0.0,30.0,14827.65
19/07/25,UPI,UPI-BHARATPE-CF.BHARATPE12@CASHFREENSDLP B-NSPB0000011-859381052413-PAYMENT FROM PHONE,0000859381052413,0.0,470.82,14356.83
19/07/25,UPI,UPI-LAKSHMI APPALA-LAKSHME1202@OKICICI- SBIN0005895-520038737175-UPI,0000520038737175,2000.0,0.0,16356.83
19/07/25,UPI,UPI-KATTA TULSI RAM-7337095861-2@AXL-SB IN0007641-009591990614-PAYMENT FROM PHON E,0000009591990614,9500.0,0.0,25856.83
19/07/25,UPI,UPI-NORTHERN ARC-NORTHERNARC692717.RZP@R XAIRTEL-AIRP0000011-520015520062-NORTHER NARC POWERE,0000520015520062,0.0,6330.54,19526.29
19/07/25,UPI,UPI-MRS SARITHA SARITH-Q843321365@YBL- YESB0YBLUPI-520026264011-UPI,0000520026264011,0.0,260.0,19266.29
19/07/25,UPI,UPI-MUKKERLA GEETA SUDHA-GEETHAMUKKERLA- 1@OKAXIS-KKBK0007463-520042949834-UPI,0000520042949834,0.0,4000.0,15266.29
19/07/25,UPI,UPI-8309617327PTYES-8309617327@PTYES-FDR L0001332-520016174453-UPI,0000520016174453,0.0,500.0,14766.29
19/07/25,UPI,UPI-MR JURRU RAHUL YADA-Q758292524@YBL- YESB0YBLUPI-520014965403-UPI,0000520014965403,0.0,150.0,14616.29
19/07/25,UPI,UPI-M ARVIND-ARVINDYADAV69552@OKAXIS-K KBK0007473-520037579015-UPI,0000520037579015,0.0,1000.0,13616.29
19/07/25,UPI,UPI-MUKERLA VANI-7997764206@KOTAK811-KKB K0000958-520062572555-UPI,0000520062572555,0.0,10.0,13606.29
19/07/25,UPI,UPI-SREE BALAJI 015-424247418146-PAYMENT FROM PHONE,0000520047781648,0.0,1940.0,11666.29
19/07/25,UPI,UPI-B RAJESHWARI-RAJESHWARIYADAV147-1@OK HDFCBANK-SBIN0RRDCGB-520004472873-UPI,0000520004472873,0.0,3380.0,8286.29
19/07/25,UPI,UPI-MUKKERLA RAJESH YADA-9676788355@YBL- KKBK0007473-520003486206-UPI,0000520003486206,0.0,500.0,7786.29
19/07/25,UPI,UPI-SWISSCASTLEBAKERY NA-VYAPAR.17198633 3553@HDFCBANK-HDFC0MERUPI-520016479573-U PI,0000520016479573,0.0,408.0,7378.29
20/07/25,NEFT,NEFT CR-UTIB0000206-RESILIENT INNOVATION S PRIVATE LIMITED- NODAL ACCO-M MADHU YA DAV-UTIBN62025072077623626,UTIBN62025072077,6363.27,0.0,13741.56
20/07/25,UPI,UPI-MR JURRU RAHUL YADA-Q758292524@YBL- YESB0YBLUPI-520170790378-UPI,0000520170790378,0.0,360.0,13381.56
20/07/25,UPI,UPI-V SAICHANDRA-Q277019799@YBL-YESB0YB LUPI-556786916558-UPI,0000556786916558,0.0,40.0,13341.56
20/07/25,UPI,UPI-J SHIVANARAYANA-BHARATPE90726407443@ YESBANKLTD-YESB0YESUPI-556775512702-PAY TO J SHIVANARA,0000556775512702,0.0,150.0,13191.56
20/07/25,UPI,UPI-SRI AMBICA WINES-PAYTMQR6H0KQ0@PTYS- YESB0PTMUPI-556729818153-UPI,0000556729818153,0.0,190.0,13001.56
20/07/25,UPI,UPI-M ARVIND-ARVINDYADAV69552@OKAXIS-K KBK0007473-556772822415-UPI,0000556772822415,0.0,500.0,12501.56
20/07/25,UPI,UPI-NORTHERN,0000520114751259,0.0,12500.54,1.02
20/07/25,IMPS,IMPS-520115242174-UPMOVE CAPITAL PVT L-I CIC-XXXXXXXX1116-7941142LOANSETTLEMENT,0000520115242174,21945.0,0.0,21946.02
20/07/25,UPI,UPI-MR JURRU RAHUL YADA-Q758292524@YBL- YESB0YBLUPI-556779943129-UPI,0000556779943129,0.0,40.0,21906.02
20/07/25,UPI,UPI-NAYI KOTI SEKHAR-SHEKAR.NAIKOTI1@IBL -CNRB0000033-556737649692-UPI,0000556737649692,0.0,500.0,21406.02
20/07/25,UPI,UPI-LIBERTYSRIHARIOKICIC-LIBERTYSRIHARI@ OKICICI-BKID0008627-556747553161-UPI,0000556747553161,0.0,650.0,20756.02
20/07/25,UPI,UPI-ANGEL LTD NSE-ANGELONENSE@HDFCBANK-H DFC0MERUPI-556748665452-PAYINGANGELONE,0000556748665452,0.0,20000.0,756.02
20/07/25,UPI,UPI-SANJAY AVULA-AVULASANJAYYADAV@YBL-HD FC0001996-676780341720-PAYMENT FROM PHON E,0000676780341720,500.0,0.0,1256.02
20/07/25,UPI,UPI-SANJAY AVULA-AVULASANJAYYADAV@YBL-HD FC0001996-556790952610-UPI,0000556790952610,0.0,400.0,856.02
20/07/25,UPI,UPI-M MADHU YADAV-9985065404-2@YBL-SBIN 0006645-307093291389-PAYMENT FROM PHONE,0000307093291389,12000.0,0.0,12856.02
20/07/25,UPI,UPI-ZERODHA BROKING LTD-ZERODHABROKING@H DFCBANK-HDFC0MERUPI-556751661087-1093593 232277127 Z,0000556751661087,0.0,11000.0,1856.02
21/07/25,UPI,NEFT CR-YESB0000001-RESILIENT INNOVATION S PVT LTD SETTL-M MADHU YADAV-YESBN12025 1@OKAXIS-KKBK0007463-544734480953-UPI,YESBN12025072101,31800.0,0.0,33656.02
21/07/25,UPI,UPI-MR JURRU RAHUL YADA-Q758292524@YBL- YESB0YBLUPI-556800374799-UPI,0000556800374799,0.0,300.0,33356.02
21/07/25,UPI,UPI-JURRU RAHUL YADAV-9963019626@YBL-SB IN0007641-354615165639-PAYMENT FROM PHON E,0000354615165639,0.0,1000.0,32356.02
21/07/25,UPI,UPI-ANGEL LTD NSE-ANGELONENSE@HDFCBANK-H DFC0MERUPI-556829380606-PAYINGANGELONE,0000556829380606,0.0,20000.0,12356.02
21/07/25,UPI,UPI-TIRIVISETTY SATYANAR-Q628175389@YBL- YESB0YBLUPI-556855380643-UPI,0000556855380643,0.0,20.0,12336.02
21/07/25,,ANGEL ONE LIMI-263280608,0000507212535793,800.0,0.0,13136.02
21/07/25,UPI,UPI-ZERODHA BROKING LTD-ZERODHABROKING@H DFCBANK-HDFC0MERUPI-556879877694-5971180 935468885 Z,0000556879877694,0.0,6000.0,7136.02
21/07/25,UPI,UPI-GUNTI BALRAJ-RAJURAJU27390@OKICICI- SBIN0020083-826546478103-PAYMENT FROM PH ONE,0000826546478103,0.0,2100.0,5036.02
21/07/25,UPI,UPI-PANUGOTHU RAVINAIK-PANUGOTHUNAIK2@Y BL-SBIN0005895-556848082881-UPI,0000556848082881,0.0,1150.0,3886.02
21/07/25,UPI,UPI-MR JURRU RAHUL YADA-Q758292524@YBL- YESB0YBLUPI-520259320984-UPI,0000520259320984,0.0,160.0,3726.02
21/07/25,UPI,UPI-SHEKER NAIKOTI-Q162267672@YBL-YESB0 YBLUPI-520268631358-UPI,0000520268631358,0.0,500.0,3226.02
21/07/25,UPI,UPI-MUKKERLA RAJESH YADA-9676788355@YBL- KKBK0007473-520227424697-UPI,0000520227424697,0.0,400.0,2826.02
21/07/25,NEFT,NEFT CR-ICIC0099999-ANGEL ONE LIMITED-MU KKERLA MADHU YADAV-ICICN220250721082818,ICICN22025072108,3000.0,0.0,5826.02
21/07/25,UPI,UPI-KOLLAPURAM VEGETA-GPAY-1124438713 1@OKBIZAXIS-UTIB0000553-544884955388-UPI,0000520287518448,0.0,200.0,5626.02
21/07/25,UPI,UPI-MUKELRA VANI-VANIRAJESHYADAV@OKAXIS- BARB0MALKAJ-520288088352-UPI,0000520288088352,150.0,0.0,5776.02
21/07/25,UPI,UPI-LIBERTYSRIHARIOKICIC-LIBERTYSRIHARI@ OKICICI-BKID0008627-520274028688-UPI,0000520274028688,0.0,1300.0,4476.02
21/07/25,UPI,UPI-LIBERTYSRIHARIOKICIC-LIBERTYSRIHARI@ OKICICI-BKID0008627-520264645766-UPI,0000520264645766,0.0,650.0,3826.02
21/07/25,UPI,UPI-VADICHERLA PRADEEP K-9293555325-3@IB L-HDFC0001635-520285835998-UPI,0000520285835998,0.0,1500.0,2326.02
21/07/25,UPI,UPI-VADICHERLA PRADEEP K-9293555325@YBL- UBIN0800619-554790955596-PAYMENT FROM PH ONE,0000554790955596,0.0,500.0,1826.02
21/07/25,UPI,UPI-MOHD PASHA MIYA-8074523914@YBL-LAVB0 000572-193803945016-PAYMENT FROM PHONE,0000193803945016,0.0,600.0,1226.02
22/07/25,NEFT,NEFT CR-UTIB0000206-RESILIENT INNOVATION S PRIVATE LIMITED- NODAL ACCO-M MADHU YA DAV-UTIBN62025072201378538,UTIBN62025072201,750.0,0.0,1976.02
22/07/25,NEFT,NEFT CR-YESB0000001-ZERODHA BROKING LTD- DSCNB A/C-MUKKERLA MADHU YADAV-YESBN1202,YESBN12025072202,2600.0,0.0,4576.02
22/07/25,UPI,UPI-MR JURRU RAHUL YADA-Q758292524@YBL- YESB0YBLUPI-520311143710-UPI,0000520311143710,0.0,360.0,4216.02
22/07/25,UPI,UPI-K SATYANARAYANA-PAYTMQR6CLJRH@PTYS-Y ESB0PTMUPI-520394242221-UPI,0000520394242221,0.0,60.0,4156.02
22/07/25,UPI,UPI-MRS R,0000520300668198,0.0,25.0,4131.02
22/07/25,UPI,UPI-MRS SANGEETA BALBHI-Q460725867@YBL- YESB0YBLUPI-520308663949-UPI,0000520308663949,0.0,10.0,4121.02
22/07/25,UPI,UPI-MR JURRU RAHUL YADA-Q758292524@YBL- YESB0YBLUPI-520388592506-UPI,0000520388592506,0.0,90.0,4031.02
22/07/25,UPI,UPI-SRI SAI RESTAURANT A-PAYTM-80659624@ PTYS-YESB0PTMUPI-556975509102-UPI,0000556975509102,0.0,205.0,3826.02
22/07/25,UPI,UPI-SRI SAI RESTAURANT A-PAYTM-80610737@ PTYS-YESB0PTMUPI-556961307855-UPI,0000556961307855,0.0,31.0,3795.02
22/07/25,NEFT,NEFT CR-ICIC0099999-ANGEL ONE LIMITED-MU KKERLA MADHU YADAV-ICICN220250722091089,ICICN22025072209,10000.0,0.0,13795.02
22/07/25,UPI,UPI-KOLLAPURAM MALLIKARJ-6302581775@IBL- HDFC0000218-520343996082-UPI,0000520343996082,0.0,100.0,13695.02
22/07/25,UPI,UPI-BHUMIREDDY SIVA SANK-PAYTMQR6I03E2@P TYS-YESB0PTMUPI-556993805628-UPI,0000556993805628,0.0,300.0,13395.02
22/07/25,UPI,UPI-LIBERTYSRIHARIOKICIC-LIBERTYSRIHARI@ OKICICI-BKID0008627-520380098601-UPI,0000520380098601,0.0,1300.0,12095.02
22/07/25,UPI,UPI-LIBERTYSRIHARIOKICIC-LIBERTYSRIHARI@ OKICICI-BKID0008627-556927111977-UPI,0000556927111977,0.0,650.0,11445.02
22/07/25,UPI,UPI-VADICHERLA PRADEEP K-9293555325-3@IB L-HDFC0001635-556925314197-UPI,0000556925314197,0.0,1500.0,9945.02
22/07/25,UPI,UPI-VADICHERLA PRADEEP K-9293555325@YBL- UBIN0800619-764123675071-PAYMENT FROM PH ONE,0000764123675071,0.0,500.0,9445.02
23/07/25,UPI,NEFT CR-YESB0000001-ZERODHA BROKING LTD- DSCNB A/C-MUKKERLA MADHU YADAV-YESBN1202 SUJATHA-SUJATHAGANAT13@OKSBI- SBIN0005895-545145546265-UPI,YESBN12025072302,14500.0,0.0,23945.02
23/07/25,NEFT,NEFT CR-UTIB0000206-RESILIENT INNOVATION S PRIVATE LIMITED- NODAL ACCO-M MADHU YA DAV-UTIBN62025072313338426,UTIBN62025072313,700.0,0.0,24645.02
23/07/25,UPI,UPI-M ANIL YADAV-ANILYADAV63473-2@OKAXIS -UBIN0803219-557053620695-UPI,0000557053620695,0.0,600.0,24045.02
23/07/25,UPI,UPI-RAKESH MADIGELA-Q270321511@YBL-YESB 0YBLUPI-557096031207-UPI,0000557096031207,0.0,171.0,23874.02
23/07/25,UPI,UPI-MR JURRU RAHUL YADA-Q758292524@YBL- YESB0YBLUPI-557003323204-UPI,0000557003323204,0.0,390.0,23484.02
23/07/25,IMPS,IMPS-520408358215-SRIDEVI JT1-ICIC-XXXXX XXX3198-CASH,0000520408358215,0.0,14000.0,9484.02
23/07/25,UPI,UPI-M MADHU YADAV-9985065404-2@YBL-SBIN 0006645-471771846506-PAYMENT FROM PHONE,0000471771846506,700.0,0.0,10184.02
23/07/25,UPI,UPI-RAPARTI SRIHARI-LIBERTYSRIHARI@OKICI CI-BKID0008627-988058013439-PAYMENT FROM PHONE,0000988058013439,0.0,10000.0,184.02
23/07/25,UPI,UPI-PANYAM MANJULA-MANJUPANYAM@OKSBI-SB IN0007641-520421447124-UPI,0000520421447124,1000.0,0.0,1184.02
23/07/25,UPI,UPI-GANTA SUJATHA-SUJATHAGANAT13@OKSBI- SBIN0005895-520424933947-UPI,0000520424933947,1050.0,0.0,2234.02
23/07/25,UPI,UPI-MR MOHAMMED ZAHEER-MOHAMMEDZAHEER511 -1@OKICICI-IDIB000T601-557028937377-UPI,0000557028937377,1480.0,0.0,3714.02
23/07/25,UPI,UPI-MR JURRU RAHUL YADA-Q758292524@YBL- YESB0YBLUPI-557085362310-UPI,0000557085362310,0.0,90.0,3624.02
23/07/25,UPI,UPI-HIMMAT SINGH JALA-JALAMAHENDRA@OKAXIS-K KBK0007466-508674121398-UPI,0000108591325693,1645.0,0.0,5269.02
23/07/25,UPI,UPI-M MADHU YADAV-9985065404-2@AXL-SBIN 0006645-054096544862-PAYMENT FROM PHONE,0000054096544862,0.0,200.0,5069.02
23/07/25,UPI,UPI-JURRU RAHUL YADAV-9963019626@YBL-SB IN0007641-321538183528-PAYMENT FROM PHON E,0000321538183528,5600.0,0.0,10669.02
23/07/25,UPI,UPI-JELLELA MALLESH-MALLESHJ528@OKICICI- CNRB0000033-557071575261-UPI,0000557071575261,1200.0,0.0,11869.02
23/07/25,NEFT,NEFT CR-ICIC0099999-ANGEL ONE LIMITED-MU KKERLA MADHU YADAV-ICICN220250723101677,ICICN22025072310,33000.0,0.0,44869.02
23/07/25,UPI,UPI-LIBERTYSRIHARIOKICIC-LIBERTYSRIHARI@ OKICICI-BKID0008627-557095175702-UPI,0000557095175702,0.0,1300.0,43569.02
23/07/25,UPI,UPI-LIBERTYSRIHARIOKICIC-LIBERTYSRIHARI@ OKICICI-BKID0008627-557029568390-UPI,0000557029568390,0.0,650.0,42919.02
23/07/25,UPI,UPI-VADICHERLA PRADEEP K-9293555325-3@IB L-HDFC0001635-557060480113-UPI,0000557060480113,0.0,1500.0,41419.02
23/07/25,UPI,UPI-VADICHERLA PRADEEP K-VPKYADAV28-2@OK ICICI-HDFC0001635-663683960996-PAYMENT F ROM PHONE,0000663683960996,0.0,500.0,40919.02
23/07/25,UPI,UPI-MOHD AHMED ALI-AQUA.AHMED98@AXL-UTIB 0001808-030103528833-PAYMENT FROM PHONE,0000030103528833,270.0,0.0,41189.02
23/07/25,NEFT,NEFT CR-UTIB0000052-ZERODHA BROKING LIMI TED-DSCNB A/C-MUKKERLA MADHU YADAV-UTIBN,UTIBN62025072321,1890.0,0.0,43079.02
23/07/25,UPI,UPI-PHONEPE-BBPSBP@YBL-YESB0YBLUPI-42795 ALI-AQUA.AHMED98@AXL-UTIB 0001808-824658179956-PAYMENT FROM PHONE,0000427958061072,0.0,905.0,42174.02
23/07/25,UPI,UPI-B VINOD KUMAR-BALERAOVINOD077@OKSBI- CNRB0000033-557062177131-UPI,0000557062177131,0.0,7000.0,35174.02
24/07/25,NEFT,NEFT CR-YESB0000001-RESILIENT INNOVATION S PVT LTD SETTL-M MADHU YADAV-YESBN12025,YESBN12025072401,1000.0,0.0,36174.02
24/07/25,UPI,UPI-MOHD PASHA MIYA-8074523914@YBL-LAVB0 000572-911230354466-PAYMENT FROM PHONE,0000911230354466,0.0,600.0,35574.02
24/07/25,UPI,UPI-ABSIPURAM KARUNAKAR-9000103377@YBL- SBIN0020083-412116017461-PAYMENT FROM PH ONE,0000412116017461,1500.0,0.0,37074.02
24/07/25,UPI,UPI-AIRTEL RECHARGE-AIRTELPREDIRECT1@YBL -YESB0YBLUPI-604588408502-PAYMENT FROM P HONE,0000604588408502,0.0,302.0,36772.02
24/07/25,UPI,UPI-PHONEPE-BBPSBP@YBL-YESB0YBLUPI-98110 1168772-PAYMENT FROM PHONE,0000981101168772,0.0,7500.0,29272.02
24/07/25,UPI,UPI-JIO RECHARGE-JIOINAPPDIRECT1@YBL-YES B0YBLUPI-689521364914-PAYMENT FROM PHONE,0000689521364914,0.0,352.0,28920.02
24/07/25,UPI,UPI-ANGEL LTD NSE-ANGELONENSE@HDFCBANK-H DFC0MERUPI-557164491003-PAYINGANGELONE,0000557164491003,0.0,18000.0,10920.02
24/07/25,UPI,UPI-MRS SANGEETA BALBHI-Q460725867@YBL- YESB0YBLUPI-520554206776-UPI,0000520554206776,0.0,100.0,10820.02
24/07/25,UPI,UPI-SBIBHIMINSTANT928542-SBIBHIM.INSTANT 92854251365997150@SBIPAY-SBIP0123456-520,0000520565222618,0.0,280.0,10540.02
24/07/25,UPI,UPI-SYED NIZAM -SYEDNIZAM975-1@OKSBI-SB IN0007054-520579411289-UPI,0000520579411289,0.0,900.0,9640.02
24/07/25,UPI,UPI-MUKELRA VANI-VANIRAJESHYADAV@OKAXIS- BARB0MALKAJ-520564419824-UPI,0000520564419824,0.0,1000.0,8640.02
24/07/25,UPI,UPI-KOLLAPURAM MALLIKARJ-6302581775@IBL- HDFC0000218-520598147950-UPI,0000520598147950,0.0,400.0,8240.02
24/07/25,NEFT,NEFT CR-ICIC0099999-ANGEL ONE LIMITED-MU KKERLA MADHU YADAV-ICICN220250724110208,ICICN22025072411,2457.99,0.0,10698.01
24/07/25,UPI,UPI-LIBERTYSRIHARIOKICIC-LIBERTYSRIHARI@ OKICICI-BKID0008627-520540365166-UPI,0000520540365166,0.0,1300.0,9398.01
24/07/25,UPI,UPI-LIBERTYSRIHARIOKICIC-LIBERTYSRIHARI@ OKICICI-BKID0008627-520578843435-UPI,0000520578843435,0.0,650.0,8748.01
24/07/25,UPI,UPI-VADICHERLA PRADEEP K-9293555325-3@IB L-HDFC0001635-520580040890-UPI,0000520580040890,0.0,1500.0,7248.01
24/07/25,UPI,UPI-VADICHERLA PRADEEP K-9293555325@AXL- UBIN0800619-474258294802-PAYMENT FROM PH ONE,0000474258294802,0.0,500.0,6748.01
25/07/25,NEFT,NEFT CR-UTIB0000206-RESILIENT INNOVATION S PRIVATE LIMITED- NODAL ACCO-M MADHU YA DAV-UTIBN62025072534522198,UTIBN62025072534,1500.0,0.0,8248.01
25/07/25,UPI,UPI-RAKESH MADIGELA-Q270321511@YBL-YESB 0YBLUPI-520628947566-UPI,0000520628947566,0.0,228.0,8020.01
25/07/25,UPI,UPI-MR JURRU RAHUL YADA-Q758292524@YBL- YESB0YBLUPI-520641570951-UPI,0000520641570951,0.0,300.0,7720.01
25/07/25,UPI,UPI-AKSHAY CHINTALA-9849868607@YESCRED-,0000557216365662,1000.0,0.0,8720.01
25/07/25,UPI,UPI-MOHD PASHA MIYA-8074523914@YBL-LAVB0 000572-396314956914-PAYMENT FROM PHONE,0000396314956914,1200.0,0.0,9920.01
25/07/25,,ANGEL ONE LIMI-W24DSUT7ZUVBLV,0000507259855726,18000.0,0.0,27920.01
25/07/25,UPI,UPI-MOHD PASHA MIYA-8074523914@YBL-LAVB0 000572-240474524912-PAYMENT FROM PHONE,0000240474524912,0.0,1200.0,26720.01
25/07/25,UPI,UPI-PHONEPE-BBPSBP@YBL-YESB0YBLUPI-66164 0984371-PAYMENT FROM PHONE,0000661640984371,0.0,4773.9,21946.11
25/07/25,UPI,UPI-MR JURRU RAHUL YADA-Q758292524@YBL- YESB0YBLUPI-520612597657-UPI,0000520612597657,0.0,90.0,21856.11
25/07/25,UPI,UPI-PARAS SPICES-PAYTM.S1KBYWT@PTY-YESB0 MCHUPI-557270517246-UPI,0000557270517246,0.0,325.0,21531.11
25/07/25,UPI,UPI-MOHD PASHA MIYA-8074523914@YBL-LAVB0 000572-472903008252-PAYMENT FROM PHONE,0000472903008252,0.0,600.0,20931.11
25/07/25,UPI,UPI-RAPARTI SRIHARI-LIBERTYSRIHARI@OKICI CI-BKID0008627-150540520640-PAYMENT FROM PHONE,0000150540520640,0.0,13000.0,7931.11
25/07/25,UPI,UPI-LIBERTYSRIHARIOKICIC-LIBERTYSRIHARI@ OKICICI-BKID0008627-557266032561-UPI,0000557266032561,0.0,1300.0,6631.11
25/07/25,IMPS,IMPS-520620353875-M MADHU YADAV-KKBK-XXX XXX7813-CASH,0000520620353875,0.0,4000.0,2631.11
26/07/25,UPI,UPI-NARESH MADIGELA-MADIGALANARESH123-1 @OKSBI-SBIN0005895-557377536327-UPI,0000557377536327,0.0,228.0,2403.11
26/07/25,UPI,UPI-MR JURRU RAHUL YADA-Q758292524@YBL- YESB0YBLUPI-557364147098-UPI,0000557364147098,0.0,300.0,2103.11
26/07/25,UPI,UPI-SUHAS MADHUKAR PURAM@OKSBI-HDFC0000218-509048097274-UPI,0000108720302968,2000.0,0.0,4103.11
26/07/25,UPI,UPI-PARWARE VIJAY-PAYTM.S1K6V7H@PTY-YESB 0MCHUPI-557329450679-UPI,0000557329450679,0.0,50.0,4053.11
26/07/25,UPI,UPI-MADHURI MARAM-LIPIKAMARAM@OKICICI-IC IC0000008-557337445798-UPI,0000557337445798,1000.0,0.0,5053.11
26/07/25,UPI,UPI-M MADHU YADAV-M.MADHUYADAV261@AXL-KK BK0007463-025528065105-PAYMENT FROM PHON E,0000025528065105,0.0,5000.0,53.11
26/07/25,UPI,UPI-BHAGWANDAS MARDA-MARDAPREMLATA-2@OK SBI-APMC0000010-520739313108-UPI,0000520739313108,1000.0,0.0,1053.11
26/07/25,UPI,UPI-SASHIKALA BHANDARI-9032117972@AXL-S BIN0005895-431668026523-PAYMENT FROM PHO NE,0000431668026523,2000.0,0.0,3053.11
26/07/25,UPI,UPI-RAPARTI SRIHARI-9493207195@YBL-BKID0 008627-006052253951-PAYMENT FROM PHONE,0000006052253951,66500.0,0.0,69553.11
26/07/25,UPI,UPI-GANTA SUJATHA-SUJATHAGANAT13@OKSBI- SBIN0005895-557317372113-UPI,0000557317372113,0.0,10000.0,59553.11
26/07/25,UPI,UPI-PANJALA KUMARASWAMY-KUMARPANJALA123 45@AXL-SBIN0021544-544076497298-PAYMENT FROM PHONE,0000544076497298,1180.0,0.0,60733.11
26/07/25,UPI,UPI-PANJALA KUMARASWAMY-KUMARPANJALA123 45@AXL-SBIN0021544-034895025275-PAYMENT FROM PHONE,0000034895025275,100.0,0.0,60833.11
26/07/25,IMPS,IMPS-520719393089-M MADHU RUPARA-KUMARRONAK7@OKA XIS-HDFC0000545-545831440265-APRIL MILK BILL,0000520719393089,0.0,30000.0,30833.11
26/07/25,UPI,UPI-MADHU SUDHAN GHODKE-MADHUSUDHANGHOD KE@AXL-SBIN0005895-651651738425-PAYMENT FROM PHONE,0000651651738425,200.0,0.0,31033.11
26/07/25,UPI,UPI-BHAVESH GUPTA-PAYTMQR5C8BFA@PTYS-YES B0PTMUPI-557319592099-UPI,0000557319592099,0.0,56.0,30977.11
26/07/25,UPI,UPI-CHILUKALA VAMSHI YAD-VAMSHIY764-1@OK HDFCBANK-HDFC0000318-108756007472-UPI,0000108756007472,200.0,0.0,31177.11
27/07/25,NEFT,NEFT CR-UTIB0000206-RESILIENT INNOVATION S PRIVATE LIMITED- NODAL ACCO-M MADHU YA DAV-UTIBN62025072754467496,UTIBN62025072754,2250.0,0.0,33427.11
27/07/25,UPI,UPI-MR JURRU RAHUL YADA-Q758292524@YBL- YESB0YBLUPI-520883312609-UPI,0000520883312609,0.0,240.0,33187.11
27/07/25,UPI,UPI-M PRABHAKAR-Q435661641@YBL-YESB0YBLU PI-520814113900-UPI,0000520814113900,0.0,300.0,32887.11
27/07/25,UPI,UPI-RAFI AHMED KHAN-PAYTM.S1AR3QF@PTY-YE SB0MCHUPI-520888320248-UPI,0000520888320248,0.0,135.0,32752.11
27/07/25,UPI,UPI-BRANCH-BRANCHONLINE@YBL-YESB0YBLUPI- 520839519735-BRANCH PAYMENT,0000520839519735,0.0,1772.0,30980.11
27/07/25,UPI,UPI-JANARDHAN FILL POINT-PAYTM.D14688511 995@PTY-YESB0MCHUPI-520825245266-UPI,0000520825245266,0.0,350.0,30630.11
27/07/25,UPI,UPI-SREENIVAS VENKATA DU-DUDDESREENI@AXL -KARB0000334-396667196314-PAYMENT FROM P HONE ZAXIS-UTIB0000553-509249800240-UPI,0000396667196314,30.0,0.0,30660.11
27/07/25,UPI,UPI-SRI SAI RESTAURANT A-PAYTM-80659623@ PTYS-YESB0PTMUPI-520888858612-UPI,0000520888858612,0.0,710.0,29950.11
27/07/25,UPI,UPI-ANGEL LTD NSE-ANGELONENSE@HDFCBANK-H DFC0MERUPI-520807055616-PAYINGANGELONE,0000520807055616,0.0,15000.0,14950.11
27/07/25,UPI,UPI-MUKKERLA RAJESH YADA-9676788355@YBL- KKBK0007473-520894373638-UPI,0000520894373638,0.0,200.0,14750.11
27/07/25,UPI,UPI-MUKELRA VANI-VANIRAJESHYADAV@OKAXIS- BARB0MALKAJ-520881857684-UPI,0000520881857684,0.0,200.0,14550.11
27/07/25,UPI,UPI-MUKKERLA GEETA SUDHA-GEETHAMUKKERLA- 1@OKAXIS-KKBK0007463-520808974158-UPI,0000520808974158,0.0,1000.0,13550.11
27/07/25,UPI,UPI-SRIKANTHBHAIRAVA162O-SRIKANTHBHAIRAV A16-2@OKICICI-TGRB0000001-520862160370-U PI,0000520862160370,0.0,2000.0,11550.11
28/07/25,NEFT,NEFT CR-UTIB0000206-RESILIENT INNOVATION S PRIVATE LIMITED- NODAL ACCO-M MADHU YA DAV-UTIBN62025072864270056,UTIBN62025072864,1650.0,0.0,13200.11
28/07/25,UPI,UPI-MOHD PASHA MIYA-8074523914@YBL-LAVB0 000572-981782204646-PAYMENT FROM PHONE,0000981782204646,0.0,600.0,12600.11
28/07/25,UPI,UPI-MR JURRU RAHUL YADA-Q758292524@YBL- YESB0YBLUPI-520950675235-UPI,0000520950675235,0.0,300.0,12300.11
28/07/25,UPI,UPI-ANGEL LTD NSE-ANGELONENSE@HDFCBANK-H DFC0MERUPI-520970076636-PAYINGANGELONE,0000520970076636,0.0,5000.0,7300.11
28/07/25,UPI,UPI-JIO RECHARGE-JIOINAPPDIRECT1@AXL-UTI B0AXLUPI-557613208363-PAYMENT FROM PHONE,0000557613208363,0.0,352.0,6948.11
28/07/25,UPI,UPI-MRS SANGEETA BALBHI-Q460725867@YBL- YESB0YBLUPI-520985393358-UPI,0000520985393358,0.0,125.0,6823.11
28/07/25,UPI,UPI-MOHD ABDUL WASEEM-BHARATPE.9A0R0M0K0 K833150@UNITYPE-UNBA000BHPE-557551012539 -PAY TO BHARATPE ME,0000557551012539,0.0,30.0,6793.11
28/07/25,UPI,UPI-A NARESH KUMAR-Q749466560@YBL-YESB0Y BLUPI-557563112046-UPI,0000557563112046,0.0,45.0,6748.11
28/07/25,UPI,UPI-JELLELA MALLESH-MALLESHJ528@OKICICI- CNRB0000033-557591839776-UPI,0000557591839776,700.0,0.0,7448.11
28/07/25,NEFT,NEFT CR-ICIC0099999-ANGEL ONE LIMITED-MU KKERLA MADHU YADAV-ICICN220250728134124,ICICN22025072813,10000.0,0.0,17448.11
28/07/25,UPI,UPI-LIBERTYSRIHARIOKICIC-LIBERTYSRIHARI@ OKICICI-BKID0008627-557540653779-UPI,0000557540653779,0.0,1300.0,16148.11
28/07/25,UPI,UPI-LIBERTYSRIHARIOKICIC-LIBERTYSRIHARI@ OKICICI-BKID0008627-557555858457-UPI,0000557555858457,0.0,650.0,15498.11
28/07/25,UPI,UPI-VADICHERLA PRADEEP K-9293555325-3@IB L-HDFC0001635-557540951152-UPI,0000557540951152,0.0,1500.0,13998.11
28/07/25,IMPS,IMPS-520922351004-M MADHU YADAV-KKBK-XXX XXX7813-CASH,0000520922351004,0.0,5000.0,8998.11
28/07/25,IMPS,IMPS-520922349850-M MADHU YADAV-KKBK-XXX XXX7813-CASH,0000520922349850,0.0,500.0,8498.11
29/07/25,UPI,UPI-SUDHAKARDAMARLAPALLY-SUDHAKARDAMARLA PALLY-1@OKICICI-IDIB000B052-557651847088 -UPI,0000557651847088,0.0,174.0,8324.11
29/07/25,UPI,UPI-MR JURRU RAHUL YADA-Q758292524@YBL- YESB0YBLUPI-557666658388-UPI PI,0000557666658388,0.0,330.0,7994.11
29/07/25,UPI,UPI-ANGEL LTD NSE-ANGELONENSE@HDFCBANK-H DFC0MERUPI-557653264795-PAYINGANGELONE,0000557653264795,0.0,5000.0,2994.11
29/07/25,UPI,UPI-JELLELA MALLESH-MALLESHJ528@OKICICI- CNRB0000033-557667765500-UPI,0000557667765500,2340.0,0.0,5334.11
29/07/25,UPI,UPI-GLENEAGLES HEALTHCAR-PINELABS.104998 69@HDFCBANK-HDFC0MERUPI-557613252503-UPI,0000557613252503,0.0,2340.0,2994.11
29/07/25,NEFT,NEFT CR-FDRL0009993-IKF HOME FINANCE LIM ITED-MUKKERLA MADHU-FDRLN520250729579929,FDRLN52025072957,225000.0,0.0,227994.11
29/07/25,UPI,UPI-GROWCAP CREDITWISE P-GROWCAPCREDITWI 723531.RZP@RXAXIS-UTIB0000RZP-5576308711 52-QYLVFYGFQQ6X6E,0000557630871152,0.0,24016.0,203978.11
29/07/25,UPI,UPI-ANGEL LTD NSE-ANGELONENSE@HDFCBANK-H DFC0MERUPI-557623670660-PAYINGANGELONE,0000557623670660,0.0,60000.0,143978.11
29/07/25,UPI,UPI-RULOANS-RULOANS.EASEBUZZ@KOTAK-KKBK0 000958-557648865683-PAY,0000557648865683,0.0,25881.18,118096.93
29/07/25,IMPS,IMPS-521011428796-AURO FINTECH PRIVATE L IMITED-NSPB-XXXXXXXX6355-PENNY DROP,0000521011428796,1.0,0.0,118097.93
29/07/25,UPI,UPI-VITTAL PRASAD-PAYTMQR5ET4BW@PTYS-YES B0PTMUPI-557679278796-UPI,0000557679278796,0.0,35.0,118062.93
29/07/25,UPI,UPI-KETHAVATHKISHAN-BHARATPE90722640279@ YESBANKLTD-YESB0YESUPI-557609880000-PAY TO BHARATPE ME,0000557609880000,0.0,40.0,118022.93
29/07/25,UPI,UPI-FREOPAY-FREOPAY-12646815.PAYU@INDUS- INDB0MERCHA-557683776959-UPIINTENT SRIVASTAVA-HARSHITASINGHPAB ARI@OKAXIS-KARB0000289-546076453851-UPI,0000557683776959,0.0,2219.02,115803.91
29/07/25,NEFT,NEFT CR-YESB0000001-RULOANS FINANCIAL SE RVICES PVT LTD -M MADHU YADAV-YESBN12025,YESBN12025072905,22935.0,0.0,138738.91
29/07/25,,.ACH DEBIT RETURN CHARGES 100725 100725- MIR2620556024548,MIR2620556024548,0.0,531.0,138207.91
29/07/25,,.ACH DEBIT RETURN CHARGES 150725 150725- MIR2620759303747,MIR2620759303747,0.0,590.0,137617.91
29/07/25,UPI,UPI-JIO RECHARGE-JIOINAPPDIRECT1@AXL-UTI B0AXLUPI-926008390503-PAYMENT FROM PHONE,0000926008390503,0.0,19.0,137598.91
29/07/25,UPI,UPI-MR RAVI TEJA POTHAR-RAVITEJAYADAV95 28@OKHDFCBANK-CBIN0280808-521034802646-U PI,0000521034802646,0.0,1000.0,136598.91
29/07/25,IMPS,IMPS-521018385623-M MADHU YADAV-KKBK-XXX XXX7813-CASH,0000521018385623,0.0,60000.0,76598.91
29/07/25,UPI,UPI-ARRALO RANI-RANIARRA92@OKSBI-FDRL000 1332-521079209428-UPI,0000521079209428,0.0,300.0,76298.91
29/07/25,UPI,UPI-K SUSHMITHA-PAYTM.S1JAX5R@PTY-YESB0M CHUPI-521048910486-UPI,0000521048910486,0.0,40.0,76258.91
29/07/25,NEFT,NEFT CR-ICIC0099999-ANGEL ONE LIMITED-MU KKERLA MADHU YADAV-ICICN220250729141824,ICICN22025072914,11951.04,0.0,88209.95
29/07/25,UPI,UPI-ZERODHA BROKING LTD-ZERODHABROKING@H DFCBANK-HDFC0MERUPI-521059029372-1372713 650988298 Z,0000521059029372,0.0,40000.0,48209.95
30/07/25,NEFT,NEFT CR-UTIB0000206-RESILIENT INNOVATION,UTIBN62025073085,2450.0,0.0,50659.95
30/07/25,UPI,UPI-NARESH MADIGELA-MADIGALANARESH123-1 @OKSBI-SBIN0005895-521171526984-UPI,0000521171526984,0.0,285.0,50374.95
30/07/25,UPI,UPI-MR JURRU RAHUL YADA-Q758292524@YBL- YESB0YBLUPI-521189429655-UPI,0000521189429655,0.0,180.0,50194.95
30/07/25,,ANGEL ONE LIMI-264849451,0000507304204248,548.96,0.0,50743.91
30/07/25,UPI,UPI-BHARKATHPURA-BHARKATHPURA.60983458@H DFCBANK-HDFC0MERUPI-521130318266-UPI,0000521130318266,0.0,166.0,50577.91
30/07/25,UPI,UPI-KURUMETI PRASAD-PAYTMQR6IL9PH@PTYS-Y ESB0PTMUPI-521141446661-UPI,0000521141446661,0.0,70.0,50507.91
30/07/25,UPI,UPI-MANGALI SRINIVASULU-9908210035@YBL-U TIB0000370-521198745956-UPI,0000521198745956,0.0,2500.0,48007.91
30/07/25,IMPS,IMPS-521111361698-M MADHU YADAV-KKBK-XXX XXX7813-CASH,0000521111361698,0.0,12000.0,36007.91
30/07/25,IMPS,IMPS-521111365682-MUKKERLA MADHU-SBIN-XX XXXXX5940-CASH,0000521111365682,0.0,10200.0,25807.91
30/07/25,UPI,UPI-SRINIVAS CHIRA-SRINIVASCHIRA782@OKS BI-SBIN0021227-521148741647-UPI,0000521148741647,0.0,100.0,25707.91
30/07/25,UPI,UPI-ZERODHA BROKING LTD-ZERODHABROKING@H DFCBANK-HDFC0MERUPI-521187845640-7588674 249352678 Z,0000521187845640,0.0,12000.0,13707.91
30/07/25,NEFT,NEFT CR-YESB0000001-TYCOON CREDIT AND P ORTFOLIOS LIMIT-MUKKERLAMADHUYADAV-YESBN E,YESBN12025073006,19404.0,0.0,33111.91
30/07/25,UPI,UPI-RK BANSAL FINANCE PV-RKBANSALFINANCE 696675.RZP@RXAIRTEL-AIRP0000011-52112687 5051-RKBANSALFINANCEPVT,0000521126875051,0.0,26000.0,7111.91
30/07/25,IMPS,IMPS-521126248446-R K BANSAL FINANCE PRI VATE LIM-RATN-XXXXXXXX8321-RKBANSALFINAN CEPLTDFUND,0000521126248446,17640.0,0.0,24751.91
30/07/25,NEFT,NEFT CR-ICIC0099999-ANGEL ONE LIMITED-MU KKERLA MADHU YADAV-ICICN220250730152449,ICICN22025073015,20500.0,0.0,45251.91
30/07/25,UPI,UPI-FDPL FINANCE-FDPLFINANCE@ICICI-ICIC0 DC0099-521171297142-UPI,0000521171297142,0.0,8253.15,36998.76
31/07/25,NEFT,NEFT CR-UTIB0000206-RESILIENT INNOVATION S PRIVATE LIMITED- NODAL ACCO-M MADHU YA DAV-UTIBN62025073196620485,UTIBN62025073196,1500.0,0.0,38498.76
31/07/25,UPI,UPI-NARESH MADIGELA-MADIGALANARESH123-1 @OKSBI-SBIN0005895-557877606180-UPI,0000557877606180,0.0,228.0,38270.76
31/07/25,UPI,UPI-MR JURRU RAHUL YADA-Q758292524@YBL- YESB0YBLUPI-557846504027-UPI,0000557846504027,0.0,300.0,37970.76
31/07/25,IMPS,IMPS-521218348333-M MADHU YADAV-KKBK-XXX XXX7813-CASH,0000521218348333,0.0,20000.0,17970.76
31/07/25,NEFT,NEFT CR-ICIC0099999-ANGEL ONE LIMITED-MU KKERLA MADHU YADAV-ICICN220250731167994,ICICN22025073116,10000.0,0.0,27970.76
31/07/25,,BHDFR6V0RZIGQW/BILLDKRATNAKARBANKLI,0002521291141065,0.0,6857.0,21113.76
01/08/25,UPI,NEFT CR-UTIB0000206-RESILIENT INNOVATION S PRIVATE LIMITED- NODAL ACCO-M MADHU BIN0020701-509612660664-UPI,UTIBN62025080107,730.0,0.0,21843.76
01/08/25,UPI,UPI-NARESH MADIGELA-MADIGALANARESH123-1 @OKSBI-SBIN0005895-557992582460-UPI,0000557992582460,0.0,228.0,21615.76
01/08/25,UPI,UPI-M ANIL YADAV-ANILYADAV63473-2@OKAXIS -UBIN0803219-557955191204-UPI,0000557955191204,0.0,600.0,21015.76
01/08/25,UPI,UPI-MUNTHA RAMESH YADAV-RAMEESHM6666-1@O KICICI-BKID0008604-518420819332-PAYMENT FROM PHONE,0000518420819332,0.0,8000.0,13015.76
01/08/25,UPI,UPI-B VINOD KUMAR-9949159003@YBL-CNRB000 0000-557965374083-UPI,0000557965374083,0.0,4000.0,9015.76
01/08/25,UPI,UPI-RONAK NEELESH RUPARA-KUMARRONAK7@OKA XIS-HDFC0000545-557922102428-COW PLUS BU FFALO M,0000557922102428,1272.0,0.0,10287.76
01/08/25,UPI,UPI-AKSHAY CHINTALA-9849868607@YESCRED- CNRB0000033-557906455263-PAID VIA CRED,0000557906455263,395.0,0.0,10682.76
01/08/25,UPI,UPI-ANGEL ONE LIMITED-ANGELONENSE@ICICI- ICIC0DC0099-557903194176-PAYINGANGELONE,0000557903194176,0.0,4200.0,6482.76
01/08/25,NEFT,NEFT CR-ICIC0SF0002-FDPL FINANCE PRIVATE LIMITED-MMADHUYADAV-ICICN42025080154440,ICICN42025080154,7292.0,0.0,13774.76
01/08/25,UPI,UPI-PAWAN KUMAR BASANT-9903315499@AXISB- UBIN0825522-557904181394-PAID VIA CRED,0000557904181394,2400.0,0.0,16174.76
01/08/25,UPI,NEFT CR-ICIC0099999-ANGEL ONE LIMITED-MU KKBK0007463-546396238873-UPI,ICICN22025080118,20000.0,0.0,36174.76
02/08/25,NEFT,NEFT CR-YESB0000001-RESILIENT INNOVATION S PVT LTD SETTL-M MADHU YADAV-YESBN12025,YESBN12025080201,608.18,0.0,36782.94
02/08/25,UPI,UPI-MUKKERLA GEETA SUDHA-GEETHAMUKKERLA- 1@OKAXIS-KKBK0007463-521410653757-UPI,0000521410653757,0.0,7000.0,29782.94
02/08/25,UPI,UPI-G PRASHANTH-PRASHANTH.GHANKOT07@OKIC ICI-UTIB0000881-406697994887-PAYMENT FRO M PHONE,0000406697994887,0.0,7875.0,21907.94
02/08/25,UPI,UPI-SHALINI HOSPITAL-MAB0450413A0104791@ YESBANK-YESB0000419-521481074064-UPI,0000521481074064,0.0,29.0,21878.94
02/08/25,UPI,UPI-BUDUMURU BHARGAVI-6303219486-3@YBL- CNRB0000033-375883035257-PAYMENT FROM PH ONE,0000375883035257,1085.0,0.0,22963.94
02/08/25,UPI,UPI-MR MARYPEDDY YADAIAH-PAYTMQR12M8KT7Q ZP@PAYTM-YESB0PTMUPI-521442885118-UPI,0000521442885118,0.0,146.0,22817.94
02/08/25,UPI,UPI-RAPARTI SRIHARI-LIBERTYSRIHARI@OKICI CI-BKID0008627-750552600982-PAYMENT FROM PHONE,0000750552600982,0.0,10000.0,12817.94
02/08/25,UPI,UPI-KATEPALLY VINAY KUM-9391150161@IBL- SBIN0003086-606356554789-PAYMENT FROM PH ONE,0000606356554789,1305.0,0.0,14122.94
02/08/25,UPI,UPI-SAMUDHRALA MANASA-MANASA31961@YBL-SB IN0RRDCGB-003841656714-PAYMENT FROM PHON MIYA-8074523914@YBL-LAVB0 000572-929666703090-PAYMENT FROM PHONE,0000003841656714,2520.0,0.0,16642.94
02/08/25,UPI,UPI-KOUR H-HARDEEPKOUR24@OKSBI-HSBC05000 02-521439464722-UPI,0000521439464722,1350.0,0.0,17992.94
02/08/25,UPI,UPI-KEERTHI NEELI-SAI.TAANYA26@OKAXIS-BA RB0BARKAT-521433258297-UPI,0000521433258297,1240.0,0.0,19232.94
02/08/25,UPI,UPI-SHALINI HOSPITAL PVT-SHALINIHOSPITAL PVTLT.66004955@HDFCBANK-HDFC0MERUPI-5580 34743514-UPI,0000558034743514,0.0,150.0,19082.94
03/08/25,UPI,UPI-NARESH MADIGELA-MADIGALANARESH123-1 @OKSBI-SBIN0005895-558116253089-UPI,0000558116253089,0.0,228.0,18854.94
03/08/25,NEFT,NEFT CR-YESB0000001-RESILIENT INNOVATION S PVT LTD SETTL-M MADHU YADAV-YESBN12025,YESBN12025080305,1145.0,0.0,19999.94
03/08/25,UPI,UPI-MR JURRU RAHUL YADA-Q758292524@YBL- YESB0YBLUPI-558145948536-UPI,0000558145948536,0.0,330.0,19669.94
03/08/25,UPI,UPI-PANYAM MANJULA-MANJUPANYAM@OKSBI-SB IN0007641-521560989513-MILK BILL,0000521560989513,2080.0,0.0,21749.94
03/08/25,UPI,UPI-SHALINI HOSPITAL PVT-SHALINIHOSPITAL PVTLT.66004955@HDFCBANK-HDFC0MERUPI-5581 49558085-UPI,0000558149558085,0.0,58.0,21691.94
03/08/25,UPI,UPI-SHALINI HOSPITAL PVT-SHALINIHOSPITAL PVTLT.66004955@HDFCBANK-HDFC0MERUPI-5581 07549134-UPI,0000558107549134,0.0,50.0,21641.94
03/08/25,UPI,UPI-FAIZANSALMANI6052OKI-FAIZANSALMANI60 52@OKICICI-PUNB0277600-558197759484-UPI,0000558197759484,0.0,300.0,21341.94
03/08/25,UPI,UPI-M MADHU YADAV-9985065404-2@AXL-SBIN 0006645-367098644088-PAYMENT FROM PHONE,0000367098644088,20000.0,0.0,41341.94
03/08/25,UPI,UPI-RAPARTI SRIHARI-LIBERTYSRIHARI@OKICI CI-BKID0008627-776412979656-PAYMENT FROM PHONE,0000776412979656,0.0,10000.0,31341.94
03/08/25,UPI,UPI-VARTHYAVATH THIRUPA-THIRUPATI1981NA IK-1@OKSBI-SBIN0021009-521582541606-UPI,0000521582541606,2325.0,0.0,33666.94
03/08/25,UPI,UPI-LAKSHMI APPALA-LAKSHME1202@OKSBI-SB IN0005895-521582598767-UPI,0000521582598767,1480.0,0.0,35146.94
03/08/25,UPI,UPI-NAYI KOTI SEKHAR-SHEKAR.NAIKOTI1@IBL -CNRB0000033-558159999092-UPI,0000558159999092,0.0,200.0,34946.94
03/08/25,UPI,UPI-PICHIGUNTLA MANGA-900257639@YBL-SBI N0011079-977522011103-PAYMENT FROM PHONE,0000977522011103,280.0,0.0,35226.94
03/08/25,UPI,UPI-M MADHU YADAV-9985065404-2@YBL-SBIN 0006645-077038391140-PAYMENT FROM PHONE,0000077038391140,20000.0,0.0,55226.94
03/08/25,UPI,UPI-ANGEL LTD NSE-ANGELONENSE@HDFCBANK-H DFC0MERUPI-521535917599-PAYINGANGELONE,0000521535917599,0.0,10000.0,45226.94
04/08/25,NEFT,NEFT CR-UNBA000BHPE-BHARAT PE-M MADHU YA DAV-UNBAN52025080452365059,UNBAN52025080452,8860.0,0.0,54086.94
04/08/25,UPI,UPI-NARESH MADIGELA-MADIGALANARESH123-1 @OKSBI-SBIN0005895-521641224822-UPI,0000521641224822,0.0,228.0,53858.94
04/08/25,UPI,UPI-MR JURRU RAHUL YADA-Q758292524@YBL- YESB0YBLUPI-521676608632-UPI,0000521676608632,0.0,190.0,53668.94
04/08/25,UPI,UPI-SUHAS MADHUKAR CHAUD-DRSUHAS2003@OKH DFCBANK-KKBK0001367-109203798173-UPI,0000109203798173,970.0,0.0,54638.94
04/08/25,UPI,UPI-MUKKERLA GEETA SUDHA-GEETHAMUKKERLA-,0000521644235168,0.0,3000.0,51638.94
04/08/25,UPI,UPI-MONEYVIEW-MONEYVIEW.EASEBUZZ@KOTAK-K KBK0000958-521637635630-PAY,0000521637635630,0.0,7460.0,44178.94
04/08/25,UPI,UPI-KALYANKAR VITTAHAL R-BHARATPE.900679 39934@FBPE-FDRL0001382-521600028889-PAY TO BHARATPE ME,0000521600028889,0.0,270.0,43908.94
04/08/25,UPI,UPI-AL MADINA NON VEG MA-GPAY-1124452501 5@OKBIZAXIS-UTIB0000553-521643530837-UPI,0000521643530837,0.0,30.0,43878.94
04/08/25,UPI,UPI-ABSIPURAM KARUNAKAR-9000103377@YBL- SBIN0020083-553609137033-PAYMENT FROM PH ONE,0000553609137033,2180.0,0.0,46058.94
04/08/25,UPI,UPI-RAJESH C PATEL-9820875022@YESPOP-KKB K0008052-521624388810-UPI,0000521624388810,1820.0,0.0,47878.94
04/08/25,,ACH D- PROTIUM FINANCE LIMI-KWG9PVHFQUID,0000001751311692,0.0,28475.0,19403.94
04/08/25,UPI,UPI-ANGEL ONE LIMITED-ANGELONENSE@ICICI- ICIC0DC0099-521609858579-PAYINGANGELONE,0000521609858579,0.0,1500.0,17903.94
04/08/25,UPI,UPI-BILLA S-9700452204-2@YBL-HSBC0500002 -010019403706-PAYMENT FROM PHONE,0000010019403706,1240.0,0.0,19143.94
04/08/25,UPI,UPI-B SHIRISHA-SIRISHA0413@AXL-UBIN08007 67-265522090160-PAYMENT FROM PHONE,0000265522090160,2250.0,0.0,21393.94
04/08/25,UPI,UPI-BHAGWANDAS MARDA-MARDAPREMLATA-2@OK SBI-APMC0000010-521630810790-UPI,0000521630810790,395.0,0.0,21788.94
04/08/25,UPI,UPI-KANKATI SRINIVAS GOU-Q427410521@YBL- YESB0YBLUPI-521651979729-UPI,0000521651979729,0.0,70.0,21718.94
04/08/25,UPI,UPI-MADHURI MARAM-9398657847@IBL-ICIC000 0008-291205738794-PAYMENT FROM PHONE,0000291205738794,2185.0,0.0,23903.94
04/08/25,NEFT,NEFT CR-ICIC0099999-ANGEL ONE LIMITED-MU,ICICN22025080420,15000.0,0.0,38903.94
04/08/25,UPI,UPI-LIBERTYSRIHARIOKICIC-LIBERTYSRIHARI@ OKICICI-BKID0008627-558227503711-UPI,0000558227503711,0.0,1300.0,37603.94
04/08/25,UPI,UPI-LIBERTYSRIHARIOKICIC-LIBERTYSRIHARI@ OKICICI-BKID0008627-521633797734-UPI,0000521633797734,0.0,650.0,36953.94
04/08/25,UPI,UPI-ANGEL ONE LIMITED-ANGELONENSE@ICICI- ICIC0DC0099-558216208920-PAYINGANGELONE,0000558216208920,0.0,8000.0,28953.94
05/08/25,NEFT,NEFT CR-YESB0000001-RESILIENT INNOVATION S PVT LTD SETTL-M MADHU YADAV-YESBN12025,YESBN12025080501,1500.0,0.0,30453.94
05/08/25,UPI,UPI-NARESH MADIGELA-MADIGALANARESH123-1 @OKSBI-SBIN0005895-558341709657-UPI,0000558341709657,0.0,228.0,30225.94
05/08/25,UPI,UPI-MR JURRU RAHUL YADA-Q758292524@YBL- YESB0YBLUPI-558362608799-UPI,0000558362608799,0.0,180.0,30045.94
05/08/25,POS,CASH DEPOSIT-XXXXXXXXXX1847-HIMAYATNAGAR,0000000000007517,6500.0,0.0,36545.94
05/08/25,UPI,UPI-MR GANESH SUNKARI SU-Q654599117@YBL- YESB0YBLUPI-558378508798-UPI,0000558378508798,0.0,20.0,36525.94
05/08/25,UPI,UPI-MR GANESH SUNKARI SU-Q654599117@YBL- YESB0YBLUPI-521711493789-UPI,0000521711493789,0.0,130.0,36395.94
05/08/25,UPI,UPI-DOMMATI PRASAD-PRASADDOMMATI@YBL-SB IN0020173-391321693339-PAYMENT FROM PHON E,0000391321693339,60000.0,0.0,96395.94
05/08/25,UPI,UPI-NAKKALA JAGADISH-9848742183@AXL-HDFC,0000124402295778,0.0,5000.0,91395.94
05/08/25,UPI,UPI-M ANIL YADAV-ANILYADAV63473-2@OKAXIS -UBIN0803219-558354223134-UPI,0000558354223134,0.0,7500.0,83895.94
05/08/25,UPI,UPI-M ANIL YADAV-ANILYADAV63473-2@OKAXIS -UBIN0803219-558305609367-UPI,0000558305609367,0.0,13000.0,70895.94
05/08/25,UPI,UPI-ANGEL ONE LIMITED-ANGELONENSE@ICICI- ICIC0DC0099-558396801710-PAYINGANGELONE,0000558396801710,0.0,20000.0,50895.94
05/08/25,UPI,UPI-KURUMETI PRASAD-PAYTMQR6IL9PH@PTYS-Y ESB0PTMUPI-558344131289-UPI,0000558344131289,0.0,35.0,50860.94
05/08/25,,ACH D- IKF HOME FINANCE LTD-050820250518,0000001807554693,0.0,26402.0,24458.94
05/08/25,UPI,UPI-RACHAMALLA SRIKANTH-RACHAMALLASRIKAN TH5L@AXL-UBIN0800619-936040429190-PAYMEN T FROM PHONE,0000936040429190,0.0,10500.0,13958.94
05/08/25,UPI,UPI-RACHAMALLA SRIKANTH-RACHAMALLASRIKAN TH5L@YBL-UBIN0800619-755550304350-PAYMEN T FROM PHONE,0000755550304350,330.0,0.0,14288.94
05/08/25,UPI,UPI-RACHAMALLA SRIKANTH-RACHAMALLASRIKAN TH5L@YBL-UBIN0800619-438052322419-PAYMEN T FROM PHONE,0000438052322419,0.0,330.0,13958.94
05/08/25,UPI,UPI-SASHIKALA BHANDARI-9032117972@YBL-S BIN0005895-625408799375-PAYMENT FROM PHO NE,0000625408799375,1550.0,0.0,15508.94
05/08/25,UPI,UPI-ARRALO RANI-RANIARRA92@OKSBI-FDRL000 1332-558311236859-UPI SUDHA-GEETHAMUKKERLA- 1@OKAXIS-KKBK0007463-546646098113-UPI,0000558311236859,0.0,500.0,15008.94
05/08/25,UPI,UPI-M ANIL YADAV-ANILYADAV63473-2@OKAXIS -UBIN0803219-521722692629-7 MEMBERS MILK BIL,0000521722692629,11970.0,0.0,26978.94
05/08/25,UPI,UPI-NAGRAJ-MUKKERLANAGRAJ@OKAXIS-UBIN080 3219-558362718628-UPI,0000558362718628,4000.0,0.0,30978.94
05/08/25,UPI,UPI-KOLLAPURAM MALLIKARJ-6302581775@IBL- HDFC0000218-558324370206-UPI,0000558324370206,0.0,4000.0,26978.94
05/08/25,UPI,UPI-FEROZ KHAN-IBRAHIMKHAN.IK693@OKHDFCB ANK-TMBL0000213-109301876790-UPI,0000109301876790,980.0,0.0,27958.94
05/08/25,IMPS,IMPS-521719303502-M MADHU YADAV-KKBK-XXX XXX7813-CASH,0000521719303502,0.0,18000.0,9958.94
05/08/25,UPI,UPI-AARIF M VIRANI-9502424149@AXL-SBIN0 030233-490896637511-PAYMENT FROM PHONE,0000490896637511,1455.0,0.0,11413.94
05/08/25,IMPS,IMPS-521721343610-M MADHU YADAV-KKBK-XXX XXX7813-CASH,0000521721343610,0.0,500.0,10913.94
06/08/25,NEFT,NEFT CR-YESB0000001-RESILIENT INNOVATION S PVT LTD SETTL-M MADHU YADAV-YESBN12025,YESBN12025080601,870.0,0.0,11783.94
06/08/25,UPI,UPI-NARESH MADIGELA-MADIGALANARESH123-1 @OKSBI-SBIN0005895-558410573061-UPI,0000558410573061,0.0,228.0,11555.94
06/08/25,UPI,UPI-MR JURRU RAHUL YADA-Q758292524@YBL- YESB0YBLUPI-558451687241-UPI,0000558451687241,0.0,210.0,11345.94
06/08/25,UPI,UPI-SYEDA NASREEN SULTAN-AFREENSYEDA-1@O KICICI-ICIC0003867-521854300658-UPI,0000521854300658,2700.0,0.0,14045.94
06/08/25,UPI,UPI-MOHIT SETHIA-MOHITSJ.1995@OKICICI- KKBK0007452-521823020735-UPI,0000521823020735,900.0,0.0,14945.94
06/08/25,UPI,UPI-ORUGANTI SRINIVASA R-OSRINIVAS555@OK AXIS-UTIB0000426-558407380539-UPI,0000558407380539,1000.0,0.0,15945.94
06/08/25,,IB BILLPAY DR-HDFC92-434155XXXXXX1025,MB06143845831ET3,0.0,10854.0,5091.94
06/08/25,,IB BILLPAY DR-HDFC92-434155XXXXXX1025,MB06143947197T11,0.0,300.0,4791.94
06/08/25,UPI,UPI-M MADHU YADAV-9985065404-2@AXL-SBIN 0006645-964874399673-PAYMENT FROM PHONE,0000964874399673,0.0,1400.0,3391.94
06/08/25,UPI,UPI-ROSHAN LIGHTS-9052569681-2@AXL-KKBK0 007451-845891697805-PAYMENT FROM PHONE,0000845891697805,3500.0,0.0,6891.94
06/08/25,UPI,UPI-PANTHANGI HARSHITH -HARSHITHBABU01@ OKHDFCBANK-SBIN0060146-109362582657-UPI,0000109362582657,960.0,0.0,7851.94
06/08/25,NEFT,NEFT CR-ICIC0099999-ANGEL ONE LIMITED-MU KKERLA MADHU YADAV-ICICN220250806235707,ICICN22025080623,5000.0,0.0,12851.94
06/08/25,UPI,UPI-MUKKERLA RAJESH YADA-9676788355@YBL- KKBK0007473-521802468482-UPI,0000521802468482,0.0,560.0,12291.94
06/08/25,UPI,UPI-RAPARTI SRIHARI-LIBERTYSRIHARI@OKICI CI-BKID0008627-694375995985-PAYMENT FROM PHONE,0000694375995985,0.0,1500.0,10791.94
06/08/25,UPI,UPI-VADICHERLA BHARATHAM-99484335@YBL-HD FC0001635-825816631193-PAYMENT FROM PHON E,0000825816631193,0.0,500.0,10291.94
06/08/25,IMPS,IMPS-521822310593-M MADHU YADAV-KKBK-XXX XXX7813-CASH,0000521822310593,0.0,5000.0,5291.94
07/08/25,NEFT,NEFT CR-UTIB0000206-RESILIENT INNOVATION S PRIVATE LIMITED- NODAL ACCO-M MADHU,UTIBN62025080771,820.0,0.0,6111.94
07/08/25,UPI,UPI-NARESH MADIGELA-MADIGALANARESH123-1 @OKSBI-SBIN0005895-521927666307-UPI,0000521927666307,0.0,228.0,5883.94
07/08/25,UPI,UPI-MR JURRU RAHUL YADA-Q758292524@YBL- YESB0YBLUPI-521901579008-UPI,0000521901579008,0.0,210.0,5673.94
07/08/25,UPI,UPI-ANGEL LTD M2P-ANGELONEM2P@HDFCBANK-H DFC0000001-101152537467-W24EB9DVQLMS9J,0000101152537467,1200.0,0.0,6873.94
07/08/25,UPI,UPI-PHONEPE-BBPSBP@AXL-UTIB0AXLUPI-97774 8853007-PAYMENT FROM PHONE,0000977748853007,0.0,2994.4,3879.54
07/08/25,UPI,UPI-MOHD PASHA MIYA-8074523914@YBL-LAVB0 000572-332574312875-PAYMENT FROM PHONE,0000332574312875,0.0,600.0,3279.54
07/08/25,UPI,UPI-BALA KASHYAP-BALA.KASHYAP1@YBL-HDFC0 000126-518219161211-PAYMENT FROM PHONE,0000518219161211,875.0,0.0,4154.54
07/08/25,UPI,UPI-B RAYUDU-RAYUDU10-1@OKHDFCBANK-HDFC0 000042-109414370402-MILK AMT,0000109414370402,1200.0,0.0,5354.54
07/08/25,UPI,UPI-MOHD NAZEER-MOHDNAZEER8283@NAVIAXIS -SBIN0005893-521994611768-PAID VIA NAVI UPI,0000521994611768,30000.0,0.0,35354.54
07/08/25,UPI,UPI-MADHU SUDHAN GHODKE-MADHUSUDHANGHOD KE-2@OKICICI-SBIN0005895-558505424356-UP I,0000558505424356,1000.0,0.0,36354.54
07/08/25,UPI,UPI-VADICHERLA PRADEEP K-9293555325-3@IB L-HDFC0001635-558583539998-UPI,0000558583539998,0.0,1500.0,34854.54
07/08/25,UPI,UPI-LIBERTYSRIHARIOKICIC-LIBERTYSRIHARI@,0000558535141467,0.0,1300.0,33554.54
07/08/25,UPI,UPI-LIBERTYSRIHARIOKICIC-LIBERTYSRIHARI@ OKICICI-BKID0008627-558503751949-UPI,0000558503751949,0.0,650.0,32904.54
07/08/25,IMPS,IMPS-521921374915-M MADHU YADAV-KKBK-XXX XXX7813-CASH,0000521921374915,0.0,1000.0,31904.54
08/08/25,NEFT,NEFT CR-UTIB0000206-RESILIENT INNOVATION S PRIVATE LIMITED- NODAL ACCO-M MADHU YA DAV-UTIBN62025080886988278,UTIBN62025080886,1030.0,0.0,32934.54
08/08/25,UPI,UPI-NARESH MADIGELA-MADIGALANARESH123-1 @OKSBI-SBIN0005895-558608755737-UPI,0000558608755737,0.0,171.0,32763.54
08/08/25,UPI,UPI-MR JURRU RAHUL YADA-Q758292524@YBL- YESB0YBLUPI-558669272966-UPI,0000558669272966,0.0,90.0,32673.54
08/08/25,UPI,UPI-K SATYANARAYANA-PAYTMQR6CLJRH@PTYS-Y ESB0PTMUPI-558635759619-UPI,0000558635759619,0.0,30.0,32643.54
08/08/25,,ANGEL ONE LIMI-266503191,0000508082840386,26.0,0.0,32669.54
08/08/25,UPI,UPI-MUKKERLA GEETA SUDHA-GEETHAMUKKERLA- 1@OKAXIS-KKBK0007463-558635554681-UPI,0000558635554681,11500.0,0.0,44169.54
08/08/25,UPI,UPI-ARRALO RANI-8309617327@AXL-FDRL00013 32-458988729945-PAYMENT FROM PHONE,0000458988729945,500.0,0.0,44669.54
08/08/25,IMPS,IMPS-522013351648-M MADHU YADAV-KKBK-XXX XXX7813-CASH,0000522013351648,0.0,10000.0,34669.54
08/08/25,UPI,UPI-MR MADISHETTY RAJE-BHARATPE.9L0G0D0M 1H622504@UNITYPE-UNBA000BHPE-52207210407 8-PAY TO BHARATPE ME,0000522072104078,0.0,60.0,34609.54
08/08/25,UPI,UPI-MAHENDAR KUMAR,0000558604834313,3000.0,0.0,37609.54
08/08/25,IMPS,IMPS-522020318919-M MADHU YADAV-KKBK-XXX XXX7813-CASH,0000522020318919,0.0,1500.0,36109.54
08/08/25,UPI,UPI-MOHD AHMED ALI-AQUA.AHMED98@AXL-UTIB 0001808-307716325740-PAYMENT FROM PHONE,0000307716325740,360.0,0.0,36469.54
09/08/25,NEFT,NEFT CR-YESB0000001-RESILIENT INNOVATION S PVT LTD SETTL-M MADHU YADAV-YESBN12025,YESBN12025080901,1120.0,0.0,37589.54
09/08/25,UPI,UPI-MILAN BAKERY-PAYTMQR6JR62V@PTYS-YESB 0PTMUPI-522118451525-UPI,0000522118451525,0.0,140.0,37449.54
09/08/25,UPI,UPI-VET INDIA PHARMACEUT-PAYTMQR68THUV@P TYS-YESB0PTMUPI-522188973633-UPI,0000522188973633,0.0,432.0,37017.54
09/08/25,IMPS,IMPS-522114308263-M MADHU YADAV-KKBK-XXX XXX7813-CASH,0000522114308263,0.0,15500.0,21517.54
09/08/25,UPI,UPI-SOMALWAR SHRINIVAS-SOMALWAR73@OKSBI -SBIN0010356-522142882095-UPI,0000522142882095,2480.0,0.0,23997.54
09/08/25,UPI,UPI-PANTHANGI HARSHITH -HARSHITHBABU01@ OKSBI-SBIN0060146-522145873779-UPI,0000522145873779,200.0,0.0,24197.54
09/08/25,UPI,UPI-TRUE CREDITS PVT LTD-TRUECREDITSPVTL TD.PAYU@MAIRTEL-AIRP0000001-522121989801 -UPIINTENT,0000522121989801,0.0,6821.0,17376.54
09/08/25,IMPS,IMPS-522120308764-M MADHU NB0159700-579095251959-PAYMENT FROM PHON E,0000522120308764,0.0,1200.0,16176.54
09/08/25,UPI,UPI-MAHENDRA JALA-JALAMAHENDRA@OKAXIS-K KBK0007466-558759534578-2 LAKHS CHITTI,0000558759534578,90000.0,0.0,106176.54
10/08/25,NEFT,NEFT CR-YESB0000001-RESILIENT INNOVATION S PVT LTD SETTL-M MADHU YADAV-YESBN12025,YESBN12025081001,1000.0,0.0,107176.54
10/08/25,UPI,UPI-MR JURRU RAHUL YADA-Q758292524@YBL- YESB0YBLUPI-558805120066-UPI,0000558805120066,0.0,180.0,106996.54
10/08/25,,NWD-416021XXXXXX2657-00847100-HIMAYATHNA GAR,0000522207019313,0.0,10000.0,96996.54
10/08/25,,NWD-416021XXXXXX2657-00847100-HIMAYATHNA GAR,0000522207004028,0.0,10000.0,86996.54
10/08/25,UPI,UPI-M PRABHAKAR-Q435661641@YBL-YESB0YBLU PI-558887021885-UPI,0000558887021885,0.0,110.0,86886.54
10/08/25,POS,POS 416021XXXXXX2657 5030 DMART KACHI,0000522204299268,0.0,4877.96,82008.58
10/08/25,IMPS,IMPS-522210305469-M MADHU YADAV-KKBK-XXX XXX7813-CASH,0000522210305469,0.0,50000.0,32008.58
10/08/25,UPI,UPI-MRS BHAIRAVA MANASA-SRIKANTHBHAIRAV A16@OKAXIS-CBIN0284811-558863461565-UPI,0000558863461565,2000.0,0.0,34008.58
10/08/25,UPI,UPI-SBIBHIMINSTANT928542-SBIBHIM.INSTANT 92854251365997150@SBIPAY-SBIP0123456-558 867254228-STATICQR,0000558867254228,0.0,90.0,33918.58
10/08/25,IMPS,IMPS-522214356678-M MADHU YADAV-KKBK-XXX XXX7813-CASH,0000522214356678,0.0,14000.0,19918.58
10/08/25,UPI,UPI-ANGEL LTD RECHARGE-JIOINAPPDIRECT@YBL-YESB 0YBLUPI-687318832892-PAYMENT FROM PHONE,0000558865096481,0.0,12000.0,7918.58
10/08/25,IMPS,IMPS-522221356641-M MADHU YADAV-KKBK-XXX XXX7813-CASH,0000522221356641,0.0,700.0,7218.58
11/08/25,UPI,UPI-NARESH MADIGELA-MADIGALANARESH123-1 @OKSBI-SBIN0005895-522388804619-UPI,0000522388804619,0.0,171.0,7047.58
11/08/25,UPI,UPI-MAADEVI-Q552508687@YBL-YESB0YBLUPI-5 22367915823-UPI,0000522367915823,0.0,140.0,6907.58
11/08/25,UPI,UPI-ANGEL LTD NSE-ANGELONENSE@HDFCBANK-H DFC0MERUPI-522382012118-PAYINGANGELONE,0000522382012118,0.0,800.0,6107.58
11/08/25,UPI,UPI-MAHENDRA JALA-JALAMAHENDRA@OKAXIS-K KBK0007466-522304226579-1LAKH COMPLETE,0000522304226579,10000.0,0.0,16107.58
11/08/25,UPI,UPI-ANGEL LTD NSE-ANGELONENSE@HDFCBANK-H DFC0MERUPI-522394912632-PAYINGANGELONE,0000522394912632,0.0,7300.0,8807.58
11/08/25,UPI,UPI-MOHD PASHA MIYA-8074523914@YBL-LAVB0 000572-127765973675-PAYMENT FROM PHONE,0000127765973675,0.0,600.0,8207.58
11/08/25,UPI,UPI-SUDHAKAR SINGAJOGI-SUDHAKARSINGAJOGI @IBL-ICIC0002362-267935724004-RAJESH,0000267935724004,300.0,0.0,8507.58
11/08/25,UPI,UPI-VARSHA YADAV VALLALA-VARSHA.VALLALA1 313@OKICICI-ICIC0000075-522315662133-CHI TTI AMOUNT,0000522315662133,25234.0,0.0,33741.58
11/08/25,UPI,UPI-SANJAY AVULA-AVULASANJAYYADAV@AXL-HD FC0001996-287580986922-PAYMENT FROM PHON,0000287580986922,500.0,0.0,34241.58
11/08/25,UPI,UPI-GURRAM VARALAKSHMI-9908898266@AXL-S BIN0003608-245839833705-PAYMENT FROM PHO NE,0000245839833705,1.0,0.0,34242.58
11/08/25,UPI,UPI-GURRAM VARALAXMI-9908898266-2@IBL-PU NB0397200-909169493819-PAYMENT FROM PHON E,0000909169493819,9460.0,0.0,43702.58
11/08/25,UPI,UPI-IMRANVIRANI-9705740028@UPI-SBIN00035 29-200821513912-NO REMARKS,0000200821513912,1500.0,0.0,45202.58
11/08/25,UPI,UPI-AZAAD KHAN-9949271078@AXL-SBIN00200 83-179017939275-PAYMENT FROM PHONE,0000179017939275,36000.0,0.0,81202.58
11/08/25,UPI,UPI-VADICHERLA PRADEEP K-9293555325-3@IB L-HDFC0001635-522340462697-UPI,0000522340462697,0.0,1500.0,79702.58
11/08/25,UPI,REV-UPI-50100123131847-M.MADHUYADAV26-3@ OKICICI-522340462697-UPI,0000522340462697,1500.0,0.0,81202.58
11/08/25,IMPS,IMPS-522320369099-M MADHU YADAV-KKBK-XXX XXX7813-CASH,0000522320369099,0.0,4500.0,76702.58
11/08/25,UPI,UPI-ANGEL LTD NSE-ANGELONENSE@HDFCBANK-H DFC0MERUPI-522323480355-PAYINGANGELONE,0000522323480355,0.0,15000.0,61702.58
11/08/25,UPI,UPI-MUKKERLA RAJESH YADA-9676788355@YBL- KKBK0007473-522346172188-UPI,0000522346172188,0.0,560.0,61142.58
11/08/25,UPI,UPI-MUKELRA VANI-VANIRAJESHYADAV@OKAXIS- BARB0MALKAJ-522301971149-UPI,0000522301971149,0.0,140.0,61002.58
12/08/25,NEFT,NEFT CR-UTIB0000206-RESILIENT INNOVATION S PRIVATE LIMITED- NODAL ACCO-M MADHU YA YADAV-KKBK-XXX XXX7813-CASH,UTIBN62025081226,700.0,0.0,61702.58
12/08/25,UPI,UPI-MR JURRU RAHUL YADA-Q758292524@YBL- YESB0YBLUPI-522494087660-UPI,0000522494087660,0.0,180.0,61522.58
12/08/25,UPI,UPI-VADICHERLA PRADEEP K-9293555325-3@IB L-HDFC0001635-522438688049-UPI,0000522438688049,0.0,1500.0,60022.58
12/08/25,UPI,UPI-PRASANTH KUMAR T-PRASHANTH8639@AXL-B ARB0VJPUBL-483114682613-PAYMENT FROM PHO NE,0000483114682613,9460.0,0.0,69482.58
12/08/25,,NWD-416021XXXXXX2657-R8606020-KACHIGUDA,0000522414198804,0.0,1000.0,68482.58
12/08/25,UPI,UPI-PRAKASH TIWARI-MUKESH.TIWARI.CA-1@O KSBI-SBIN0005895-559043318279-UPI,0000559043318279,0.0,220.0,68262.58
12/08/25,UPI,UPI-MADHU SUDHAN GHODKE-MADHUSUDHANGHOD KE@YBL-SBIN0005895-559065820202-UPI,0000559065820202,0.0,500.0,67762.58
12/08/25,UPI,UPI-B SUMAN GOUD-GOUDSUMAN5321-2@OKAXIS -KKBK0007451-138468844941-PAYMENT FROM P HONE,0000138468844941,0.0,6000.0,61762.58
12/08/25,UPI,UPI-MOHD AHMED ALI-MOHD.AHMED199819@OKAX IS-UTIB0001808-486175705940-PAYMENT FROM PHONE,0000486175705940,0.0,10000.0,51762.58
12/08/25,UPI,UPI-MUKKERLA RAJESH YADA-9676788355@YBL- KKBK0007473-559066855634-UPI,0000559066855634,0.0,1100.0,50662.58
12/08/25,NEFT,NEFT CR-ICIC0099999-ANGEL ONE LIMITED-MU KKERLA MADHU YADAV-ICICN220250812299498,ICICN22025081229,4000.0,0.0,54662.58
12/08/25,UPI,UPI-LIBERTYSRIHARIOKICIC-LIBERTYSRIHARI@,0000559039749849,0.0,1300.0,53362.58
12/08/25,IMPS,IMPS-522421377923-M MADHU YADAV-KKBK-XXX XXX7813-CASH,0000522421377923,0.0,10000.0,43362.58
13/08/25,NEFT,NEFT CR-UTIB0000206-RESILIENT INNOVATION S PRIVATE LIMITED- NODAL ACCO-M MADHU YA DAV-UTIBN62025081337456062,UTIBN62025081337,1300.0,0.0,44662.58
13/08/25,UPI,UPI-MR JURRU RAHUL YADA-Q758292524@YBL- YESB0YBLUPI-559184450128-UPI,0000559184450128,0.0,220.0,44442.58
13/08/25,UPI,UPI-ANGEL LTD NSE-ANGELONENSE@HDFCBANK-H DFC0MERUPI-559136567586-PAYINGANGELONE,0000559136567586,0.0,10000.0,34442.58
13/08/25,UPI,UPI-MR BALKISHAN LADDHA-BALKISHANLADDHA1 956@OKSBI-IDIB000B052-559146470910-UPI,0000559146470910,0.0,370.0,34072.58
13/08/25,UPI,UPI-NANDIKANTI SANTOSH-PAYTMQR6CYHDC@PTY S-YESB0PTMUPI-559163969486-UPI,0000559163969486,0.0,360.0,33712.58
13/08/25,UPI,UPI-JELLELA MALLESH-MALLESHJ528@OKICICI- CNRB0000033-559108395619-UPI,0000559108395619,5000.0,0.0,38712.58
13/08/25,UPI,UPI-MR JURRU RAHUL YADA-Q758292524@YBL- YESB0YBLUPI-522588304794-UPI,0000522588304794,0.0,90.0,38622.58
13/08/25,UPI,UPI-MOHD AHMED ALI-AQUA.AHMED98@AXL-UTIB 0001808-170497919250-PAYMENT FROM PHONE,0000170497919250,450.0,0.0,39072.58
13/08/25,IMPS,IMPS-522521376908-M MADHU YADAV-KKBK-XXX XXX7813-CASH,0000522521376908,0.0,5000.0,34072.58
13/08/25,UPI,NEFT CR-ICIC0099999-ANGEL ONE LIMITED-MU KKERLA MADHU YADAV-ICICN220250813309327 YESB0YBLUPI-510954803218-UPI,ICICN22025081330,4000.0,0.0,38072.58
14/08/25,NEFT,NEFT CR-YESB0000001-RESILIENT INNOVATION S PVT LTD SETTL-M MADHU YADAV-YESBN12025,YESBN12025081401,920.0,0.0,38992.58
14/08/25,UPI,UPI-MR JURRU RAHUL YADA-Q758292524@YBL- YESB0YBLUPI-522669733775-UPI,0000522669733775,0.0,180.0,38812.58
14/08/25,UPI,UPI-MOHD PASHA MIYA-8074523914@YBL-LAVB0 000572-661944495660-PAYMENT FROM PHONE,0000661944495660,0.0,1200.0,37612.58
14/08/25,UPI,UPI-HP PETROL PUMP PETR-Q400339571@YBL- YESB0YBLUPI-522642628416-UPI,0000522642628416,0.0,350.0,37262.58
14/08/25,UPI,UPI-J BHAGYA LAXMI EXOTI-Q790803008@YBL- YESB0YBLUPI-522615742883-UPI,0000522615742883,0.0,60.0,37202.58
14/08/25,UPI,UPI-MUKELRA VANI-VANIRAJESHYADAV@OKAXIS- BARB0MALKAJ-522696160038-UPI,0000522696160038,0.0,200.0,37002.58
14/08/25,UPI,UPI-SRI LAXMI RATAN KIRA-LATHASINGH1201- 1@OKSBI-SBIN0005895-522618948474-UPI,0000522618948474,0.0,20.0,36982.58
14/08/25,UPI,UPI-A NARESH KUMAR-Q749466560@YBL-YESB0Y BLUPI-522678271176-UPI,0000522678271176,0.0,20.0,36962.58
14/08/25,UPI,UPI-A NARESH KUMAR-Q749466560@YBL-YESB0Y BLUPI-522603769283-UPI,0000522603769283,0.0,20.0,36942.58
14/08/25,UPI,UPI-PSATISH-ADARSH.PRINTERS999@OKHDFCBAN K-PUNB0362800-522627984225-UPI,0000522627984225,0.0,3000.0,33942.58
14/08/25,UPI,UPI-GANTA SUJATHA-SUJATHAGANAT13@OKSBI- SBIN0005895-522641683050-UPI,0000522641683050,0.0,1.0,33941.58
14/08/25,UPI,UPI-GANTA SUJATHA-SUJATHAGANAT13@OKSBI-,0000522655129771,45000.0,0.0,78941.58
14/08/25,IMPS,IMPS-522618324486-M MADHU YADAV-KKBK-XXX XXX7813-CASH,0000522618324486,0.0,20000.0,58941.58
14/08/25,NEFT,NEFT CR-ICIC0099999-ANGEL ONE LIMITED-MU KKERLA MADHU YADAV-ICICN220250814320595,ICICN22025081432,27500.0,0.0,86441.58
15/08/25,UPI,UPI-LIBERTYSRIHARIOKICIC-LIBERTYSRIHARI@ OKICICI-BKID0008627-559304219739-UPI,0000559304219739,0.0,1300.0,85141.58
15/08/25,UPI,UPI-LIBERTYSRIHARIOKICIC-LIBERTYSRIHARI@ OKICICI-BKID0008627-559365510691-UPI,0000559365510691,0.0,650.0,84491.58
15/08/25,UPI,UPI-VADICHERLA PRADEEP K-9293555325-3@IB L-HDFC0001635-559328310333-UPI,0000559328310333,0.0,1500.0,82991.58
15/08/25,IMPS,IMPS-522700313052-M MADHU YADAV-KKBK-XXX XXX7813-CASH,0000522700313052,0.0,12000.0,70991.58
15/08/25,NEFT,NEFT CR-YESB0000001-RESILIENT INNOVATION S PVT LTD SETTL-M MADHU YADAV-YESBN12025,YESBN12025081501,160.0,0.0,71151.58
15/08/25,UPI,UPI-MR JURRU RAHUL YADA-Q758292524@YBL- YESB0YBLUPI-559307216597-UPI,0000559307216597,0.0,190.0,70961.58
15/08/25,,ACH D- LIC OF INDIA-6577926590825,0000008029342227,0.0,2488.0,68473.58
15/08/25,IMPS,IMPS-522711462299-GSD TRADING FINANCI-I DFB-XXXXXXX0243-IMPSTXN,0000522711462299,3000.0,0.0,71473.58
15/08/25,UPI,UPI-M ASHWIN-ASHWINYADAV5834@AXL-KKBK0 007473-705692064657-PAYMENT FROM PHONE,0000705692064657,10.0,0.0,71483.58
15/08/25,UPI,UPI-M ASHWIN-ASHWINYADAV5834@AXL-KKBK0 007473-537380603833-PAYMENT FROM PHONE,0000537380603833,50000.0,0.0,121483.58
15/08/25,UPI,UPI-M,0000647632779935,40000.0,0.0,161483.58
15/08/25,IMPS,IMPS-522715315967-M MADHU YADAV-KKBK-XXX XXX7813-CASH,0000522715315967,0.0,55000.0,106483.58
15/08/25,IMPS,IMPS-522715324472-M MADHU YADAV-KKBK-XXX XXX7813-CASH,0000522715324472,0.0,10000.0,96483.58
15/08/25,UPI,UPI-MOHD TAQI ANSARI-PAYTMQR66XO3L@PTYS- YESB0PTMUPI-559382478481-UPI,0000559382478481,0.0,300.0,96183.58
15/08/25,IMPS,IMPS-522719376940-M MADHU YADAV-KKBK-XXX XXX7813-CASH,0000522719376940,0.0,1000.0,95183.58
15/08/25,UPI,UPI-PHONEPE-BBPSBP@AXL-UTIB0AXLUPI-18226 0987381-PAYMENT FROM PHONE,0000182260987381,0.0,905.0,94278.58
16/08/25,UPI,UPI-MR JURRU RAHUL YADA-Q758292524@YBL- YESB0YBLUPI-522800503853-UPI,0000522800503853,0.0,240.0,94038.58
16/08/25,UPI,UPI-MR MADISHETTY RAJE-BHARATPE.9L0G0D0M 1H622504@UNITYPE-UNBA000BHPE-55946819046 5-PAY TO BHARATPE ME,0000559468190465,0.0,770.0,93268.58
16/08/25,UPI,UPI-NAGRAJ-MUKKERLANAGRAJ@OKAXIS-UBIN080 3219-522840207591-UPI,0000522840207591,0.0,500.0,92768.58
16/08/25,UPI,UPI-SARWJIT SINGH-SARVSARVJEET166@FREECH ARGE-JIOP0000001-865227412285-UPI,0000865227412285,1500.0,0.0,94268.58
16/08/25,UPI,UPI-RAJVEER SINGH-9389927170@IKWIK-UCBA0 002450-101218555321-NA,0000101218555321,1800.0,0.0,96068.58
16/08/25,UPI,UPI-MR MARYPEDDY YADAIAH-PAYTMQR12M8KT7Q ZP@PAYTM-YESB0PTMUPI-559411493986-UPI 000572-252195578890-PAYMENT FROM PHONE,0000559411493986,0.0,30.0,96038.58
16/08/25,UPI,UPI-MR SAHEB HUSAIN-SAHEBHUSAIN0297@OKA XIS-CBIN0282914-522870922241-UPI,0000522870922241,0.0,1000.0,95038.58
16/08/25,UPI,UPI-MAANGALYA SHOPPING M-MAANGALYASHOPPI NGMAL.42724889@HDFCBANK-HDFC0MERUPI-5228 12409273-UPI,0000522812409273,0.0,7666.0,87372.58
16/08/25,UPI,UPI-MAANGALYA SHOPPING M-MAANGALYASHOPPI NGMAL.42724683@HDFCBANK-HDFC0MERUPI-5228 52825644-UPI,0000522852825644,0.0,5600.0,81772.58
16/08/25,UPI,UPI-AVULA RAM SAI PRASAD-RAM.RAMSAI.SAI5 @OKAXIS-UTIB0004826-522895093604-UPI,0000522895093604,15000.0,0.0,96772.58
16/08/25,,ATW-416021XXXXXX2657-P3ENTS55-HYDERABAD,0000000000007593,0.0,20000.0,76772.58
16/08/25,,ATW-416021XXXXXX2657-P3ENTS55-HYDERABAD,0000000000007594,0.0,20000.0,56772.58
16/08/25,UPI,UPI-SUPRABATH TIFFINS-PAYTMQR5CYPRP@PTYS -YESB0PTMUPI-522806837916-UPI,0000522806837916,0.0,12.0,56760.58
16/08/25,UPI,UPI-MOHD PASHA MIYA-8074523914@YBL-LAVB0 000572-715974241857-PAYMENT FROM PHONE,0000715974241857,0.0,600.0,56160.58
16/08/25,UPI,UPI-MOHD AHMED ALI-AQUA.AHMED98@AXL-UTIB 0001808-636978490740-PAYMENT FROM PHONE,0000636978490740,270.0,0.0,56430.58
16/08/25,UPI,UPI-ENGLE VANDNA-SK1131864-4@OKSBI-SBIN 0005895-522887458703-UPI,0000522887458703,0.0,110.0,56320.58
16/08/25,UPI,UPI-CHIMMULA MALLIKARJUN-PAYTMQR6H1PIW@P TYS-YESB0PTMUPI-522842453263-UPI,0000522842453263,0.0,60.0,56260.58
16/08/25,UPI,UPI-NAMPALLYKAMALNATH-9182262483@UPI-SBI N0020083-210509691132-NO REMARKS 426009721 Z,0000210509691132,9460.0,0.0,65720.58
16/08/25,UPI,UPI-RAJARAM GURJAR-RG949927@OKSBI-BARB0T ARHAT-522814958486-UPI,0000522814958486,0.0,500.0,65220.58
16/08/25,UPI,UPI-LIBERTYSRIHARIOKICIC-LIBERTYSRIHARI@ OKICICI-BKID0008627-522807667628-UPI,0000522807667628,0.0,1300.0,63920.58
16/08/25,UPI,UPI-LIBERTYSRIHARIOKICIC-LIBERTYSRIHARI@ OKICICI-BKID0008627-522891862712-UPI,0000522891862712,0.0,650.0,63270.58
16/08/25,UPI,UPI-VADICHERLA PRADEEP K-9293555325-3@IB L-HDFC0001635-522856077078-UPI,0000522856077078,0.0,1500.0,61770.58
16/08/25,UPI,UPI-V SRIRAMULU-994843356@YBL-UBIN081180 7-259681882090-PAYMENT FROM PHONE,0000259681882090,0.0,500.0,61270.58
17/08/25,NEFT,NEFT CR-UNBA000BHPE-BHARAT PE-M MADHU YA DAV-UNBAN52025081774861441,UNBAN52025081774,240.0,0.0,61510.58
17/08/25,UPI,UPI-MUKELRA VANI-VANIRAJESHYADAV@OKAXIS- BARB0MALKAJ-522977159050-UPI,0000522977159050,0.0,240.0,61270.58
17/08/25,UPI,UPI-MR JURRU RAHUL YADA-Q758292524@YBL- YESB0YBLUPI-522905164572-UPI,0000522905164572,0.0,240.0,61030.58
17/08/25,UPI,UPI-MUNTHA RAMESH YADAV-RAMEESHM6666@YBL -BKID0008604-183848257853-PAYMENT FROM P HONE,0000183848257853,0.0,10000.0,51030.58
17/08/25,UPI,UPI-HP PETROL PUMP PETR-Q561100586@YBL- YESB0YBLUPI-522995093735-UPI,0000522995093735,0.0,680.0,50350.58
17/08/25,UPI,UPI-NAGRAJ-MUKKERLANAGRAJ@OKAXIS-UBIN080 3219-522964592244-UPI,0000522964592244,0.0,675.0,49675.58
17/08/25,UPI,UPI-SANAVI ENTERPRISES-PAYTM.D86725279@P TA-UTIB0000022-522994973968-UPI,0000522994973968,0.0,750.0,48925.58
17/08/25,UPI,UPI-SRI GIRIRAJ TRADING -9246520052-2@IB L-IBKL0000594-522904472246-UPI,0000522904472246,0.0,50.0,48875.58
17/08/25,UPI,UPI-M 0006645-237981529703-PAYMENT FROM PHONE,0000369835553752,7500.0,0.0,56375.58
17/08/25,UPI,UPI-NOONE RAVINDER GRANE-NOONERAVINDER-1 @OKSBI-KKBK0007451-522936491360-UPI,0000522936491360,0.0,600.0,55775.58
17/08/25,UPI,UPI-M SRINIVAS YADAV-MAMINLAAJAYYADAV-1@ OKAXIS-ANDB0000485-559549285894-UPI,0000559549285894,15000.0,0.0,70775.58
17/08/25,UPI,UPI-MADHAVI-PAYTMQR6BYA3I@PTYS-YESB0PTMU PI-522962176249-UPI,0000522962176249,0.0,270.0,70505.58
17/08/25,UPI,UPI-P NARESH-Q494181624@YBL-YESB0YBLUPI- 522903798265-UPI,0000522903798265,0.0,65.0,70440.58
17/08/25,UPI,UPI-SRINIVAS MULA-Q351445630@YBL-YESB0YB LUPI-522993473505-UPI,0000522993473505,0.0,300.0,70140.58
17/08/25,UPI,UPI-DHANURE ASLAM RAHIM-PAYTM.S1GVDRE@PT Y-YESB0MCHUPI-522946387738-UPI,0000522946387738,0.0,80.0,70060.58
17/08/25,UPI,UPI-MR MADIGELA MUKESH-Q120657734@YBL-Y ESB0YBLUPI-559555009777-UPI,0000559555009777,0.0,80.0,69980.58
17/08/25,UPI,UPI-CHIMMULA MALLIKARJUN-PAYTMQR62NJTR@P TYS-YESB0PTMUPI-522981573442-UPI,0000522981573442,0.0,30.0,69950.58
17/08/25,UPI,UPI-M ANIL YADAV-ANILYADAV63473-2@OKAXIS -UBIN0803219-559508707948-UPI,0000559508707948,0.0,2500.0,67450.58
17/08/25,UPI,UPI-K S CONSTRUCTIONS-ASHWINYADAV85-1@OK SBI-AUBL0002591-102728047613-PAYMENT FRO M PHONE,0000102728047613,0.0,10000.0,57450.58
17/08/25,IMPS,IMPS-522916366692-M MADHU,0000522916366692,0.0,5000.0,52450.58
17/08/25,UPI,UPI-MUTHOOT FINCORP LIMI-MUTHOOTFINCORPL 610302.RZP@RXAXIS-UTIB0000RZP-5595356177 04-UPI,0000559535617704,0.0,871.22,51579.36
17/08/25,UPI,UPI-MUTHOOT FINCORP LIMI-MUTHOOTFINCORPL 610302.RZP@RXAXIS-UTIB0000RZP-5595935075 32-UPI,0000559593507532,0.0,1283.3,50296.06
17/08/25,UPI,UPI-MS RAIMPET LAVANYA-Q411720563@YBL-Y ESB0YBLUPI-559586208802-UPI,0000559586208802,0.0,50.0,50246.06
17/08/25,UPI,UPI-KODURI DAVUNI MADHUK-DEVUNIMADHUKODU RI@OKSBI-SBIN0003605-559544938830-UPI,0000559544938830,0.0,500.0,49746.06
17/08/25,UPI,UPI-KOLLAPURAM MALLIKARJ-6302581775@AXL- HDFC0000218-559511548361-UPI,0000559511548361,0.0,350.0,49396.06
18/08/25,UPI,UPI-ANGEL LTD NSE-ANGELONENSE@HDFCBANK-H DFC0MERUPI-559684954176-PAYINGANGELONE,0000559684954176,0.0,10000.0,39396.06
18/08/25,UPI,UPI-SRI BALAJI BAKERY-PAYTMQR6ID8L1@PTYS -YESB0PTMUPI-559661959144-UPI,0000559661959144,0.0,210.0,39186.06
18/08/25,UPI,UPI-SOWJANYA-M.SOUJANYA2@OKAXIS-CNRB0000 033-559637144138-UPI,0000559637144138,0.0,8000.0,31186.06
18/08/25,UPI,UPI-ARRAGUNDLA JYOTHI-YADAVJYOTHI381@OK SBI-SBIN0014676-559667443000-UPI,0000559667443000,0.0,5000.0,26186.06
18/08/25,UPI,UPI-ANGEL LTD NSE-ANGELONENSE@HDFCBANK-H,0000559686434825,0.0,9000.0,17186.06
18/08/25,UPI,UPI-ANGEL LTD NSE-ANGELONENSE@HDFCBANK-H DFC0MERUPI-559647750961-PAYINGANGELONE,0000559647750961,0.0,1000.0,16186.06
18/08/25,UPI,UPI-ANGEL LTD NSE-ANGELONENSE@HDFCBANK-H DFC0MERUPI-559648659009-PAYINGANGELONE,0000559648659009,0.0,500.0,15686.06
18/08/25,UPI,UPI-ABDUL KAREEM-7676166204@YBL-UBIN0572 039-559605560139-UPI,0000559605560139,0.0,260.0,15426.06
18/08/25,UPI,UPI-NOMULA SWETHA-8519813071@AXL-SBIN00 20836-559605064496-UPI,0000559605064496,0.0,500.0,14926.06
18/08/25,UPI,UPI-CHENNOJI SAI KUMAR-9908198075SAI@AX L-SBIN0000916-559623979607-UPI,0000559623979607,0.0,2000.0,12926.06
18/08/25,UPI,UPI-KONETI SUJATHA-KONETINAGESH6-1@OKSB I-SBIN0020763-559688572570-UPI,0000559688572570,0.0,600.0,12326.06
18/08/25,UPI,UPI-KONETI SUJATHA-KONETINAGESH6-1@OKSB I-SBIN0020763-559688276975-UPI,0000559688276975,0.0,1000.0,11326.06
18/08/25,UPI,UPI-BEST FAST FOOD AND B-PAYTMQR6HZR1Z@P TYS-YESB0PTMUPI-559605975391-UPI,0000559605975391,0.0,120.0,11206.06
18/08/25,UPI,UPI-BHARATHI BHARATHI-BHARTHI9573@YBL-S BIN0020701-559662282148-UPI,0000559662282148,0.0,6000.0,5206.06
18/08/25,UPI,UPI-NARESH MADIGELA-MADIGALANARESH123-1 @OKSBI-SBIN0005895-559616186531-UPI,0000559616186531,0.0,1000.0,4206.06
18/08/25,UPI,UPI-MR JURRU RAHUL YADA-Q758292524@YBL- YESB0YBLUPI-559670388872-UPI XXX7813-CASH,0000559670388872,0.0,60.0,4146.06
18/08/25,UPI,UPI-KOLLAPURAM MALLIKARJ-6302581775@AXL- HDFC0000218-523070201106-UPI,0000523070201106,0.0,200.0,3946.06
18/08/25,UPI,UPI-KOLLAPURAM MALLIKARJ-6302581775@AXL- HDFC0000218-523060201573-UPI,0000523060201573,0.0,180.0,3766.06
18/08/25,NEFT,NEFT CR-ICIC0099999-ANGEL ONE LIMITED-MU KKERLA MADHU YADAV-ICICN220250818341023,ICICN22025081834,764.26,0.0,4530.32
18/08/25,UPI,UPI-LIBERTYSRIHARIOKICIC-LIBERTYSRIHARI@ OKICICI-BKID0008627-523005602871-UPI,0000523005602871,0.0,1300.0,3230.32
18/08/25,UPI,UPI-LIBERTYSRIHARIOKICIC-LIBERTYSRIHARI@ OKICICI-BKID0008627-523071003822-UPI,0000523071003822,0.0,650.0,2580.32
18/08/25,IMPS,IMPS-523021309191-M MADHU YADAV-KKBK-XXX XXX7813-CASH,0000523021309191,0.0,2500.0,80.32
19/08/25,,ANGEL ONE LIMI-267978723,0000508197556677,235.74,0.0,316.06
19/08/25,UPI,UPI-ANIL APPARELS-PAYTMQR28100505010111A 4C4QF3I0A@PAYTM-YESB0PTMUPI-523139218955 -UPI,0000523139218955,0.0,70.0,246.06
19/08/25,UPI,UPI-M MADHU YADAV-9985065404-2@YBL-SBIN 0006645-281841758580-PAYMENT FROM PHONE,0000281841758580,6000.0,0.0,6246.06
19/08/25,UPI,UPI-ANGEL LTD NSE-ANGELONENSE@HDFCBANK-H DFC0MERUPI-523171145953-PAYINGANGELONE,0000523171145953,0.0,6000.0,246.06
19/08/25,UPI,UPI-G PRASHANTH-7702920675@AXL-UTIB00008 81-373512499784-PAYMENT FROM PHONE,0000373512499784,6625.0,0.0,6871.06
19/08/25,UPI,UPI-M MADHU YADAV-9985065404-2@AXL-SBIN 0006645-999756745813-PAYMENT FROM PHONE,0000999756745813,12000.0,0.0,18871.06
19/08/25,UPI,UPI-NALLAMOTHU SIVAJI GA-SIVAJI.LIC@OKAX IS-UTIB0000881-523137549003-UPI,0000523137549003,0.0,18000.0,871.06
19/08/25,UPI,UPI-SRI RAGHAVENDRA TIFF-PAYTMQR17U07CIZ 21@PAYTM-YESB0PTMUPI-523159456364-UPI,0000523159456364,0.0,12.0,859.06
19/08/25,UPI,UPI-MOHD AHMED ALI-AQUA.AHMED98@AXL-UTIB 0001808-968284256533-PAYMENT FROM PHONE,0000968284256533,270.0,0.0,1129.06
19/08/25,UPI,UPI-JURRU RAHUL YADAV-9963019626@YBL-SB IN0007641-635590098321-PAYMENT FROM PHON E,0000635590098321,10000.0,0.0,11129.06
19/08/25,UPI,UPI-MADHURI MARAM-LIPIKAMARAM@OKAXIS-ICI C0000008-559796287620-UPI,0000559796287620,2000.0,0.0,13129.06
19/08/25,UPI,UPI-KOLLAPURAM MALLIKARJ-6302581775@IBL- HDFC0000218-523139249647-UPI,0000523139249647,0.0,200.0,12929.06
19/08/25,UPI,UPI-VUKYAM KEDARESWARI-PAYTMQR6NKUW1@PTY S-YESB0PTMUPI-636762078734-PAYMENT FROM PHONE,0000636762078734,0.0,200.0,12729.06
19/08/25,UPI,UPI-P VINOD KUMAR-Q801724639@YBL-YESB0YB LUPI-690714221051-PAYMENT FROM PHONE,0000690714221051,0.0,120.0,12609.06
19/08/25,UPI,UPI-CHIMMULA MALLIKARJUN-PAYTMQR6H1PIW@P TYS-YESB0PTMUPI-523187558497-UPI,0000523187558497,0.0,60.0,12549.06
19/08/25,UPI,UPI-LIBERTYSRIHARIOKICIC-LIBERTYSRIHARI@ OKICICI-BKID0008627-523170981982-UPI,0000523170981982,0.0,1300.0,11249.06
19/08/25,UPI,UPI-LIBERTYSRIHARIOKICIC-LIBERTYSRIHARI@ OKICICI-BKID0008627-523156277109-UPI,0000523156277109,0.0,650.0,10599.06
19/08/25,UPI,UPI-VADICHERLA PRADEEP K-9293555325-3@IB L-HDFC0001635-523139767403-UPI,0000523139767403,0.0,1500.0,9099.06
19/08/25,UPI,UPI-VADICHERLA PRADEEP K-9293555325-3@IB,0000523169560438,0.0,1500.0,7599.06
19/08/25,UPI,UPI-V SRIRAMULU-994843356@YBL-UBIN081180 7-154152555723-PAYMENT FROM PHONE,0000154152555723,0.0,500.0,7099.06
19/08/25,UPI,UPI-PAYU FINANCE INDIA P-PAYUFINANCEINDI 305682.RZP@RXAIRTEL-AIRP0000011-52312182 7204-PAYUFINANCEINDIAPR,0000523121827204,0.0,5242.54,1856.52
20/08/25,NEFT,NEFT CR-UNBA000BHPE-BHARAT PE-M MADHU YA DAV-UNBAN52025082083233678,UNBAN52025082083,90.0,0.0,1946.52
20/08/25,UPI,UPI-MUKELRA VANI-VANIRAJESHYADAV@OKAXIS- BARB0MALKAJ-523299173420-UPI,0000523299173420,0.0,90.0,1856.52
20/08/25,UPI,UPI-K SATYANARAYANA-PAYTMQR6CLJRH@PTYS-Y ESB0PTMUPI-523259491744-UPI,0000523259491744,0.0,30.0,1826.52
20/08/25,UPI,UPI-JAI SANTHOSHI MATHA-GPAY-11256386643 @OKBIZAXIS-UTIB0000553-523238387804-UPI,0000523238387804,0.0,10.0,1816.52
20/08/25,IMPS,IMPS-523209409692-GSD TRADING FINANCI-I DFB-XXXXXXX0243-IMPSTXN,0000523209409692,6420.8,0.0,8237.32
20/08/25,UPI,UPI-ANGEL LTD NSE-ANGELONENSE@HDFCBANK-H DFC0MERUPI-523290874838-PAYINGANGELONE,0000523290874838,0.0,1300.0,6937.32
20/08/25,UPI,UPI-RAPARTI SRIHARI-9493207195@YBL-BKID0 008627-195243140485-PAYMENT FROM PHONE,0000195243140485,19000.0,0.0,25937.32
20/08/25,UPI,UPI-USHKALA YADAGIRI-9391377674@YBL-SBI N0005895-523293586338-UPI,0000523293586338,0.0,10000.0,15937.32
20/08/25,UPI,UPI-M VIJAYA LAKSHMI-BHARATPE.9X0H0F0I2X 494580@UNITYPE-UNBA000BHPE-523294792861- PAY TO BHARATPE ME,0000523294792861,0.0,180.0,15757.32
20/08/25,UPI,UPI-N SHARADHA-NOONESHARADA19@OKSBI-PUNB,0000523278491281,0.0,4000.0,11757.32
20/08/25,UPI,UPI-PANYAM MANJULA-MANJUPANYAM@OKSBI-SB IN0007641-523219971549-MILK BILL,0000523219971549,2480.0,0.0,14237.32
20/08/25,UPI,UPI-OMBKAADH43093GVGIVL3-OMBK.AADH43093G VGIVL3FPB@MBK-PPIW0881822-523282096269-U PI,0000523282096269,0.0,420.0,13817.32
20/08/25,UPI,UPI-KOLLAPURAM MALLIKARJ-6302581775@IBL- HDFC0000218-559810104180-UPI,0000559810104180,0.0,2500.0,11317.32
20/08/25,UPI,UPI-MD AMEER-MOHAMMEDAMAIR232@OKSBI-SBI N0003086-523232580267-UPI,0000523232580267,1500.0,0.0,12817.32
20/08/25,IMPS,IMPS-523219333821-M MADHU YADAV-KKBK-XXX XXX7813-CASH,0000523219333821,0.0,12000.0,817.32
20/08/25,UPI,UPI-PAWAN KUMAR BASANT-9903315499@AXISB- UBIN0825522-559830604278-PAID VIA CRED,0000559830604278,1500.0,0.0,2317.32
21/08/25,UPI,UPI-M ANIL YADAV-ANILYADAV63473-2@OKAXIS -UBIN0803219-523395696365-CASH,0000523395696365,2000.0,0.0,4317.32
21/08/25,UPI,UPI-M MADHU YADAV-M.MADHUYADAV261@YBL-KK BK0007463-044820337426-PAYMENT FROM PHON E,0000044820337426,0.0,2000.0,2317.32
21/08/25,UPI,UPI-KOLLAPURAM MALLIKARJ-6302581775@IBL- HDFC0000218-559999147525-UPI,0000559999147525,0.0,250.0,2067.32
21/08/25,UPI,UPI-PARVESH KUMAR SHARMA-PARVESHSHARMA09 728@OKSBI-SBIN0005895-523374520913-UPI YESBANKLTD-YESB0YESUPI-511952059390-PAY TO J SHIVANARA,0000523374520913,2000.0,0.0,4067.32
21/08/25,UPI,UPI-BHASKAR ALLI-9966763001@YBL-SBIN001 1984-559918065394-UPI,0000559918065394,0.0,1000.0,3067.32
21/08/25,UPI,UPI-PERIKA NAVEEN KUMAR-NAVEEN92PERIKA-3 @YBL-UBIN0822108-062634723112-PAYMENT FR OM PHONE,0000062634723112,25000.0,0.0,28067.32
21/08/25,UPI,UPI-XXXPGN KOTAK 811 OTP-9573446433@AXL- KKBK0000958-444976443515-PAYMENT FROM PH ONE,0000444976443515,0.0,20000.0,8067.32
21/08/25,UPI,UPI-SUHAS MADHUKAR CHAUD-DRSUHAS2003@OKH DFCBANK-KKBK0001367-110132350994-UPI,0000110132350994,2000.0,0.0,10067.32
21/08/25,UPI,UPI-GANTA SUJATHA-SUJATHAGANAT13@OKAXIS -SBIN0005895-559970755474-UPI,0000559970755474,1050.0,0.0,11117.32
21/08/25,UPI,UPI-LIBERTYSRIHARIOKICIC-LIBERTYSRIHARI@ OKICICI-BKID0008627-523362504620-UPI,0000523362504620,0.0,1300.0,9817.32
21/08/25,UPI,UPI-LIBERTYSRIHARIOKICIC-LIBERTYSRIHARI@ OKICICI-BKID0008627-523303508800-UPI,0000523303508800,0.0,650.0,9167.32
21/08/25,UPI,UPI-BHARATHI BHARATHI-BHARTHI9573@YBL-S BIN0020701-523338404662-UPI,0000523338404662,0.0,6000.0,3167.32
